unitid,institution name,year,EF2013.Level of student,EF2013.Grand total,EF2013.Total men,EF2013.Total women,IDX_EF
102553,University of Alaska Anchorage,2013,All students total,17363,7086,10277,-2
102553,University of Alaska Anchorage,2013,"All students, Undergraduate total",16380,6762,9618,-2
102553,University of Alaska Anchorage,2013,"All students, Undergraduate, Degree/certificate-seeking total",13116,5470,7646,-2
102553,University of Alaska Anchorage,2013,"All students, Undergraduate, Degree/certificate-seeking, First-time",1965,821,1144,-2
102553,University of Alaska Anchorage,2013,"All students, Undergraduate, Other degree/certificate-seeking",11151,4649,6502,-2
102553,University of Alaska Anchorage,2013,"All students, Undergraduate, Other degree/certifcate-seeking, Transfer-ins",613,257,356,-2
102553,University of Alaska Anchorage,2013,"All students, Undergraduate, Other degree/certifcate-seeking, Continuing",10538,4392,6146,-2
102553,University of Alaska Anchorage,2013,"All students, Undergraduate, Non-degree/certificate-seeking",3264,1292,1972,-2
102553,University of Alaska Anchorage,2013,"All students, Graduate",983,324,659,-2
102580,Alaska Bible College,2013,All students total,42,22,20,-2
102580,Alaska Bible College,2013,"All students, Undergraduate total",42,22,20,-2
102580,Alaska Bible College,2013,"All students, Undergraduate, Degree/certificate-seeking total",26,16,10,-2
102580,Alaska Bible College,2013,"All students, Undergraduate, Degree/certificate-seeking, First-time",13,5,8,-2
102580,Alaska Bible College,2013,"All students, Undergraduate, Other degree/certificate-seeking",13,11,2,-2
102580,Alaska Bible College,2013,"All students, Undergraduate, Other degree/certifcate-seeking, Continuing",13,11,2,-2
102580,Alaska Bible College,2013,"All students, Undergraduate, Non-degree/certificate-seeking",16,6,10,-2
102614,University of Alaska Fairbanks,2013,All students total,9166,3892,5274,-2
102614,University of Alaska Fairbanks,2013,"All students, Undergraduate total",7989,3411,4578,-2
102614,University of Alaska Fairbanks,2013,"All students, Undergraduate, Degree/certificate-seeking total",5729,2530,3199,-2
102614,University of Alaska Fairbanks,2013,"All students, Undergraduate, Degree/certificate-seeking, First-time",981,480,501,-2
102614,University of Alaska Fairbanks,2013,"All students, Undergraduate, Other degree/certificate-seeking",4748,2050,2698,-2
102614,University of Alaska Fairbanks,2013,"All students, Undergraduate, Other degree/certifcate-seeking, Transfer-ins",462,209,253,-2
102614,University of Alaska Fairbanks,2013,"All students, Undergraduate, Other degree/certifcate-seeking, Continuing",4286,1841,2445,-2
102614,University of Alaska Fairbanks,2013,"All students, Undergraduate, Non-degree/certificate-seeking",2260,881,1379,-2
102614,University of Alaska Fairbanks,2013,"All students, Graduate",1177,481,696,-2
102632,University of Alaska Southeast,2013,All students total,2996,1040,1956,-2
102632,University of Alaska Southeast,2013,"All students, Undergraduate total",2645,945,1700,-2
102632,University of Alaska Southeast,2013,"All students, Undergraduate, Degree/certificate-seeking total",1488,520,968,-2
102632,University of Alaska Southeast,2013,"All students, Undergraduate, Degree/certificate-seeking, First-time",228,105,123,-2
102632,University of Alaska Southeast,2013,"All students, Undergraduate, Other degree/certificate-seeking",1260,415,845,-2
102632,University of Alaska Southeast,2013,"All students, Undergraduate, Other degree/certifcate-seeking, Transfer-ins",174,55,119,-2
102632,University of Alaska Southeast,2013,"All students, Undergraduate, Other degree/certifcate-seeking, Continuing",1086,360,726,-2
102632,University of Alaska Southeast,2013,"All students, Undergraduate, Non-degree/certificate-seeking",1157,425,732,-2
102632,University of Alaska Southeast,2013,"All students, Graduate",351,95,256,-2
102669,Alaska Pacific University,2013,All students total,669,235,434,-2
102669,Alaska Pacific University,2013,"All students, Undergraduate total",387,132,255,-2
102669,Alaska Pacific University,2013,"All students, Undergraduate, Degree/certificate-seeking total",340,118,222,-2
102669,Alaska Pacific University,2013,"All students, Undergraduate, Degree/certificate-seeking, First-time",32,16,16,-2
102669,Alaska Pacific University,2013,"All students, Undergraduate, Other degree/certificate-seeking",308,102,206,-2
102669,Alaska Pacific University,2013,"All students, Undergraduate, Other degree/certifcate-seeking, Transfer-ins",63,21,42,-2
102669,Alaska Pacific University,2013,"All students, Undergraduate, Other degree/certifcate-seeking, Continuing",245,81,164,-2
102669,Alaska Pacific University,2013,"All students, Undergraduate, Non-degree/certificate-seeking",47,14,33,-2
102669,Alaska Pacific University,2013,"All students, Graduate",282,103,179,-2
102845,Charter College-Anchorage,2013,All students total,2191,611,1580,-2
102845,Charter College-Anchorage,2013,"All students, Undergraduate total",2191,611,1580,-2
102845,Charter College-Anchorage,2013,"All students, Undergraduate, Degree/certificate-seeking total",2191,611,1580,-2
102845,Charter College-Anchorage,2013,"All students, Undergraduate, Degree/certificate-seeking, First-time",1053,302,751,-2
102845,Charter College-Anchorage,2013,"All students, Undergraduate, Other degree/certificate-seeking",1138,309,829,-2
102845,Charter College-Anchorage,2013,"All students, Undergraduate, Other degree/certifcate-seeking, Continuing",1138,309,829,-2
103529,University of Alaska System of Higher Education,2013,,,,,-2
125231,Walden University,2013,All students total,51016,11696,39320,-2
125231,Walden University,2013,"All students, Undergraduate total",8205,1922,6283,-2
125231,Walden University,2013,"All students, Undergraduate, Degree/certificate-seeking total",8064,1852,6212,-2
125231,Walden University,2013,"All students, Undergraduate, Degree/certificate-seeking, First-time",229,74,155,-2
125231,Walden University,2013,"All students, Undergraduate, Other degree/certificate-seeking",7835,1778,6057,-2
125231,Walden University,2013,"All students, Undergraduate, Other degree/certifcate-seeking, Transfer-ins",1451,246,1205,-2
125231,Walden University,2013,"All students, Undergraduate, Other degree/certifcate-seeking, Continuing",6384,1532,4852,-2
125231,Walden University,2013,"All students, Undergraduate, Non-degree/certificate-seeking",141,70,71,-2
125231,Walden University,2013,"All students, Graduate",42811,9774,33037,-2
126182,Adams State University,2013,All students total,3211,1406,1805,-2
126182,Adams State University,2013,"All students, Undergraduate total",2284,1133,1151,-2
126182,Adams State University,2013,"All students, Undergraduate, Degree/certificate-seeking total",2227,1112,1115,-2
126182,Adams State University,2013,"All students, Undergraduate, Degree/certificate-seeking, First-time",527,285,242,-2
126182,Adams State University,2013,"All students, Undergraduate, Other degree/certificate-seeking",1700,827,873,-2
126182,Adams State University,2013,"All students, Undergraduate, Other degree/certifcate-seeking, Transfer-ins",257,129,128,-2
126182,Adams State University,2013,"All students, Undergraduate, Other degree/certifcate-seeking, Continuing",1443,698,745,-2
126182,Adams State University,2013,"All students, Undergraduate, Non-degree/certificate-seeking",57,21,36,-2
126182,Adams State University,2013,"All students, Graduate",927,273,654,-2
126562,University of Colorado Denver,2013,All students total,22206,9657,12549,-2
126562,University of Colorado Denver,2013,"All students, Undergraduate total",13010,6060,6950,-2
126562,University of Colorado Denver,2013,"All students, Undergraduate, Degree/certificate-seeking total",10470,5004,5466,-2
126562,University of Colorado Denver,2013,"All students, Undergraduate, Degree/certificate-seeking, First-time",1180,521,659,-2
126562,University of Colorado Denver,2013,"All students, Undergraduate, Other degree/certificate-seeking",9290,4483,4807,-2
126562,University of Colorado Denver,2013,"All students, Undergraduate, Other degree/certifcate-seeking, Transfer-ins",1645,759,886,-2
126562,University of Colorado Denver,2013,"All students, Undergraduate, Other degree/certifcate-seeking, Continuing",7645,3724,3921,-2
126562,University of Colorado Denver,2013,"All students, Undergraduate, Non-degree/certificate-seeking",2540,1056,1484,-2
126562,University of Colorado Denver,2013,"All students, Graduate",9196,3597,5599,-2
126580,University of Colorado Colorado Springs,2013,All students total,11321,5304,6017,-2
126580,University of Colorado Colorado Springs,2013,"All students, Undergraduate total",9220,4357,4863,-2
126580,University of Colorado Colorado Springs,2013,"All students, Undergraduate, Degree/certificate-seeking total",8888,4182,4706,-2
126580,University of Colorado Colorado Springs,2013,"All students, Undergraduate, Degree/certificate-seeking, First-time",1618,808,810,-2
126580,University of Colorado Colorado Springs,2013,"All students, Undergraduate, Other degree/certificate-seeking",7270,3374,3896,-2
126580,University of Colorado Colorado Springs,2013,"All students, Undergraduate, Other degree/certifcate-seeking, Transfer-ins",1122,516,606,-2
126580,University of Colorado Colorado Springs,2013,"All students, Undergraduate, Other degree/certifcate-seeking, Continuing",6148,2858,3290,-2
126580,University of Colorado Colorado Springs,2013,"All students, Undergraduate, Non-degree/certificate-seeking",332,175,157,-2
126580,University of Colorado Colorado Springs,2013,"All students, Graduate",2101,947,1154,-2
126614,University of Colorado Boulder,2013,All students total,32017,17671,14346,-2
126614,University of Colorado Boulder,2013,"All students, Undergraduate total",26096,14306,11790,-2
126614,University of Colorado Boulder,2013,"All students, Undergraduate, Degree/certificate-seeking total",25461,14012,11449,-2
126614,University of Colorado Boulder,2013,"All students, Undergraduate, Degree/certificate-seeking, First-time",5840,3155,2685,-2
126614,University of Colorado Boulder,2013,"All students, Undergraduate, Other degree/certificate-seeking",19621,10857,8764,-2
126614,University of Colorado Boulder,2013,"All students, Undergraduate, Other degree/certifcate-seeking, Transfer-ins",1290,734,556,-2
126614,University of Colorado Boulder,2013,"All students, Undergraduate, Other degree/certifcate-seeking, Continuing",18331,10123,8208,-2
126614,University of Colorado Boulder,2013,"All students, Undergraduate, Non-degree/certificate-seeking",635,294,341,-2
126614,University of Colorado Boulder,2013,"All students, Graduate",5921,3365,2556,-2
126669,Colorado Christian University,2013,All students total,5368,1838,3530,-2
126669,Colorado Christian University,2013,"All students, Undergraduate total",4973,1705,3268,-2
126669,Colorado Christian University,2013,"All students, Undergraduate, Degree/certificate-seeking total",3614,1141,2473,-2
126669,Colorado Christian University,2013,"All students, Undergraduate, Degree/certificate-seeking, First-time",530,187,343,-2
126669,Colorado Christian University,2013,"All students, Undergraduate, Other degree/certificate-seeking",3084,954,2130,-2
126669,Colorado Christian University,2013,"All students, Undergraduate, Other degree/certifcate-seeking, Transfer-ins",529,153,376,-2
126669,Colorado Christian University,2013,"All students, Undergraduate, Other degree/certifcate-seeking, Continuing",2555,801,1754,-2
126669,Colorado Christian University,2013,"All students, Undergraduate, Non-degree/certificate-seeking",1359,564,795,-2
126669,Colorado Christian University,2013,"All students, Graduate",395,133,262,-2
126678,Colorado College,2013,All students total,2061,928,1133,-2
126678,Colorado College,2013,"All students, Undergraduate total",2041,921,1120,-2
126678,Colorado College,2013,"All students, Undergraduate, Degree/certificate-seeking total",2025,914,1111,-2
126678,Colorado College,2013,"All students, Undergraduate, Degree/certificate-seeking, First-time",522,224,298,-2
126678,Colorado College,2013,"All students, Undergraduate, Other degree/certificate-seeking",1503,690,813,-2
126678,Colorado College,2013,"All students, Undergraduate, Other degree/certifcate-seeking, Transfer-ins",36,15,21,-2
126678,Colorado College,2013,"All students, Undergraduate, Other degree/certifcate-seeking, Continuing",1467,675,792,-2
126678,Colorado College,2013,"All students, Undergraduate, Non-degree/certificate-seeking",16,7,9,-2
126678,Colorado College,2013,"All students, Graduate",20,7,13,-2
126702,The Art Institute of Colorado,2013,All students total,1794,986,808,-2
126702,The Art Institute of Colorado,2013,"All students, Undergraduate total",1794,986,808,-2
126702,The Art Institute of Colorado,2013,"All students, Undergraduate, Degree/certificate-seeking total",1794,986,808,-2
126702,The Art Institute of Colorado,2013,"All students, Undergraduate, Degree/certificate-seeking, First-time",289,180,109,-2
126702,The Art Institute of Colorado,2013,"All students, Undergraduate, Other degree/certificate-seeking",1505,806,699,-2
126702,The Art Institute of Colorado,2013,"All students, Undergraduate, Other degree/certifcate-seeking, Transfer-ins",334,184,150,-2
126702,The Art Institute of Colorado,2013,"All students, Undergraduate, Other degree/certifcate-seeking, Continuing",1171,622,549,-2
126711,Colorado Mountain College,2013,All students total,5893,2598,3295,-2
126711,Colorado Mountain College,2013,"All students, Undergraduate total",5893,2598,3295,-2
126711,Colorado Mountain College,2013,"All students, Undergraduate, Degree/certificate-seeking total",3559,1625,1934,-2
126711,Colorado Mountain College,2013,"All students, Undergraduate, Degree/certificate-seeking, First-time",640,377,263,-2
126711,Colorado Mountain College,2013,"All students, Undergraduate, Other degree/certificate-seeking",2919,1248,1671,-2
126711,Colorado Mountain College,2013,"All students, Undergraduate, Other degree/certifcate-seeking, Transfer-ins",300,155,145,-2
126711,Colorado Mountain College,2013,"All students, Undergraduate, Other degree/certifcate-seeking, Continuing",2619,1093,1526,-2
126711,Colorado Mountain College,2013,"All students, Undergraduate, Non-degree/certificate-seeking",2334,973,1361,-2
126775,Colorado School of Mines,2013,All students total,5790,4137,1653,-2
126775,Colorado School of Mines,2013,"All students, Undergraduate total",4291,3137,1154,-2
126775,Colorado School of Mines,2013,"All students, Undergraduate, Degree/certificate-seeking total",4197,3058,1139,-2
126775,Colorado School of Mines,2013,"All students, Undergraduate, Degree/certificate-seeking, First-time",954,682,272,-2
126775,Colorado School of Mines,2013,"All students, Undergraduate, Other degree/certificate-seeking",3243,2376,867,-2
126775,Colorado School of Mines,2013,"All students, Undergraduate, Other degree/certifcate-seeking, Transfer-ins",144,107,37,-2
126775,Colorado School of Mines,2013,"All students, Undergraduate, Other degree/certifcate-seeking, Continuing",3099,2269,830,-2
126775,Colorado School of Mines,2013,"All students, Undergraduate, Non-degree/certificate-seeking",94,79,15,-2
126775,Colorado School of Mines,2013,"All students, Graduate",1499,1000,499,-2
126818,Colorado State University-Fort Collins,2013,All students total,31186,15194,15992,-2
126818,Colorado State University-Fort Collins,2013,"All students, Undergraduate total",23548,11440,12108,-2
126818,Colorado State University-Fort Collins,2013,"All students, Undergraduate, Degree/certificate-seeking total",22482,10960,11522,-2
126818,Colorado State University-Fort Collins,2013,"All students, Undergraduate, Degree/certificate-seeking, First-time",4435,2015,2420,-2
126818,Colorado State University-Fort Collins,2013,"All students, Undergraduate, Other degree/certificate-seeking",18047,8945,9102,-2
126818,Colorado State University-Fort Collins,2013,"All students, Undergraduate, Other degree/certifcate-seeking, Transfer-ins",1426,744,682,-2
126818,Colorado State University-Fort Collins,2013,"All students, Undergraduate, Other degree/certifcate-seeking, Continuing",16621,8201,8420,-2
126818,Colorado State University-Fort Collins,2013,"All students, Undergraduate, Non-degree/certificate-seeking",1066,480,586,-2
126818,Colorado State University-Fort Collins,2013,"All students, Graduate",7638,3754,3884,-2
126827,Colorado Technical University-Colorado Springs,2013,All students total,2049,1336,713,-2
126827,Colorado Technical University-Colorado Springs,2013,"All students, Undergraduate total",1216,790,426,-2
126827,Colorado Technical University-Colorado Springs,2013,"All students, Undergraduate, Degree/certificate-seeking total",1200,775,425,-2
126827,Colorado Technical University-Colorado Springs,2013,"All students, Undergraduate, Degree/certificate-seeking, First-time",78,45,33,-2
126827,Colorado Technical University-Colorado Springs,2013,"All students, Undergraduate, Other degree/certificate-seeking",1122,730,392,-2
126827,Colorado Technical University-Colorado Springs,2013,"All students, Undergraduate, Other degree/certifcate-seeking, Transfer-ins",126,65,61,-2
126827,Colorado Technical University-Colorado Springs,2013,"All students, Undergraduate, Other degree/certifcate-seeking, Continuing",996,665,331,-2
126827,Colorado Technical University-Colorado Springs,2013,"All students, Undergraduate, Non-degree/certificate-seeking",16,15,1,-2
126827,Colorado Technical University-Colorado Springs,2013,"All students, Graduate",833,546,287,-2
126872,College America-Denver,2013,All students total,497,107,390,-2
126872,College America-Denver,2013,"All students, Undergraduate total",497,107,390,-2
126872,College America-Denver,2013,"All students, Undergraduate, Degree/certificate-seeking total",497,107,390,-2
126872,College America-Denver,2013,"All students, Undergraduate, Degree/certificate-seeking, First-time",107,17,90,-2
126872,College America-Denver,2013,"All students, Undergraduate, Other degree/certificate-seeking",390,90,300,-2
126872,College America-Denver,2013,"All students, Undergraduate, Other degree/certifcate-seeking, Transfer-ins",5,0,5,-2
126872,College America-Denver,2013,"All students, Undergraduate, Other degree/certifcate-seeking, Continuing",385,90,295,-2
126979,Denver Seminary,2013,All students total,990,582,408,-2
126979,Denver Seminary,2013,"All students, Graduate",990,582,408,-2
127024,Westwood College-Denver North,2013,All students total,438,256,182,-2
127024,Westwood College-Denver North,2013,"All students, Undergraduate total",438,256,182,-2
127024,Westwood College-Denver North,2013,"All students, Undergraduate, Degree/certificate-seeking total",438,256,182,-2
127024,Westwood College-Denver North,2013,"All students, Undergraduate, Degree/certificate-seeking, First-time",33,19,14,-2
127024,Westwood College-Denver North,2013,"All students, Undergraduate, Other degree/certificate-seeking",405,237,168,-2
127024,Westwood College-Denver North,2013,"All students, Undergraduate, Other degree/certifcate-seeking, Continuing",405,237,168,-2
127060,University of Denver,2013,All students total,11778,5128,6650,-2
127060,University of Denver,2013,"All students, Undergraduate total",5517,2499,3018,-2
127060,University of Denver,2013,"All students, Undergraduate, Degree/certificate-seeking total",5505,2494,3011,-2
127060,University of Denver,2013,"All students, Undergraduate, Degree/certificate-seeking, First-time",1407,667,740,-2
127060,University of Denver,2013,"All students, Undergraduate, Other degree/certificate-seeking",4098,1827,2271,-2
127060,University of Denver,2013,"All students, Undergraduate, Other degree/certifcate-seeking, Transfer-ins",221,109,112,-2
127060,University of Denver,2013,"All students, Undergraduate, Other degree/certifcate-seeking, Continuing",3877,1718,2159,-2
127060,University of Denver,2013,"All students, Undergraduate, Non-degree/certificate-seeking",12,5,7,-2
127060,University of Denver,2013,"All students, Graduate",6261,2629,3632,-2
127185,Fort Lewis College,2013,All students total,4021,2050,1971,-2
127185,Fort Lewis College,2013,"All students, Undergraduate total",3984,2043,1941,-2
127185,Fort Lewis College,2013,"All students, Undergraduate, Degree/certificate-seeking total",3859,1979,1880,-2
127185,Fort Lewis College,2013,"All students, Undergraduate, Degree/certificate-seeking, First-time",873,465,408,-2
127185,Fort Lewis College,2013,"All students, Undergraduate, Other degree/certificate-seeking",2986,1514,1472,-2
127185,Fort Lewis College,2013,"All students, Undergraduate, Other degree/certifcate-seeking, Transfer-ins",414,220,194,-2
127185,Fort Lewis College,2013,"All students, Undergraduate, Other degree/certifcate-seeking, Continuing",2572,1294,1278,-2
127185,Fort Lewis College,2013,"All students, Undergraduate, Non-degree/certificate-seeking",125,64,61,-2
127185,Fort Lewis College,2013,"All students, Graduate",37,7,30,-2
127273,Iliff School of Theology,2013,All students total,349,148,201,-2
127273,Iliff School of Theology,2013,"All students, Graduate",349,148,201,-2
127556,Colorado Mesa University,2013,All students total,9676,4330,5346,-2
127556,Colorado Mesa University,2013,"All students, Undergraduate total",9576,4292,5284,-2
127556,Colorado Mesa University,2013,"All students, Undergraduate, Degree/certificate-seeking total",8733,3995,4738,-2
127556,Colorado Mesa University,2013,"All students, Undergraduate, Degree/certificate-seeking, First-time",2208,1099,1109,-2
127556,Colorado Mesa University,2013,"All students, Undergraduate, Other degree/certificate-seeking",6525,2896,3629,-2
127556,Colorado Mesa University,2013,"All students, Undergraduate, Other degree/certifcate-seeking, Transfer-ins",579,252,327,-2
127556,Colorado Mesa University,2013,"All students, Undergraduate, Other degree/certifcate-seeking, Continuing",5946,2644,3302,-2
127556,Colorado Mesa University,2013,"All students, Undergraduate, Non-degree/certificate-seeking",843,297,546,-2
127556,Colorado Mesa University,2013,"All students, Graduate",100,38,62,-2
127565,Metropolitan State University of Denver,2013,All students total,22752,10441,12311,-2
127565,Metropolitan State University of Denver,2013,"All students, Undergraduate total",22289,10328,11961,-2
127565,Metropolitan State University of Denver,2013,"All students, Undergraduate, Degree/certificate-seeking total",21696,10120,11576,-2
127565,Metropolitan State University of Denver,2013,"All students, Undergraduate, Degree/certificate-seeking, First-time",2234,1154,1080,-2
127565,Metropolitan State University of Denver,2013,"All students, Undergraduate, Other degree/certificate-seeking",19462,8966,10496,-2
127565,Metropolitan State University of Denver,2013,"All students, Undergraduate, Other degree/certifcate-seeking, Transfer-ins",2860,1245,1615,-2
127565,Metropolitan State University of Denver,2013,"All students, Undergraduate, Other degree/certifcate-seeking, Continuing",16602,7721,8881,-2
127565,Metropolitan State University of Denver,2013,"All students, Undergraduate, Non-degree/certificate-seeking",593,208,385,-2
127565,Metropolitan State University of Denver,2013,"All students, Graduate",463,113,350,-2
127653,Naropa University,2013,All students total,992,328,664,-2
127653,Naropa University,2013,"All students, Undergraduate total",383,138,245,-2
127653,Naropa University,2013,"All students, Undergraduate, Degree/certificate-seeking total",380,137,243,-2
127653,Naropa University,2013,"All students, Undergraduate, Degree/certificate-seeking, First-time",37,17,20,-2
127653,Naropa University,2013,"All students, Undergraduate, Other degree/certificate-seeking",343,120,223,-2
127653,Naropa University,2013,"All students, Undergraduate, Other degree/certifcate-seeking, Transfer-ins",92,36,56,-2
127653,Naropa University,2013,"All students, Undergraduate, Other degree/certifcate-seeking, Continuing",251,84,167,-2
127653,Naropa University,2013,"All students, Undergraduate, Non-degree/certificate-seeking",3,1,2,-2
127653,Naropa University,2013,"All students, Graduate",609,190,419,-2
127680,National American University-Colorado Springs,2013,All students total,281,110,171,-2
127680,National American University-Colorado Springs,2013,"All students, Undergraduate total",281,110,171,-2
127680,National American University-Colorado Springs,2013,"All students, Undergraduate, Degree/certificate-seeking total",281,110,171,-2
127680,National American University-Colorado Springs,2013,"All students, Undergraduate, Degree/certificate-seeking, First-time",21,11,10,-2
127680,National American University-Colorado Springs,2013,"All students, Undergraduate, Other degree/certificate-seeking",260,99,161,-2
127680,National American University-Colorado Springs,2013,"All students, Undergraduate, Other degree/certifcate-seeking, Transfer-ins",55,15,40,-2
127680,National American University-Colorado Springs,2013,"All students, Undergraduate, Other degree/certifcate-seeking, Continuing",205,84,121,-2
127699,National American University-Denver,2013,All students total,258,58,200,-2
127699,National American University-Denver,2013,"All students, Undergraduate total",258,58,200,-2
127699,National American University-Denver,2013,"All students, Undergraduate, Degree/certificate-seeking total",258,58,200,-2
127699,National American University-Denver,2013,"All students, Undergraduate, Degree/certificate-seeking, First-time",15,5,10,-2
127699,National American University-Denver,2013,"All students, Undergraduate, Other degree/certificate-seeking",243,53,190,-2
127699,National American University-Denver,2013,"All students, Undergraduate, Other degree/certifcate-seeking, Transfer-ins",64,19,45,-2
127699,National American University-Denver,2013,"All students, Undergraduate, Other degree/certifcate-seeking, Continuing",179,34,145,-2
127714,Nazarene Bible College,2013,All students total,889,542,347,-2
127714,Nazarene Bible College,2013,"All students, Undergraduate total",889,542,347,-2
127714,Nazarene Bible College,2013,"All students, Undergraduate, Degree/certificate-seeking total",889,542,347,-2
127714,Nazarene Bible College,2013,"All students, Undergraduate, Degree/certificate-seeking, First-time",39,28,11,-2
127714,Nazarene Bible College,2013,"All students, Undergraduate, Other degree/certificate-seeking",850,514,336,-2
127714,Nazarene Bible College,2013,"All students, Undergraduate, Other degree/certifcate-seeking, Transfer-ins",236,140,96,-2
127714,Nazarene Bible College,2013,"All students, Undergraduate, Other degree/certifcate-seeking, Continuing",614,374,240,-2
127741,University of Northern Colorado,2013,All students total,12710,4446,8264,-2
127741,University of Northern Colorado,2013,"All students, Undergraduate total",9947,3686,6261,-2
127741,University of Northern Colorado,2013,"All students, Undergraduate, Degree/certificate-seeking total",9525,3517,6008,-2
127741,University of Northern Colorado,2013,"All students, Undergraduate, Degree/certificate-seeking, First-time",1982,725,1257,-2
127741,University of Northern Colorado,2013,"All students, Undergraduate, Other degree/certificate-seeking",7543,2792,4751,-2
127741,University of Northern Colorado,2013,"All students, Undergraduate, Other degree/certifcate-seeking, Transfer-ins",798,270,528,-2
127741,University of Northern Colorado,2013,"All students, Undergraduate, Other degree/certifcate-seeking, Continuing",6745,2522,4223,-2
127741,University of Northern Colorado,2013,"All students, Undergraduate, Non-degree/certificate-seeking",422,169,253,-2
127741,University of Northern Colorado,2013,"All students, Graduate",2763,760,2003,-2
127918,Regis University,2013,All students total,9722,3526,6196,-2
127918,Regis University,2013,"All students, Undergraduate total",5172,1929,3243,-2
127918,Regis University,2013,"All students, Undergraduate, Degree/certificate-seeking total",4930,1809,3121,-2
127918,Regis University,2013,"All students, Undergraduate, Degree/certificate-seeking, First-time",390,135,255,-2
127918,Regis University,2013,"All students, Undergraduate, Other degree/certificate-seeking",4540,1674,2866,-2
127918,Regis University,2013,"All students, Undergraduate, Other degree/certifcate-seeking, Transfer-ins",507,211,296,-2
127918,Regis University,2013,"All students, Undergraduate, Other degree/certifcate-seeking, Continuing",4033,1463,2570,-2
127918,Regis University,2013,"All students, Undergraduate, Non-degree/certificate-seeking",242,120,122,-2
127918,Regis University,2013,"All students, Graduate",4550,1597,2953,-2
127945,Rocky Mountain College of Art and Design,2013,All students total,775,284,491,-2
127945,Rocky Mountain College of Art and Design,2013,"All students, Undergraduate total",739,272,467,-2
127945,Rocky Mountain College of Art and Design,2013,"All students, Undergraduate, Degree/certificate-seeking total",722,262,460,-2
127945,Rocky Mountain College of Art and Design,2013,"All students, Undergraduate, Degree/certificate-seeking, First-time",64,27,37,-2
127945,Rocky Mountain College of Art and Design,2013,"All students, Undergraduate, Other degree/certificate-seeking",658,235,423,-2
127945,Rocky Mountain College of Art and Design,2013,"All students, Undergraduate, Other degree/certifcate-seeking, Transfer-ins",222,87,135,-2
127945,Rocky Mountain College of Art and Design,2013,"All students, Undergraduate, Other degree/certifcate-seeking, Continuing",436,148,288,-2
127945,Rocky Mountain College of Art and Design,2013,"All students, Undergraduate, Non-degree/certificate-seeking",17,10,7,-2
127945,Rocky Mountain College of Art and Design,2013,"All students, Graduate",36,12,24,-2
127954,Montessori Education Center of the Rockies,2013,All students total,79,6,73,-2
127954,Montessori Education Center of the Rockies,2013,"All students, Undergraduate total",11,0,11,-2
127954,Montessori Education Center of the Rockies,2013,"All students, Undergraduate, Degree/certificate-seeking total",11,0,11,-2
127954,Montessori Education Center of the Rockies,2013,"All students, Undergraduate, Degree/certificate-seeking, First-time",3,0,3,-2
127954,Montessori Education Center of the Rockies,2013,"All students, Undergraduate, Other degree/certificate-seeking",8,0,8,-2
127954,Montessori Education Center of the Rockies,2013,"All students, Undergraduate, Other degree/certifcate-seeking, Continuing",8,0,8,-2
127954,Montessori Education Center of the Rockies,2013,"All students, Graduate",68,6,62,-2
128106,Colorado State University-Pueblo,2013,All students total,7089,2688,4401,-2
128106,Colorado State University-Pueblo,2013,"All students, Undergraduate total",5207,2314,2893,-2
128106,Colorado State University-Pueblo,2013,"All students, Undergraduate, Degree/certificate-seeking total",4375,2023,2352,-2
128106,Colorado State University-Pueblo,2013,"All students, Undergraduate, Degree/certificate-seeking, First-time",793,382,411,-2
128106,Colorado State University-Pueblo,2013,"All students, Undergraduate, Other degree/certificate-seeking",3582,1641,1941,-2
128106,Colorado State University-Pueblo,2013,"All students, Undergraduate, Other degree/certifcate-seeking, Transfer-ins",411,174,237,-2
128106,Colorado State University-Pueblo,2013,"All students, Undergraduate, Other degree/certifcate-seeking, Continuing",3171,1467,1704,-2
128106,Colorado State University-Pueblo,2013,"All students, Undergraduate, Non-degree/certificate-seeking",832,291,541,-2
128106,Colorado State University-Pueblo,2013,"All students, Graduate",1882,374,1508,-2
128300,University of Colorado System Office,2013,,,,,-2
128328,United States Air Force Academy,2013,All students total,3993,3097,896,-2
128328,United States Air Force Academy,2013,"All students, Undergraduate total",3993,3097,896,-2
128328,United States Air Force Academy,2013,"All students, Undergraduate, Degree/certificate-seeking total",3993,3097,896,-2
128328,United States Air Force Academy,2013,"All students, Undergraduate, Degree/certificate-seeking, First-time",1154,887,267,-2
128328,United States Air Force Academy,2013,"All students, Undergraduate, Other degree/certificate-seeking",2839,2210,629,-2
128328,United States Air Force Academy,2013,"All students, Undergraduate, Other degree/certifcate-seeking, Continuing",2839,2210,629,-2
128391,Western State Colorado University,2013,All students total,2404,1330,1074,-2
128391,Western State Colorado University,2013,"All students, Undergraduate total",2193,1269,924,-2
128391,Western State Colorado University,2013,"All students, Undergraduate, Degree/certificate-seeking total",1956,1157,799,-2
128391,Western State Colorado University,2013,"All students, Undergraduate, Degree/certificate-seeking, First-time",469,256,213,-2
128391,Western State Colorado University,2013,"All students, Undergraduate, Other degree/certificate-seeking",1487,901,586,-2
128391,Western State Colorado University,2013,"All students, Undergraduate, Other degree/certifcate-seeking, Transfer-ins",155,96,59,-2
128391,Western State Colorado University,2013,"All students, Undergraduate, Other degree/certifcate-seeking, Continuing",1332,805,527,-2
128391,Western State Colorado University,2013,"All students, Undergraduate, Non-degree/certificate-seeking",237,112,125,-2
128391,Western State Colorado University,2013,"All students, Graduate",211,61,150,-2
128425,Yeshiva Toras Chaim Talmudical Seminary,2013,All students total,18,18,0,-2
128425,Yeshiva Toras Chaim Talmudical Seminary,2013,"All students, Undergraduate total",16,16,0,-2
128425,Yeshiva Toras Chaim Talmudical Seminary,2013,"All students, Undergraduate, Degree/certificate-seeking total",16,16,0,-2
128425,Yeshiva Toras Chaim Talmudical Seminary,2013,"All students, Undergraduate, Degree/certificate-seeking, First-time",7,7,0,-2
128425,Yeshiva Toras Chaim Talmudical Seminary,2013,"All students, Undergraduate, Other degree/certificate-seeking",9,9,0,-2
128425,Yeshiva Toras Chaim Talmudical Seminary,2013,"All students, Undergraduate, Other degree/certifcate-seeking, Continuing",9,9,0,-2
128425,Yeshiva Toras Chaim Talmudical Seminary,2013,"All students, Graduate",2,2,0,-2
128498,Albertus Magnus College,2013,All students total,1582,520,1062,-2
128498,Albertus Magnus College,2013,"All students, Undergraduate total",1278,443,835,-2
128498,Albertus Magnus College,2013,"All students, Undergraduate, Degree/certificate-seeking total",1278,443,835,-2
128498,Albertus Magnus College,2013,"All students, Undergraduate, Degree/certificate-seeking, First-time",143,65,78,-2
128498,Albertus Magnus College,2013,"All students, Undergraduate, Other degree/certificate-seeking",1135,378,757,-2
128498,Albertus Magnus College,2013,"All students, Undergraduate, Other degree/certifcate-seeking, Transfer-ins",144,52,92,-2
128498,Albertus Magnus College,2013,"All students, Undergraduate, Other degree/certifcate-seeking, Continuing",991,326,665,-2
128498,Albertus Magnus College,2013,"All students, Graduate",304,77,227,-2
128683,Lincoln College of New England-Southington,2013,All students total,837,216,621,-2
128683,Lincoln College of New England-Southington,2013,"All students, Undergraduate total",837,216,621,-2
128683,Lincoln College of New England-Southington,2013,"All students, Undergraduate, Degree/certificate-seeking total",837,216,621,-2
128683,Lincoln College of New England-Southington,2013,"All students, Undergraduate, Degree/certificate-seeking, First-time",179,67,112,-2
128683,Lincoln College of New England-Southington,2013,"All students, Undergraduate, Other degree/certificate-seeking",658,149,509,-2
128683,Lincoln College of New England-Southington,2013,"All students, Undergraduate, Other degree/certifcate-seeking, Transfer-ins",80,22,58,-2
128683,Lincoln College of New England-Southington,2013,"All students, Undergraduate, Other degree/certifcate-seeking, Continuing",578,127,451,-2
128744,University of Bridgeport,2013,All students total,4842,1820,3022,-2
128744,University of Bridgeport,2013,"All students, Undergraduate total",2835,959,1876,-2
128744,University of Bridgeport,2013,"All students, Undergraduate, Degree/certificate-seeking total",2835,959,1876,-2
128744,University of Bridgeport,2013,"All students, Undergraduate, Degree/certificate-seeking, First-time",542,212,330,-2
128744,University of Bridgeport,2013,"All students, Undergraduate, Other degree/certificate-seeking",2293,747,1546,-2
128744,University of Bridgeport,2013,"All students, Undergraduate, Other degree/certifcate-seeking, Transfer-ins",254,89,165,-2
128744,University of Bridgeport,2013,"All students, Undergraduate, Other degree/certifcate-seeking, Continuing",2039,658,1381,-2
128744,University of Bridgeport,2013,"All students, Graduate",2007,861,1146,-2
128771,Central Connecticut State University,2013,All students total,11865,5828,6037,-2
128771,Central Connecticut State University,2013,"All students, Undergraduate total",9771,5108,4663,-2
128771,Central Connecticut State University,2013,"All students, Undergraduate, Degree/certificate-seeking total",9512,4956,4556,-2
128771,Central Connecticut State University,2013,"All students, Undergraduate, Degree/certificate-seeking, First-time",1293,678,615,-2
128771,Central Connecticut State University,2013,"All students, Undergraduate, Other degree/certificate-seeking",8219,4278,3941,-2
128771,Central Connecticut State University,2013,"All students, Undergraduate, Other degree/certifcate-seeking, Transfer-ins",1072,521,551,-2
128771,Central Connecticut State University,2013,"All students, Undergraduate, Other degree/certifcate-seeking, Continuing",7147,3757,3390,-2
128771,Central Connecticut State University,2013,"All students, Undergraduate, Non-degree/certificate-seeking",259,152,107,-2
128771,Central Connecticut State University,2013,"All students, Graduate",2094,720,1374,-2
128780,Charter Oak State College,2013,All students total,1580,542,1038,-2
128780,Charter Oak State College,2013,"All students, Undergraduate total",1580,542,1038,-2
128780,Charter Oak State College,2013,"All students, Undergraduate, Degree/certificate-seeking total",1471,508,963,-2
128780,Charter Oak State College,2013,"All students, Undergraduate, Other degree/certificate-seeking",1471,508,963,-2
128780,Charter Oak State College,2013,"All students, Undergraduate, Other degree/certifcate-seeking, Transfer-ins",463,178,285,-2
128780,Charter Oak State College,2013,"All students, Undergraduate, Other degree/certifcate-seeking, Continuing",1008,330,678,-2
128780,Charter Oak State College,2013,"All students, Undergraduate, Non-degree/certificate-seeking",109,34,75,-2
128902,Connecticut College,2013,All students total,1922,759,1163,-2
128902,Connecticut College,2013,"All students, Undergraduate total",1915,755,1160,-2
128902,Connecticut College,2013,"All students, Undergraduate, Degree/certificate-seeking total",1878,742,1136,-2
128902,Connecticut College,2013,"All students, Undergraduate, Degree/certificate-seeking, First-time",489,181,308,-2
128902,Connecticut College,2013,"All students, Undergraduate, Other degree/certificate-seeking",1389,561,828,-2
128902,Connecticut College,2013,"All students, Undergraduate, Other degree/certifcate-seeking, Transfer-ins",14,5,9,-2
128902,Connecticut College,2013,"All students, Undergraduate, Other degree/certifcate-seeking, Continuing",1375,556,819,-2
128902,Connecticut College,2013,"All students, Undergraduate, Non-degree/certificate-seeking",37,13,24,-2
128902,Connecticut College,2013,"All students, Graduate",7,4,3,-2
129020,University of Connecticut,2013,All students total,25911,12957,12954,-2
129020,University of Connecticut,2013,"All students, Undergraduate total",18032,9177,8855,-2
129020,University of Connecticut,2013,"All students, Undergraduate, Degree/certificate-seeking total",17684,8957,8727,-2
129020,University of Connecticut,2013,"All students, Undergraduate, Degree/certificate-seeking, First-time",3755,1866,1889,-2
129020,University of Connecticut,2013,"All students, Undergraduate, Other degree/certificate-seeking",13929,7091,6838,-2
129020,University of Connecticut,2013,"All students, Undergraduate, Other degree/certifcate-seeking, Transfer-ins",785,376,409,-2
129020,University of Connecticut,2013,"All students, Undergraduate, Other degree/certifcate-seeking, Continuing",13144,6715,6429,-2
129020,University of Connecticut,2013,"All students, Undergraduate, Non-degree/certificate-seeking",348,220,128,-2
129020,University of Connecticut,2013,"All students, Graduate",7879,3780,4099,-2
129154,Goodwin College,2013,All students total,3388,581,2807,-2
129154,Goodwin College,2013,"All students, Undergraduate total",3388,581,2807,-2
129154,Goodwin College,2013,"All students, Undergraduate, Degree/certificate-seeking total",3269,531,2738,-2
129154,Goodwin College,2013,"All students, Undergraduate, Degree/certificate-seeking, First-time",250,50,200,-2
129154,Goodwin College,2013,"All students, Undergraduate, Other degree/certificate-seeking",3019,481,2538,-2
129154,Goodwin College,2013,"All students, Undergraduate, Other degree/certifcate-seeking, Transfer-ins",708,131,577,-2
129154,Goodwin College,2013,"All students, Undergraduate, Other degree/certifcate-seeking, Continuing",2311,350,1961,-2
129154,Goodwin College,2013,"All students, Undergraduate, Non-degree/certificate-seeking",119,50,69,-2
129215,Eastern Connecticut State University,2013,All students total,5368,2444,2924,-2
129215,Eastern Connecticut State University,2013,"All students, Undergraduate total",5179,2396,2783,-2
129215,Eastern Connecticut State University,2013,"All students, Undergraduate, Degree/certificate-seeking total",4920,2263,2657,-2
129215,Eastern Connecticut State University,2013,"All students, Undergraduate, Degree/certificate-seeking, First-time",985,430,555,-2
129215,Eastern Connecticut State University,2013,"All students, Undergraduate, Other degree/certificate-seeking",3935,1833,2102,-2
129215,Eastern Connecticut State University,2013,"All students, Undergraduate, Other degree/certifcate-seeking, Transfer-ins",499,240,259,-2
129215,Eastern Connecticut State University,2013,"All students, Undergraduate, Other degree/certifcate-seeking, Continuing",3436,1593,1843,-2
129215,Eastern Connecticut State University,2013,"All students, Undergraduate, Non-degree/certificate-seeking",259,133,126,-2
129215,Eastern Connecticut State University,2013,"All students, Graduate",189,48,141,-2
129242,Fairfield University,2013,All students total,4919,1905,3014,-2
129242,Fairfield University,2013,"All students, Undergraduate total",3873,1566,2307,-2
129242,Fairfield University,2013,"All students, Undergraduate, Degree/certificate-seeking total",3721,1504,2217,-2
129242,Fairfield University,2013,"All students, Undergraduate, Degree/certificate-seeking, First-time",963,374,589,-2
129242,Fairfield University,2013,"All students, Undergraduate, Other degree/certificate-seeking",2758,1130,1628,-2
129242,Fairfield University,2013,"All students, Undergraduate, Other degree/certifcate-seeking, Transfer-ins",41,27,14,-2
129242,Fairfield University,2013,"All students, Undergraduate, Other degree/certifcate-seeking, Continuing",2717,1103,1614,-2
129242,Fairfield University,2013,"All students, Undergraduate, Non-degree/certificate-seeking",152,62,90,-2
129242,Fairfield University,2013,"All students, Graduate",1046,339,707,-2
129428,Rensselaer Hartford Graduate Center Inc,2013,All students total,281,224,57,-2
129428,Rensselaer Hartford Graduate Center Inc,2013,"All students, Graduate",281,224,57,-2
129491,Hartford Seminary,2013,All students total,123,67,56,-2
129491,Hartford Seminary,2013,"All students, Graduate",123,67,56,-2
129525,University of Hartford,2013,All students total,6820,3228,3592,-2
129525,University of Hartford,2013,"All students, Undergraduate total",5187,2589,2598,-2
129525,University of Hartford,2013,"All students, Undergraduate, Degree/certificate-seeking total",5026,2511,2515,-2
129525,University of Hartford,2013,"All students, Undergraduate, Degree/certificate-seeking, First-time",1267,645,622,-2
129525,University of Hartford,2013,"All students, Undergraduate, Other degree/certificate-seeking",3759,1866,1893,-2
129525,University of Hartford,2013,"All students, Undergraduate, Other degree/certifcate-seeking, Transfer-ins",226,109,117,-2
129525,University of Hartford,2013,"All students, Undergraduate, Other degree/certifcate-seeking, Continuing",3533,1757,1776,-2
129525,University of Hartford,2013,"All students, Undergraduate, Non-degree/certificate-seeking",161,78,83,-2
129525,University of Hartford,2013,"All students, Graduate",1633,639,994,-2
129534,Holy Apostles College and Seminary,2013,All students total,385,269,116,-2
129534,Holy Apostles College and Seminary,2013,"All students, Undergraduate total",58,32,26,-2
129534,Holy Apostles College and Seminary,2013,"All students, Undergraduate, Degree/certificate-seeking total",48,26,22,-2
129534,Holy Apostles College and Seminary,2013,"All students, Undergraduate, Degree/certificate-seeking, First-time",1,0,1,-2
129534,Holy Apostles College and Seminary,2013,"All students, Undergraduate, Other degree/certificate-seeking",47,26,21,-2
129534,Holy Apostles College and Seminary,2013,"All students, Undergraduate, Other degree/certifcate-seeking, Transfer-ins",2,2,0,-2
129534,Holy Apostles College and Seminary,2013,"All students, Undergraduate, Other degree/certifcate-seeking, Continuing",45,24,21,-2
129534,Holy Apostles College and Seminary,2013,"All students, Undergraduate, Non-degree/certificate-seeking",10,6,4,-2
129534,Holy Apostles College and Seminary,2013,"All students, Graduate",327,237,90,-2
129686,Lyme Academy College of Fine Arts,2013,All students total,77,28,49,-2
129686,Lyme Academy College of Fine Arts,2013,"All students, Undergraduate total",77,28,49,-2
129686,Lyme Academy College of Fine Arts,2013,"All students, Undergraduate, Degree/certificate-seeking total",77,28,49,-2
129686,Lyme Academy College of Fine Arts,2013,"All students, Undergraduate, Degree/certificate-seeking, First-time",17,6,11,-2
129686,Lyme Academy College of Fine Arts,2013,"All students, Undergraduate, Other degree/certificate-seeking",60,22,38,-2
129686,Lyme Academy College of Fine Arts,2013,"All students, Undergraduate, Other degree/certifcate-seeking, Transfer-ins",5,1,4,-2
129686,Lyme Academy College of Fine Arts,2013,"All students, Undergraduate, Other degree/certifcate-seeking, Continuing",55,21,34,-2
129774,Mitchell College,2013,All students total,866,464,402,-2
129774,Mitchell College,2013,"All students, Undergraduate total",866,464,402,-2
129774,Mitchell College,2013,"All students, Undergraduate, Degree/certificate-seeking total",802,426,376,-2
129774,Mitchell College,2013,"All students, Undergraduate, Degree/certificate-seeking, First-time",178,101,77,-2
129774,Mitchell College,2013,"All students, Undergraduate, Other degree/certificate-seeking",624,325,299,-2
129774,Mitchell College,2013,"All students, Undergraduate, Other degree/certifcate-seeking, Transfer-ins",76,37,39,-2
129774,Mitchell College,2013,"All students, Undergraduate, Other degree/certifcate-seeking, Continuing",548,288,260,-2
129774,Mitchell College,2013,"All students, Undergraduate, Non-degree/certificate-seeking",64,38,26,-2
129941,University of New Haven,2013,All students total,6555,3300,3255,-2
129941,University of New Haven,2013,"All students, Undergraduate total",4864,2457,2407,-2
129941,University of New Haven,2013,"All students, Undergraduate, Degree/certificate-seeking total",4759,2408,2351,-2
129941,University of New Haven,2013,"All students, Undergraduate, Degree/certificate-seeking, First-time",1174,556,618,-2
129941,University of New Haven,2013,"All students, Undergraduate, Other degree/certificate-seeking",3585,1852,1733,-2
129941,University of New Haven,2013,"All students, Undergraduate, Other degree/certifcate-seeking, Transfer-ins",263,147,116,-2
129941,University of New Haven,2013,"All students, Undergraduate, Other degree/certifcate-seeking, Continuing",3322,1705,1617,-2
129941,University of New Haven,2013,"All students, Undergraduate, Non-degree/certificate-seeking",105,49,56,-2
129941,University of New Haven,2013,"All students, Graduate",1691,843,848,-2
130110,Paier College of Art Inc,2013,All students total,155,52,103,-2
130110,Paier College of Art Inc,2013,"All students, Undergraduate total",155,52,103,-2
130110,Paier College of Art Inc,2013,"All students, Undergraduate, Degree/certificate-seeking total",137,40,97,-2
130110,Paier College of Art Inc,2013,"All students, Undergraduate, Degree/certificate-seeking, First-time",20,5,15,-2
130110,Paier College of Art Inc,2013,"All students, Undergraduate, Other degree/certificate-seeking",117,35,82,-2
130110,Paier College of Art Inc,2013,"All students, Undergraduate, Other degree/certifcate-seeking, Transfer-ins",12,1,11,-2
130110,Paier College of Art Inc,2013,"All students, Undergraduate, Other degree/certifcate-seeking, Continuing",105,34,71,-2
130110,Paier College of Art Inc,2013,"All students, Undergraduate, Non-degree/certificate-seeking",18,12,6,-2
130183,Post University,2013,All students total,8082,3253,4829,-2
130183,Post University,2013,"All students, Undergraduate total",7371,3032,4339,-2
130183,Post University,2013,"All students, Undergraduate, Degree/certificate-seeking total",6616,2757,3859,-2
130183,Post University,2013,"All students, Undergraduate, Degree/certificate-seeking, First-time",1036,357,679,-2
130183,Post University,2013,"All students, Undergraduate, Other degree/certificate-seeking",5580,2400,3180,-2
130183,Post University,2013,"All students, Undergraduate, Other degree/certifcate-seeking, Transfer-ins",909,445,464,-2
130183,Post University,2013,"All students, Undergraduate, Other degree/certifcate-seeking, Continuing",4671,1955,2716,-2
130183,Post University,2013,"All students, Undergraduate, Non-degree/certificate-seeking",755,275,480,-2
130183,Post University,2013,"All students, Graduate",711,221,490,-2
130226,Quinnipiac University,2013,All students total,8803,3275,5528,-2
130226,Quinnipiac University,2013,"All students, Undergraduate total",6542,2496,4046,-2
130226,Quinnipiac University,2013,"All students, Undergraduate, Degree/certificate-seeking total",6486,2478,4008,-2
130226,Quinnipiac University,2013,"All students, Undergraduate, Degree/certificate-seeking, First-time",1800,664,1136,-2
130226,Quinnipiac University,2013,"All students, Undergraduate, Other degree/certificate-seeking",4686,1814,2872,-2
130226,Quinnipiac University,2013,"All students, Undergraduate, Other degree/certifcate-seeking, Transfer-ins",207,77,130,-2
130226,Quinnipiac University,2013,"All students, Undergraduate, Other degree/certifcate-seeking, Continuing",4479,1737,2742,-2
130226,Quinnipiac University,2013,"All students, Undergraduate, Non-degree/certificate-seeking",56,18,38,-2
130226,Quinnipiac University,2013,"All students, Graduate",2261,779,1482,-2
130253,Sacred Heart University,2013,All students total,6983,2265,4718,-2
130253,Sacred Heart University,2013,"All students, Undergraduate total",4489,1621,2868,-2
130253,Sacred Heart University,2013,"All students, Undergraduate, Degree/certificate-seeking total",4409,1582,2827,-2
130253,Sacred Heart University,2013,"All students, Undergraduate, Degree/certificate-seeking, First-time",1267,444,823,-2
130253,Sacred Heart University,2013,"All students, Undergraduate, Other degree/certificate-seeking",3142,1138,2004,-2
130253,Sacred Heart University,2013,"All students, Undergraduate, Other degree/certifcate-seeking, Transfer-ins",102,51,51,-2
130253,Sacred Heart University,2013,"All students, Undergraduate, Other degree/certifcate-seeking, Continuing",3040,1087,1953,-2
130253,Sacred Heart University,2013,"All students, Undergraduate, Non-degree/certificate-seeking",80,39,41,-2
130253,Sacred Heart University,2013,"All students, Graduate",2494,644,1850,-2
130314,University of Saint Joseph,2013,All students total,2640,271,2369,-2
130314,University of Saint Joseph,2013,"All students, Undergraduate total",1049,21,1028,-2
130314,University of Saint Joseph,2013,"All students, Undergraduate, Degree/certificate-seeking total",971,12,959,-2
130314,University of Saint Joseph,2013,"All students, Undergraduate, Degree/certificate-seeking, First-time",153,0,153,-2
130314,University of Saint Joseph,2013,"All students, Undergraduate, Other degree/certificate-seeking",818,12,806,-2
130314,University of Saint Joseph,2013,"All students, Undergraduate, Other degree/certifcate-seeking, Transfer-ins",97,3,94,-2
130314,University of Saint Joseph,2013,"All students, Undergraduate, Other degree/certifcate-seeking, Continuing",721,9,712,-2
130314,University of Saint Joseph,2013,"All students, Undergraduate, Non-degree/certificate-seeking",78,9,69,-2
130314,University of Saint Joseph,2013,"All students, Graduate",1591,250,1341,-2
130448,St Vincent's College,2013,All students total,827,103,724,-2
130448,St Vincent's College,2013,"All students, Undergraduate total",827,103,724,-2
130448,St Vincent's College,2013,"All students, Undergraduate, Degree/certificate-seeking total",772,94,678,-2
130448,St Vincent's College,2013,"All students, Undergraduate, Degree/certificate-seeking, First-time",18,2,16,-2
130448,St Vincent's College,2013,"All students, Undergraduate, Other degree/certificate-seeking",754,92,662,-2
130448,St Vincent's College,2013,"All students, Undergraduate, Other degree/certifcate-seeking, Transfer-ins",124,12,112,-2
130448,St Vincent's College,2013,"All students, Undergraduate, Other degree/certifcate-seeking, Continuing",630,80,550,-2
130448,St Vincent's College,2013,"All students, Undergraduate, Non-degree/certificate-seeking",55,9,46,-2
130493,Southern Connecticut State University,2013,All students total,10804,3887,6917,-2
130493,Southern Connecticut State University,2013,"All students, Undergraduate total",8257,3253,5004,-2
130493,Southern Connecticut State University,2013,"All students, Undergraduate, Degree/certificate-seeking total",8257,3253,5004,-2
130493,Southern Connecticut State University,2013,"All students, Undergraduate, Degree/certificate-seeking, First-time",1380,459,921,-2
130493,Southern Connecticut State University,2013,"All students, Undergraduate, Other degree/certificate-seeking",6877,2794,4083,-2
130493,Southern Connecticut State University,2013,"All students, Undergraduate, Other degree/certifcate-seeking, Transfer-ins",922,377,545,-2
130493,Southern Connecticut State University,2013,"All students, Undergraduate, Other degree/certifcate-seeking, Continuing",5955,2417,3538,-2
130493,Southern Connecticut State University,2013,"All students, Graduate",2547,634,1913,-2
130581,Tri-State College of Acupuncture,2013,All students total,112,32,80,-2
130581,Tri-State College of Acupuncture,2013,"All students, Graduate",112,32,80,-2
130590,Trinity College,2013,All students total,2390,1217,1173,-2
130590,Trinity College,2013,"All students, Undergraduate total",2301,1176,1125,-2
130590,Trinity College,2013,"All students, Undergraduate, Degree/certificate-seeking total",2239,1150,1089,-2
130590,Trinity College,2013,"All students, Undergraduate, Degree/certificate-seeking, First-time",604,317,287,-2
130590,Trinity College,2013,"All students, Undergraduate, Other degree/certificate-seeking",1635,833,802,-2
130590,Trinity College,2013,"All students, Undergraduate, Other degree/certifcate-seeking, Transfer-ins",30,16,14,-2
130590,Trinity College,2013,"All students, Undergraduate, Other degree/certifcate-seeking, Continuing",1605,817,788,-2
130590,Trinity College,2013,"All students, Undergraduate, Non-degree/certificate-seeking",62,26,36,-2
130590,Trinity College,2013,"All students, Graduate",89,41,48,-2
130624,United States Coast Guard Academy,2013,All students total,902,597,305,-2
130624,United States Coast Guard Academy,2013,"All students, Undergraduate total",902,597,305,-2
130624,United States Coast Guard Academy,2013,"All students, Undergraduate, Degree/certificate-seeking total",902,597,305,-2
130624,United States Coast Guard Academy,2013,"All students, Undergraduate, Degree/certificate-seeking, First-time",217,140,77,-2
130624,United States Coast Guard Academy,2013,"All students, Undergraduate, Other degree/certificate-seeking",685,457,228,-2
130624,United States Coast Guard Academy,2013,"All students, Undergraduate, Other degree/certifcate-seeking, Continuing",685,457,228,-2
130697,Wesleyan University,2013,All students total,3205,1539,1666,-2
130697,Wesleyan University,2013,"All students, Undergraduate total",2906,1402,1504,-2
130697,Wesleyan University,2013,"All students, Undergraduate, Degree/certificate-seeking total",2888,1396,1492,-2
130697,Wesleyan University,2013,"All students, Undergraduate, Degree/certificate-seeking, First-time",741,344,397,-2
130697,Wesleyan University,2013,"All students, Undergraduate, Other degree/certificate-seeking",2147,1052,1095,-2
130697,Wesleyan University,2013,"All students, Undergraduate, Other degree/certifcate-seeking, Transfer-ins",50,27,23,-2
130697,Wesleyan University,2013,"All students, Undergraduate, Other degree/certifcate-seeking, Continuing",2097,1025,1072,-2
130697,Wesleyan University,2013,"All students, Undergraduate, Non-degree/certificate-seeking",18,6,12,-2
130697,Wesleyan University,2013,"All students, Graduate",299,137,162,-2
130776,Western Connecticut State University,2013,All students total,6025,2752,3273,-2
130776,Western Connecticut State University,2013,"All students, Undergraduate total",5492,2563,2929,-2
130776,Western Connecticut State University,2013,"All students, Undergraduate, Degree/certificate-seeking total",5184,2378,2806,-2
130776,Western Connecticut State University,2013,"All students, Undergraduate, Degree/certificate-seeking, First-time",797,389,408,-2
130776,Western Connecticut State University,2013,"All students, Undergraduate, Other degree/certificate-seeking",4387,1989,2398,-2
130776,Western Connecticut State University,2013,"All students, Undergraduate, Other degree/certifcate-seeking, Transfer-ins",567,270,297,-2
130776,Western Connecticut State University,2013,"All students, Undergraduate, Other degree/certifcate-seeking, Continuing",3820,1719,2101,-2
130776,Western Connecticut State University,2013,"All students, Undergraduate, Non-degree/certificate-seeking",308,185,123,-2
130776,Western Connecticut State University,2013,"All students, Graduate",533,189,344,-2
130785,Yale-New Haven Hospital Dietetic Internship,2013,All students total,10,1,9,-2
130785,Yale-New Haven Hospital Dietetic Internship,2013,"All students, Graduate",10,1,9,-2
130794,Yale University,2013,All students total,12109,6148,5961,-2
130794,Yale University,2013,"All students, Undergraduate total",5430,2753,2677,-2
130794,Yale University,2013,"All students, Undergraduate, Degree/certificate-seeking total",5422,2745,2677,-2
130794,Yale University,2013,"All students, Undergraduate, Degree/certificate-seeking, First-time",1358,677,681,-2
130794,Yale University,2013,"All students, Undergraduate, Other degree/certificate-seeking",4064,2068,1996,-2
130794,Yale University,2013,"All students, Undergraduate, Other degree/certifcate-seeking, Transfer-ins",26,15,11,-2
130794,Yale University,2013,"All students, Undergraduate, Other degree/certifcate-seeking, Continuing",4038,2053,1985,-2
130794,Yale University,2013,"All students, Undergraduate, Non-degree/certificate-seeking",8,8,0,-2
130794,Yale University,2013,"All students, Graduate",6679,3395,3284,-2
141486,Chaminade University of Honolulu,2013,All students total,2752,925,1827,-2
141486,Chaminade University of Honolulu,2013,"All students, Undergraduate total",2036,702,1334,-2
141486,Chaminade University of Honolulu,2013,"All students, Undergraduate, Degree/certificate-seeking total",1864,654,1210,-2
141486,Chaminade University of Honolulu,2013,"All students, Undergraduate, Degree/certificate-seeking, First-time",280,93,187,-2
141486,Chaminade University of Honolulu,2013,"All students, Undergraduate, Other degree/certificate-seeking",1584,561,1023,-2
141486,Chaminade University of Honolulu,2013,"All students, Undergraduate, Other degree/certifcate-seeking, Transfer-ins",157,50,107,-2
141486,Chaminade University of Honolulu,2013,"All students, Undergraduate, Other degree/certifcate-seeking, Continuing",1427,511,916,-2
141486,Chaminade University of Honolulu,2013,"All students, Undergraduate, Non-degree/certificate-seeking",172,48,124,-2
141486,Chaminade University of Honolulu,2013,"All students, Graduate",716,223,493,-2
141565,University of Hawaii at Hilo,2013,All students total,4043,1628,2415,-2
141565,University of Hawaii at Hilo,2013,"All students, Undergraduate total",3457,1394,2063,-2
141565,University of Hawaii at Hilo,2013,"All students, Undergraduate, Degree/certificate-seeking total",3335,1346,1989,-2
141565,University of Hawaii at Hilo,2013,"All students, Undergraduate, Degree/certificate-seeking, First-time",496,176,320,-2
141565,University of Hawaii at Hilo,2013,"All students, Undergraduate, Other degree/certificate-seeking",2839,1170,1669,-2
141565,University of Hawaii at Hilo,2013,"All students, Undergraduate, Other degree/certifcate-seeking, Transfer-ins",636,253,383,-2
141565,University of Hawaii at Hilo,2013,"All students, Undergraduate, Other degree/certifcate-seeking, Continuing",2203,917,1286,-2
141565,University of Hawaii at Hilo,2013,"All students, Undergraduate, Non-degree/certificate-seeking",122,48,74,-2
141565,University of Hawaii at Hilo,2013,"All students, Graduate",586,234,352,-2
141574,University of Hawaii at Manoa,2013,All students total,20006,8849,11157,-2
141574,University of Hawaii at Manoa,2013,"All students, Undergraduate total",14499,6557,7942,-2
141574,University of Hawaii at Manoa,2013,"All students, Undergraduate, Degree/certificate-seeking total",14097,6438,7659,-2
141574,University of Hawaii at Manoa,2013,"All students, Undergraduate, Degree/certificate-seeking, First-time",2005,847,1158,-2
141574,University of Hawaii at Manoa,2013,"All students, Undergraduate, Other degree/certificate-seeking",12092,5591,6501,-2
141574,University of Hawaii at Manoa,2013,"All students, Undergraduate, Other degree/certifcate-seeking, Transfer-ins",1823,799,1024,-2
141574,University of Hawaii at Manoa,2013,"All students, Undergraduate, Other degree/certifcate-seeking, Continuing",10269,4792,5477,-2
141574,University of Hawaii at Manoa,2013,"All students, Undergraduate, Non-degree/certificate-seeking",402,119,283,-2
141574,University of Hawaii at Manoa,2013,"All students, Graduate",5507,2292,3215,-2
141644,Hawaii Pacific University,2013,All students total,6736,2998,3738,-2
141644,Hawaii Pacific University,2013,"All students, Undergraduate total",5582,2481,3101,-2
141644,Hawaii Pacific University,2013,"All students, Undergraduate, Degree/certificate-seeking total",5386,2370,3016,-2
141644,Hawaii Pacific University,2013,"All students, Undergraduate, Degree/certificate-seeking, First-time",576,199,377,-2
141644,Hawaii Pacific University,2013,"All students, Undergraduate, Other degree/certificate-seeking",4810,2171,2639,-2
141644,Hawaii Pacific University,2013,"All students, Undergraduate, Other degree/certifcate-seeking, Transfer-ins",855,414,441,-2
141644,Hawaii Pacific University,2013,"All students, Undergraduate, Other degree/certifcate-seeking, Continuing",3955,1757,2198,-2
141644,Hawaii Pacific University,2013,"All students, Undergraduate, Non-degree/certificate-seeking",196,111,85,-2
141644,Hawaii Pacific University,2013,"All students, Graduate",1154,517,637,-2
141839,University of Hawaii Maui College,2013,All students total,4076,1449,2627,-2
141839,University of Hawaii Maui College,2013,"All students, Undergraduate total",4076,1449,2627,-2
141839,University of Hawaii Maui College,2013,"All students, Undergraduate, Degree/certificate-seeking total",3553,1282,2271,-2
141839,University of Hawaii Maui College,2013,"All students, Undergraduate, Degree/certificate-seeking, First-time",770,328,442,-2
141839,University of Hawaii Maui College,2013,"All students, Undergraduate, Other degree/certificate-seeking",2783,954,1829,-2
141839,University of Hawaii Maui College,2013,"All students, Undergraduate, Other degree/certifcate-seeking, Transfer-ins",268,93,175,-2
141839,University of Hawaii Maui College,2013,"All students, Undergraduate, Other degree/certifcate-seeking, Continuing",2515,861,1654,-2
141839,University of Hawaii Maui College,2013,"All students, Undergraduate, Non-degree/certificate-seeking",523,167,356,-2
141936,World Medicine Institute,2013,All students total,64,23,41,-2
141936,World Medicine Institute,2013,"All students, Graduate",64,23,41,-2
141963,University of Hawaii System Office,2013,,,,,-2
141981,University of Hawaii-West Oahu,2013,All students total,2361,792,1569,-2
141981,University of Hawaii-West Oahu,2013,"All students, Undergraduate total",2361,792,1569,-2
141981,University of Hawaii-West Oahu,2013,"All students, Undergraduate, Degree/certificate-seeking total",2192,740,1452,-2
141981,University of Hawaii-West Oahu,2013,"All students, Undergraduate, Degree/certificate-seeking, First-time",291,115,176,-2
141981,University of Hawaii-West Oahu,2013,"All students, Undergraduate, Other degree/certificate-seeking",1901,625,1276,-2
141981,University of Hawaii-West Oahu,2013,"All students, Undergraduate, Other degree/certifcate-seeking, Transfer-ins",539,169,370,-2
141981,University of Hawaii-West Oahu,2013,"All students, Undergraduate, Other degree/certifcate-seeking, Continuing",1362,456,906,-2
141981,University of Hawaii-West Oahu,2013,"All students, Undergraduate, Non-degree/certificate-seeking",169,52,117,-2
142090,Boise Bible College,2013,All students total,186,102,84,-2
142090,Boise Bible College,2013,"All students, Undergraduate total",186,102,84,-2
142090,Boise Bible College,2013,"All students, Undergraduate, Degree/certificate-seeking total",183,101,82,-2
142090,Boise Bible College,2013,"All students, Undergraduate, Degree/certificate-seeking, First-time",47,33,14,-2
142090,Boise Bible College,2013,"All students, Undergraduate, Other degree/certificate-seeking",136,68,68,-2
142090,Boise Bible College,2013,"All students, Undergraduate, Other degree/certifcate-seeking, Transfer-ins",10,7,3,-2
142090,Boise Bible College,2013,"All students, Undergraduate, Other degree/certifcate-seeking, Continuing",126,61,65,-2
142090,Boise Bible College,2013,"All students, Undergraduate, Non-degree/certificate-seeking",3,1,2,-2
142115,Boise State University,2013,All students total,21981,9973,12008,-2
142115,Boise State University,2013,"All students, Undergraduate total",19026,8846,10180,-2
142115,Boise State University,2013,"All students, Undergraduate, Degree/certificate-seeking total",16557,7841,8716,-2
142115,Boise State University,2013,"All students, Undergraduate, Degree/certificate-seeking, First-time",2194,1000,1194,-2
142115,Boise State University,2013,"All students, Undergraduate, Other degree/certificate-seeking",14363,6841,7522,-2
142115,Boise State University,2013,"All students, Undergraduate, Other degree/certifcate-seeking, Transfer-ins",1400,631,769,-2
142115,Boise State University,2013,"All students, Undergraduate, Other degree/certifcate-seeking, Continuing",12963,6210,6753,-2
142115,Boise State University,2013,"All students, Undergraduate, Non-degree/certificate-seeking",2469,1005,1464,-2
142115,Boise State University,2013,"All students, Graduate",2955,1127,1828,-2
142276,Idaho State University,2013,All students total,13326,6194,7132,-2
142276,Idaho State University,2013,"All students, Undergraduate total",11418,5315,6103,-2
142276,Idaho State University,2013,"All students, Undergraduate, Degree/certificate-seeking total",9337,4475,4862,-2
142276,Idaho State University,2013,"All students, Undergraduate, Degree/certificate-seeking, First-time",1551,771,780,-2
142276,Idaho State University,2013,"All students, Undergraduate, Other degree/certificate-seeking",7786,3704,4082,-2
142276,Idaho State University,2013,"All students, Undergraduate, Other degree/certifcate-seeking, Transfer-ins",458,192,266,-2
142276,Idaho State University,2013,"All students, Undergraduate, Other degree/certifcate-seeking, Continuing",7328,3512,3816,-2
142276,Idaho State University,2013,"All students, Undergraduate, Non-degree/certificate-seeking",2081,840,1241,-2
142276,Idaho State University,2013,"All students, Graduate",1908,879,1029,-2
142285,University of Idaho,2013,All students total,12024,6402,5622,-2
142285,University of Idaho,2013,"All students, Undergraduate total",9540,5012,4528,-2
142285,University of Idaho,2013,"All students, Undergraduate, Degree/certificate-seeking total",8539,4586,3953,-2
142285,University of Idaho,2013,"All students, Undergraduate, Degree/certificate-seeking, First-time",1630,837,793,-2
142285,University of Idaho,2013,"All students, Undergraduate, Other degree/certificate-seeking",6909,3749,3160,-2
142285,University of Idaho,2013,"All students, Undergraduate, Other degree/certifcate-seeking, Transfer-ins",671,363,308,-2
142285,University of Idaho,2013,"All students, Undergraduate, Other degree/certifcate-seeking, Continuing",6238,3386,2852,-2
142285,University of Idaho,2013,"All students, Undergraduate, Non-degree/certificate-seeking",1001,426,575,-2
142285,University of Idaho,2013,"All students, Graduate",2484,1390,1094,-2
142294,The College of Idaho,2013,All students total,1122,495,627,-2
142294,The College of Idaho,2013,"All students, Undergraduate total",1095,490,605,-2
142294,The College of Idaho,2013,"All students, Undergraduate, Degree/certificate-seeking total",1086,487,599,-2
142294,The College of Idaho,2013,"All students, Undergraduate, Degree/certificate-seeking, First-time",292,143,149,-2
142294,The College of Idaho,2013,"All students, Undergraduate, Other degree/certificate-seeking",794,344,450,-2
142294,The College of Idaho,2013,"All students, Undergraduate, Other degree/certifcate-seeking, Transfer-ins",64,36,28,-2
142294,The College of Idaho,2013,"All students, Undergraduate, Other degree/certifcate-seeking, Continuing",730,308,422,-2
142294,The College of Idaho,2013,"All students, Undergraduate, Non-degree/certificate-seeking",9,3,6,-2
142294,The College of Idaho,2013,"All students, Graduate",27,5,22,-2
142328,Lewis-Clark State College,2013,All students total,4304,1685,2619,-2
142328,Lewis-Clark State College,2013,"All students, Undergraduate total",4304,1685,2619,-2
142328,Lewis-Clark State College,2013,"All students, Undergraduate, Degree/certificate-seeking total",3161,1213,1948,-2
142328,Lewis-Clark State College,2013,"All students, Undergraduate, Degree/certificate-seeking, First-time",475,195,280,-2
142328,Lewis-Clark State College,2013,"All students, Undergraduate, Other degree/certificate-seeking",2686,1018,1668,-2
142328,Lewis-Clark State College,2013,"All students, Undergraduate, Other degree/certifcate-seeking, Transfer-ins",366,135,231,-2
142328,Lewis-Clark State College,2013,"All students, Undergraduate, Other degree/certifcate-seeking, Continuing",2320,883,1437,-2
142328,Lewis-Clark State College,2013,"All students, Undergraduate, Non-degree/certificate-seeking",1143,472,671,-2
142337,ITT Technical Institute-Boise,2013,All students total,251,147,104,-2
142337,ITT Technical Institute-Boise,2013,"All students, Undergraduate total",251,147,104,-2
142337,ITT Technical Institute-Boise,2013,"All students, Undergraduate, Degree/certificate-seeking total",251,147,104,-2
142337,ITT Technical Institute-Boise,2013,"All students, Undergraduate, Degree/certificate-seeking, First-time",31,20,11,-2
142337,ITT Technical Institute-Boise,2013,"All students, Undergraduate, Other degree/certificate-seeking",220,127,93,-2
142337,ITT Technical Institute-Boise,2013,"All students, Undergraduate, Other degree/certifcate-seeking, Transfer-ins",15,4,11,-2
142337,ITT Technical Institute-Boise,2013,"All students, Undergraduate, Other degree/certifcate-seeking, Continuing",205,123,82,-2
142461,Northwest Nazarene University,2013,All students total,2246,949,1297,-2
142461,Northwest Nazarene University,2013,"All students, Undergraduate total",1488,648,840,-2
142461,Northwest Nazarene University,2013,"All students, Undergraduate, Degree/certificate-seeking total",1251,496,755,-2
142461,Northwest Nazarene University,2013,"All students, Undergraduate, Degree/certificate-seeking, First-time",252,98,154,-2
142461,Northwest Nazarene University,2013,"All students, Undergraduate, Other degree/certificate-seeking",999,398,601,-2
142461,Northwest Nazarene University,2013,"All students, Undergraduate, Other degree/certifcate-seeking, Transfer-ins",89,37,52,-2
142461,Northwest Nazarene University,2013,"All students, Undergraduate, Other degree/certifcate-seeking, Continuing",910,361,549,-2
142461,Northwest Nazarene University,2013,"All students, Undergraduate, Non-degree/certificate-seeking",237,152,85,-2
142461,Northwest Nazarene University,2013,"All students, Graduate",758,301,457,-2
142522,Brigham Young University-Idaho,2013,All students total,27692,11780,15912,-2
142522,Brigham Young University-Idaho,2013,"All students, Undergraduate total",27692,11780,15912,-2
142522,Brigham Young University-Idaho,2013,"All students, Undergraduate, Degree/certificate-seeking total",20208,8594,11614,-2
142522,Brigham Young University-Idaho,2013,"All students, Undergraduate, Degree/certificate-seeking, First-time",2423,754,1669,-2
142522,Brigham Young University-Idaho,2013,"All students, Undergraduate, Other degree/certificate-seeking",17785,7840,9945,-2
142522,Brigham Young University-Idaho,2013,"All students, Undergraduate, Other degree/certifcate-seeking, Transfer-ins",1859,601,1258,-2
142522,Brigham Young University-Idaho,2013,"All students, Undergraduate, Other degree/certifcate-seeking, Continuing",15926,7239,8687,-2
142522,Brigham Young University-Idaho,2013,"All students, Undergraduate, Non-degree/certificate-seeking",7484,3186,4298,-2
152798,Allen College,2013,All students total,581,40,541,-2
152798,Allen College,2013,"All students, Undergraduate total",398,26,372,-2
152798,Allen College,2013,"All students, Undergraduate, Degree/certificate-seeking total",398,26,372,-2
152798,Allen College,2013,"All students, Undergraduate, Degree/certificate-seeking, First-time",1,0,1,-2
152798,Allen College,2013,"All students, Undergraduate, Other degree/certificate-seeking",397,26,371,-2
152798,Allen College,2013,"All students, Undergraduate, Other degree/certifcate-seeking, Transfer-ins",130,16,114,-2
152798,Allen College,2013,"All students, Undergraduate, Other degree/certifcate-seeking, Continuing",267,10,257,-2
152798,Allen College,2013,"All students, Graduate",183,14,169,-2
152822,AIB College of Business,2013,All students total,1019,453,566,-2
152822,AIB College of Business,2013,"All students, Undergraduate total",1019,453,566,-2
152822,AIB College of Business,2013,"All students, Undergraduate, Degree/certificate-seeking total",1007,447,560,-2
152822,AIB College of Business,2013,"All students, Undergraduate, Degree/certificate-seeking, First-time",184,96,88,-2
152822,AIB College of Business,2013,"All students, Undergraduate, Other degree/certificate-seeking",823,351,472,-2
152822,AIB College of Business,2013,"All students, Undergraduate, Other degree/certifcate-seeking, Transfer-ins",178,86,92,-2
152822,AIB College of Business,2013,"All students, Undergraduate, Other degree/certifcate-seeking, Continuing",645,265,380,-2
152822,AIB College of Business,2013,"All students, Undergraduate, Non-degree/certificate-seeking",12,6,6,-2
152992,Briar Cliff University,2013,All students total,1174,486,688,-2
152992,Briar Cliff University,2013,"All students, Undergraduate total",1042,446,596,-2
152992,Briar Cliff University,2013,"All students, Undergraduate, Degree/certificate-seeking total",999,426,573,-2
152992,Briar Cliff University,2013,"All students, Undergraduate, Degree/certificate-seeking, First-time",180,107,73,-2
152992,Briar Cliff University,2013,"All students, Undergraduate, Other degree/certificate-seeking",819,319,500,-2
152992,Briar Cliff University,2013,"All students, Undergraduate, Other degree/certifcate-seeking, Transfer-ins",147,44,103,-2
152992,Briar Cliff University,2013,"All students, Undergraduate, Other degree/certifcate-seeking, Continuing",672,275,397,-2
152992,Briar Cliff University,2013,"All students, Undergraduate, Non-degree/certificate-seeking",43,20,23,-2
152992,Briar Cliff University,2013,"All students, Graduate",132,40,92,-2
153001,Buena Vista University,2013,All students total,2399,805,1594,-2
153001,Buena Vista University,2013,"All students, Undergraduate total",2293,790,1503,-2
153001,Buena Vista University,2013,"All students, Undergraduate, Degree/certificate-seeking total",2125,739,1386,-2
153001,Buena Vista University,2013,"All students, Undergraduate, Degree/certificate-seeking, First-time",269,128,141,-2
153001,Buena Vista University,2013,"All students, Undergraduate, Other degree/certificate-seeking",1856,611,1245,-2
153001,Buena Vista University,2013,"All students, Undergraduate, Other degree/certifcate-seeking, Transfer-ins",374,119,255,-2
153001,Buena Vista University,2013,"All students, Undergraduate, Other degree/certifcate-seeking, Continuing",1482,492,990,-2
153001,Buena Vista University,2013,"All students, Undergraduate, Non-degree/certificate-seeking",168,51,117,-2
153001,Buena Vista University,2013,"All students, Graduate",106,15,91,-2
153108,Central College,2013,All students total,1386,654,732,-2
153108,Central College,2013,"All students, Undergraduate total",1386,654,732,-2
153108,Central College,2013,"All students, Undergraduate, Degree/certificate-seeking total",1303,629,674,-2
153108,Central College,2013,"All students, Undergraduate, Degree/certificate-seeking, First-time",309,158,151,-2
153108,Central College,2013,"All students, Undergraduate, Other degree/certificate-seeking",994,471,523,-2
153108,Central College,2013,"All students, Undergraduate, Other degree/certifcate-seeking, Transfer-ins",22,11,11,-2
153108,Central College,2013,"All students, Undergraduate, Other degree/certifcate-seeking, Continuing",972,460,512,-2
153108,Central College,2013,"All students, Undergraduate, Non-degree/certificate-seeking",83,25,58,-2
153126,Clarke University,2013,All students total,1225,399,826,-2
153126,Clarke University,2013,"All students, Undergraduate total",1011,342,669,-2
153126,Clarke University,2013,"All students, Undergraduate, Degree/certificate-seeking total",995,332,663,-2
153126,Clarke University,2013,"All students, Undergraduate, Degree/certificate-seeking, First-time",181,57,124,-2
153126,Clarke University,2013,"All students, Undergraduate, Other degree/certificate-seeking",814,275,539,-2
153126,Clarke University,2013,"All students, Undergraduate, Other degree/certifcate-seeking, Transfer-ins",123,46,77,-2
153126,Clarke University,2013,"All students, Undergraduate, Other degree/certifcate-seeking, Continuing",691,229,462,-2
153126,Clarke University,2013,"All students, Undergraduate, Non-degree/certificate-seeking",16,10,6,-2
153126,Clarke University,2013,"All students, Graduate",214,57,157,-2
153144,Coe College,2013,All students total,1419,650,769,-2
153144,Coe College,2013,"All students, Undergraduate total",1419,650,769,-2
153144,Coe College,2013,"All students, Undergraduate, Degree/certificate-seeking total",1355,620,735,-2
153144,Coe College,2013,"All students, Undergraduate, Degree/certificate-seeking, First-time",390,158,232,-2
153144,Coe College,2013,"All students, Undergraduate, Other degree/certificate-seeking",965,462,503,-2
153144,Coe College,2013,"All students, Undergraduate, Other degree/certifcate-seeking, Transfer-ins",29,15,14,-2
153144,Coe College,2013,"All students, Undergraduate, Other degree/certifcate-seeking, Continuing",936,447,489,-2
153144,Coe College,2013,"All students, Undergraduate, Non-degree/certificate-seeking",64,30,34,-2
153162,Cornell College,2013,All students total,1125,506,619,-2
153162,Cornell College,2013,"All students, Undergraduate total",1125,506,619,-2
153162,Cornell College,2013,"All students, Undergraduate, Degree/certificate-seeking total",1122,505,617,-2
153162,Cornell College,2013,"All students, Undergraduate, Degree/certificate-seeking, First-time",270,124,146,-2
153162,Cornell College,2013,"All students, Undergraduate, Other degree/certificate-seeking",852,381,471,-2
153162,Cornell College,2013,"All students, Undergraduate, Other degree/certifcate-seeking, Transfer-ins",45,20,25,-2
153162,Cornell College,2013,"All students, Undergraduate, Other degree/certifcate-seeking, Continuing",807,361,446,-2
153162,Cornell College,2013,"All students, Undergraduate, Non-degree/certificate-seeking",3,1,2,-2
153241,Divine Word College,2013,All students total,90,58,32,-2
153241,Divine Word College,2013,"All students, Undergraduate total",90,58,32,-2
153241,Divine Word College,2013,"All students, Undergraduate, Degree/certificate-seeking total",89,57,32,-2
153241,Divine Word College,2013,"All students, Undergraduate, Degree/certificate-seeking, First-time",11,11,0,-2
153241,Divine Word College,2013,"All students, Undergraduate, Other degree/certificate-seeking",78,46,32,-2
153241,Divine Word College,2013,"All students, Undergraduate, Other degree/certifcate-seeking, Transfer-ins",5,4,1,-2
153241,Divine Word College,2013,"All students, Undergraduate, Other degree/certifcate-seeking, Continuing",73,42,31,-2
153241,Divine Word College,2013,"All students, Undergraduate, Non-degree/certificate-seeking",1,1,0,-2
153250,Dordt College,2013,All students total,1430,772,658,-2
153250,Dordt College,2013,"All students, Undergraduate total",1376,747,629,-2
153250,Dordt College,2013,"All students, Undergraduate, Degree/certificate-seeking total",1338,726,612,-2
153250,Dordt College,2013,"All students, Undergraduate, Degree/certificate-seeking, First-time",379,209,170,-2
153250,Dordt College,2013,"All students, Undergraduate, Other degree/certificate-seeking",959,517,442,-2
153250,Dordt College,2013,"All students, Undergraduate, Other degree/certifcate-seeking, Transfer-ins",46,24,22,-2
153250,Dordt College,2013,"All students, Undergraduate, Other degree/certifcate-seeking, Continuing",913,493,420,-2
153250,Dordt College,2013,"All students, Undergraduate, Non-degree/certificate-seeking",38,21,17,-2
153250,Dordt College,2013,"All students, Graduate",54,25,29,-2
153269,Drake University,2013,All students total,5139,2143,2996,-2
153269,Drake University,2013,"All students, Undergraduate total",3383,1475,1908,-2
153269,Drake University,2013,"All students, Undergraduate, Degree/certificate-seeking total",3310,1434,1876,-2
153269,Drake University,2013,"All students, Undergraduate, Degree/certificate-seeking, First-time",850,355,495,-2
153269,Drake University,2013,"All students, Undergraduate, Other degree/certificate-seeking",2460,1079,1381,-2
153269,Drake University,2013,"All students, Undergraduate, Other degree/certifcate-seeking, Transfer-ins",115,52,63,-2
153269,Drake University,2013,"All students, Undergraduate, Other degree/certifcate-seeking, Continuing",2345,1027,1318,-2
153269,Drake University,2013,"All students, Undergraduate, Non-degree/certificate-seeking",73,41,32,-2
153269,Drake University,2013,"All students, Graduate",1756,668,1088,-2
153278,University of Dubuque,2013,All students total,2023,1142,881,-2
153278,University of Dubuque,2013,"All students, Undergraduate total",1694,972,722,-2
153278,University of Dubuque,2013,"All students, Undergraduate, Degree/certificate-seeking total",1687,969,718,-2
153278,University of Dubuque,2013,"All students, Undergraduate, Degree/certificate-seeking, First-time",443,276,167,-2
153278,University of Dubuque,2013,"All students, Undergraduate, Other degree/certificate-seeking",1244,693,551,-2
153278,University of Dubuque,2013,"All students, Undergraduate, Other degree/certifcate-seeking, Transfer-ins",142,68,74,-2
153278,University of Dubuque,2013,"All students, Undergraduate, Other degree/certifcate-seeking, Continuing",1102,625,477,-2
153278,University of Dubuque,2013,"All students, Undergraduate, Non-degree/certificate-seeking",7,3,4,-2
153278,University of Dubuque,2013,"All students, Graduate",329,170,159,-2
153302,Emmaus Bible College,2013,All students total,187,94,93,-2
153302,Emmaus Bible College,2013,"All students, Undergraduate total",187,94,93,-2
153302,Emmaus Bible College,2013,"All students, Undergraduate, Degree/certificate-seeking total",187,94,93,-2
153302,Emmaus Bible College,2013,"All students, Undergraduate, Degree/certificate-seeking, First-time",34,17,17,-2
153302,Emmaus Bible College,2013,"All students, Undergraduate, Other degree/certificate-seeking",153,77,76,-2
153302,Emmaus Bible College,2013,"All students, Undergraduate, Other degree/certifcate-seeking, Transfer-ins",30,16,14,-2
153302,Emmaus Bible College,2013,"All students, Undergraduate, Other degree/certifcate-seeking, Continuing",123,61,62,-2
153320,Faith Baptist Bible College and Theological Seminary,2013,All students total,267,142,125,-2
153320,Faith Baptist Bible College and Theological Seminary,2013,"All students, Undergraduate total",229,106,123,-2
153320,Faith Baptist Bible College and Theological Seminary,2013,"All students, Undergraduate, Degree/certificate-seeking total",220,102,118,-2
153320,Faith Baptist Bible College and Theological Seminary,2013,"All students, Undergraduate, Degree/certificate-seeking, First-time",60,22,38,-2
153320,Faith Baptist Bible College and Theological Seminary,2013,"All students, Undergraduate, Other degree/certificate-seeking",160,80,80,-2
153320,Faith Baptist Bible College and Theological Seminary,2013,"All students, Undergraduate, Other degree/certifcate-seeking, Transfer-ins",16,6,10,-2
153320,Faith Baptist Bible College and Theological Seminary,2013,"All students, Undergraduate, Other degree/certifcate-seeking, Continuing",144,74,70,-2
153320,Faith Baptist Bible College and Theological Seminary,2013,"All students, Undergraduate, Non-degree/certificate-seeking",9,4,5,-2
153320,Faith Baptist Bible College and Theological Seminary,2013,"All students, Graduate",38,36,2,-2
153366,Graceland University-Lamoni,2013,All students total,2286,759,1527,-2
153366,Graceland University-Lamoni,2013,"All students, Undergraduate total",1559,678,881,-2
153366,Graceland University-Lamoni,2013,"All students, Undergraduate, Degree/certificate-seeking total",1434,632,802,-2
153366,Graceland University-Lamoni,2013,"All students, Undergraduate, Degree/certificate-seeking, First-time",326,183,143,-2
153366,Graceland University-Lamoni,2013,"All students, Undergraduate, Other degree/certificate-seeking",1108,449,659,-2
153366,Graceland University-Lamoni,2013,"All students, Undergraduate, Other degree/certifcate-seeking, Transfer-ins",221,82,139,-2
153366,Graceland University-Lamoni,2013,"All students, Undergraduate, Other degree/certifcate-seeking, Continuing",887,367,520,-2
153366,Graceland University-Lamoni,2013,"All students, Undergraduate, Non-degree/certificate-seeking",125,46,79,-2
153366,Graceland University-Lamoni,2013,"All students, Graduate",727,81,646,-2
153375,Grand View University,2013,All students total,2129,894,1235,-2
153375,Grand View University,2013,"All students, Undergraduate total",2096,883,1213,-2
153375,Grand View University,2013,"All students, Undergraduate, Degree/certificate-seeking total",2079,877,1202,-2
153375,Grand View University,2013,"All students, Undergraduate, Degree/certificate-seeking, First-time",298,153,145,-2
153375,Grand View University,2013,"All students, Undergraduate, Other degree/certificate-seeking",1781,724,1057,-2
153375,Grand View University,2013,"All students, Undergraduate, Other degree/certifcate-seeking, Transfer-ins",300,120,180,-2
153375,Grand View University,2013,"All students, Undergraduate, Other degree/certifcate-seeking, Continuing",1481,604,877,-2
153375,Grand View University,2013,"All students, Undergraduate, Non-degree/certificate-seeking",17,6,11,-2
153375,Grand View University,2013,"All students, Graduate",33,11,22,-2
153384,Grinnell College,2013,All students total,1721,791,930,-2
153384,Grinnell College,2013,"All students, Undergraduate total",1721,791,930,-2
153384,Grinnell College,2013,"All students, Undergraduate, Degree/certificate-seeking total",1661,751,910,-2
153384,Grinnell College,2013,"All students, Undergraduate, Degree/certificate-seeking, First-time",423,183,240,-2
153384,Grinnell College,2013,"All students, Undergraduate, Other degree/certificate-seeking",1238,568,670,-2
153384,Grinnell College,2013,"All students, Undergraduate, Other degree/certifcate-seeking, Transfer-ins",6,4,2,-2
153384,Grinnell College,2013,"All students, Undergraduate, Other degree/certifcate-seeking, Continuing",1232,564,668,-2
153384,Grinnell College,2013,"All students, Undergraduate, Non-degree/certificate-seeking",60,40,20,-2
153409,Kaplan University-Mason City Campus,2013,All students total,228,39,189,-2
153409,Kaplan University-Mason City Campus,2013,"All students, Undergraduate total",205,35,170,-2
153409,Kaplan University-Mason City Campus,2013,"All students, Undergraduate, Degree/certificate-seeking total",205,35,170,-2
153409,Kaplan University-Mason City Campus,2013,"All students, Undergraduate, Degree/certificate-seeking, First-time",24,5,19,-2
153409,Kaplan University-Mason City Campus,2013,"All students, Undergraduate, Other degree/certificate-seeking",181,30,151,-2
153409,Kaplan University-Mason City Campus,2013,"All students, Undergraduate, Other degree/certifcate-seeking, Transfer-ins",83,15,68,-2
153409,Kaplan University-Mason City Campus,2013,"All students, Undergraduate, Other degree/certifcate-seeking, Continuing",98,15,83,-2
153409,Kaplan University-Mason City Campus,2013,"All students, Graduate",23,4,19,-2
153418,Kaplan University-Cedar Rapids Campus,2013,All students total,512,104,408,-2
153418,Kaplan University-Cedar Rapids Campus,2013,"All students, Undergraduate total",483,93,390,-2
153418,Kaplan University-Cedar Rapids Campus,2013,"All students, Undergraduate, Degree/certificate-seeking total",483,93,390,-2
153418,Kaplan University-Cedar Rapids Campus,2013,"All students, Undergraduate, Degree/certificate-seeking, First-time",39,8,31,-2
153418,Kaplan University-Cedar Rapids Campus,2013,"All students, Undergraduate, Other degree/certificate-seeking",444,85,359,-2
153418,Kaplan University-Cedar Rapids Campus,2013,"All students, Undergraduate, Other degree/certifcate-seeking, Transfer-ins",147,28,119,-2
153418,Kaplan University-Cedar Rapids Campus,2013,"All students, Undergraduate, Other degree/certifcate-seeking, Continuing",297,57,240,-2
153418,Kaplan University-Cedar Rapids Campus,2013,"All students, Graduate",29,11,18,-2
153427,Hamilton Technical College,2013,All students total,177,99,78,-2
153427,Hamilton Technical College,2013,"All students, Undergraduate total",177,99,78,-2
153427,Hamilton Technical College,2013,"All students, Undergraduate, Degree/certificate-seeking total",177,99,78,-2
153427,Hamilton Technical College,2013,"All students, Undergraduate, Degree/certificate-seeking, First-time",88,40,48,-2
153427,Hamilton Technical College,2013,"All students, Undergraduate, Other degree/certificate-seeking",89,59,30,-2
153427,Hamilton Technical College,2013,"All students, Undergraduate, Other degree/certifcate-seeking, Continuing",89,59,30,-2
153603,Iowa State University,2013,All students total,32955,18466,14489,-2
153603,Iowa State University,2013,"All students, Undergraduate total",27659,15658,12001,-2
153603,Iowa State University,2013,"All students, Undergraduate, Degree/certificate-seeking total",27112,15332,11780,-2
153603,Iowa State University,2013,"All students, Undergraduate, Degree/certificate-seeking, First-time",6089,3365,2724,-2
153603,Iowa State University,2013,"All students, Undergraduate, Other degree/certificate-seeking",21023,11967,9056,-2
153603,Iowa State University,2013,"All students, Undergraduate, Other degree/certifcate-seeking, Transfer-ins",2042,1128,914,-2
153603,Iowa State University,2013,"All students, Undergraduate, Other degree/certifcate-seeking, Continuing",18981,10839,8142,-2
153603,Iowa State University,2013,"All students, Undergraduate, Non-degree/certificate-seeking",547,326,221,-2
153603,Iowa State University,2013,"All students, Graduate",5296,2808,2488,-2
153621,Iowa Wesleyan College,2013,All students total,599,217,382,-2
153621,Iowa Wesleyan College,2013,"All students, Undergraduate total",599,217,382,-2
153621,Iowa Wesleyan College,2013,"All students, Undergraduate, Degree/certificate-seeking total",578,212,366,-2
153621,Iowa Wesleyan College,2013,"All students, Undergraduate, Degree/certificate-seeking, First-time",103,59,44,-2
153621,Iowa Wesleyan College,2013,"All students, Undergraduate, Other degree/certificate-seeking",475,153,322,-2
153621,Iowa Wesleyan College,2013,"All students, Undergraduate, Other degree/certifcate-seeking, Transfer-ins",101,26,75,-2
153621,Iowa Wesleyan College,2013,"All students, Undergraduate, Other degree/certifcate-seeking, Continuing",374,127,247,-2
153621,Iowa Wesleyan College,2013,"All students, Undergraduate, Non-degree/certificate-seeking",21,5,16,-2
153658,University of Iowa,2013,All students total,29748,14372,15376,-2
153658,University of Iowa,2013,"All students, Undergraduate total",21974,10550,11424,-2
153658,University of Iowa,2013,"All students, Undergraduate, Degree/certificate-seeking total",21314,10260,11054,-2
153658,University of Iowa,2013,"All students, Undergraduate, Degree/certificate-seeking, First-time",4460,2036,2424,-2
153658,University of Iowa,2013,"All students, Undergraduate, Other degree/certificate-seeking",16854,8224,8630,-2
153658,University of Iowa,2013,"All students, Undergraduate, Other degree/certifcate-seeking, Transfer-ins",1140,596,544,-2
153658,University of Iowa,2013,"All students, Undergraduate, Other degree/certifcate-seeking, Continuing",15714,7628,8086,-2
153658,University of Iowa,2013,"All students, Undergraduate, Non-degree/certificate-seeking",660,290,370,-2
153658,University of Iowa,2013,"All students, Graduate",7774,3822,3952,-2
153825,Loras College,2013,All students total,1621,827,794,-2
153825,Loras College,2013,"All students, Undergraduate total",1554,805,749,-2
153825,Loras College,2013,"All students, Undergraduate, Degree/certificate-seeking total",1521,785,736,-2
153825,Loras College,2013,"All students, Undergraduate, Degree/certificate-seeking, First-time",414,213,201,-2
153825,Loras College,2013,"All students, Undergraduate, Other degree/certificate-seeking",1107,572,535,-2
153825,Loras College,2013,"All students, Undergraduate, Other degree/certifcate-seeking, Transfer-ins",49,30,19,-2
153825,Loras College,2013,"All students, Undergraduate, Other degree/certifcate-seeking, Continuing",1058,542,516,-2
153825,Loras College,2013,"All students, Undergraduate, Non-degree/certificate-seeking",33,20,13,-2
153825,Loras College,2013,"All students, Graduate",67,22,45,-2
153834,Luther College,2013,All students total,2466,1066,1400,-2
153834,Luther College,2013,"All students, Undergraduate total",2466,1066,1400,-2
153834,Luther College,2013,"All students, Undergraduate, Degree/certificate-seeking total",2388,1031,1357,-2
153834,Luther College,2013,"All students, Undergraduate, Degree/certificate-seeking, First-time",628,273,355,-2
153834,Luther College,2013,"All students, Undergraduate, Other degree/certificate-seeking",1760,758,1002,-2
153834,Luther College,2013,"All students, Undergraduate, Other degree/certifcate-seeking, Transfer-ins",39,24,15,-2
153834,Luther College,2013,"All students, Undergraduate, Other degree/certifcate-seeking, Continuing",1721,734,987,-2
153834,Luther College,2013,"All students, Undergraduate, Non-degree/certificate-seeking",78,35,43,-2
153861,Maharishi University of Management,2013,All students total,1136,785,351,-2
153861,Maharishi University of Management,2013,"All students, Undergraduate total",319,172,147,-2
153861,Maharishi University of Management,2013,"All students, Undergraduate, Degree/certificate-seeking total",316,170,146,-2
153861,Maharishi University of Management,2013,"All students, Undergraduate, Degree/certificate-seeking, First-time",19,9,10,-2
153861,Maharishi University of Management,2013,"All students, Undergraduate, Other degree/certificate-seeking",297,161,136,-2
153861,Maharishi University of Management,2013,"All students, Undergraduate, Other degree/certifcate-seeking, Transfer-ins",54,27,27,-2
153861,Maharishi University of Management,2013,"All students, Undergraduate, Other degree/certifcate-seeking, Continuing",243,134,109,-2
153861,Maharishi University of Management,2013,"All students, Undergraduate, Non-degree/certificate-seeking",3,2,1,-2
153861,Maharishi University of Management,2013,"All students, Graduate",817,613,204,-2
153977,Mercy College of Health Sciences,2013,All students total,831,123,708,-2
153977,Mercy College of Health Sciences,2013,"All students, Undergraduate total",831,123,708,-2
153977,Mercy College of Health Sciences,2013,"All students, Undergraduate, Degree/certificate-seeking total",826,121,705,-2
153977,Mercy College of Health Sciences,2013,"All students, Undergraduate, Degree/certificate-seeking, First-time",46,8,38,-2
153977,Mercy College of Health Sciences,2013,"All students, Undergraduate, Other degree/certificate-seeking",780,113,667,-2
153977,Mercy College of Health Sciences,2013,"All students, Undergraduate, Other degree/certifcate-seeking, Transfer-ins",237,43,194,-2
153977,Mercy College of Health Sciences,2013,"All students, Undergraduate, Other degree/certifcate-seeking, Continuing",543,70,473,-2
153977,Mercy College of Health Sciences,2013,"All students, Undergraduate, Non-degree/certificate-seeking",5,2,3,-2
154004,Morningside College,2013,All students total,2542,840,1702,-2
154004,Morningside College,2013,"All students, Undergraduate total",1305,616,689,-2
154004,Morningside College,2013,"All students, Undergraduate, Degree/certificate-seeking total",1267,600,667,-2
154004,Morningside College,2013,"All students, Undergraduate, Degree/certificate-seeking, First-time",357,160,197,-2
154004,Morningside College,2013,"All students, Undergraduate, Other degree/certificate-seeking",910,440,470,-2
154004,Morningside College,2013,"All students, Undergraduate, Other degree/certifcate-seeking, Transfer-ins",69,26,43,-2
154004,Morningside College,2013,"All students, Undergraduate, Other degree/certifcate-seeking, Continuing",841,414,427,-2
154004,Morningside College,2013,"All students, Undergraduate, Non-degree/certificate-seeking",38,16,22,-2
154004,Morningside College,2013,"All students, Graduate",1237,224,1013,-2
154013,Mount Mercy University,2013,All students total,1761,542,1219,-2
154013,Mount Mercy University,2013,"All students, Undergraduate total",1476,454,1022,-2
154013,Mount Mercy University,2013,"All students, Undergraduate, Degree/certificate-seeking total",1454,444,1010,-2
154013,Mount Mercy University,2013,"All students, Undergraduate, Degree/certificate-seeking, First-time",154,40,114,-2
154013,Mount Mercy University,2013,"All students, Undergraduate, Other degree/certificate-seeking",1300,404,896,-2
154013,Mount Mercy University,2013,"All students, Undergraduate, Other degree/certifcate-seeking, Transfer-ins",276,101,175,-2
154013,Mount Mercy University,2013,"All students, Undergraduate, Other degree/certifcate-seeking, Continuing",1024,303,721,-2
154013,Mount Mercy University,2013,"All students, Undergraduate, Non-degree/certificate-seeking",22,10,12,-2
154013,Mount Mercy University,2013,"All students, Graduate",285,88,197,-2
154022,Ashford University,2013,All students total,58104,16414,41690,-2
154022,Ashford University,2013,"All students, Undergraduate total",50895,14706,36189,-2
154022,Ashford University,2013,"All students, Undergraduate, Degree/certificate-seeking total",50403,14371,36032,-2
154022,Ashford University,2013,"All students, Undergraduate, Degree/certificate-seeking, First-time",866,257,609,-2
154022,Ashford University,2013,"All students, Undergraduate, Other degree/certificate-seeking",49537,14114,35423,-2
154022,Ashford University,2013,"All students, Undergraduate, Other degree/certifcate-seeking, Transfer-ins",5789,1543,4246,-2
154022,Ashford University,2013,"All students, Undergraduate, Other degree/certifcate-seeking, Continuing",43748,12571,31177,-2
154022,Ashford University,2013,"All students, Undergraduate, Non-degree/certificate-seeking",492,335,157,-2
154022,Ashford University,2013,"All students, Graduate",7209,1708,5501,-2
154095,University of Northern Iowa,2013,All students total,12159,5030,7129,-2
154095,University of Northern Iowa,2013,"All students, Undergraduate total",10380,4471,5909,-2
154095,University of Northern Iowa,2013,"All students, Undergraduate, Degree/certificate-seeking total",10170,4384,5786,-2
154095,University of Northern Iowa,2013,"All students, Undergraduate, Degree/certificate-seeking, First-time",1722,646,1076,-2
154095,University of Northern Iowa,2013,"All students, Undergraduate, Other degree/certificate-seeking",8448,3738,4710,-2
154095,University of Northern Iowa,2013,"All students, Undergraduate, Other degree/certifcate-seeking, Transfer-ins",912,449,463,-2
154095,University of Northern Iowa,2013,"All students, Undergraduate, Other degree/certifcate-seeking, Continuing",7536,3289,4247,-2
154095,University of Northern Iowa,2013,"All students, Undergraduate, Non-degree/certificate-seeking",210,87,123,-2
154095,University of Northern Iowa,2013,"All students, Graduate",1779,559,1220,-2
154101,Northwestern College,2013,All students total,1233,532,701,-2
154101,Northwestern College,2013,"All students, Undergraduate total",1233,532,701,-2
154101,Northwestern College,2013,"All students, Undergraduate, Degree/certificate-seeking total",1147,509,638,-2
154101,Northwestern College,2013,"All students, Undergraduate, Degree/certificate-seeking, First-time",284,135,149,-2
154101,Northwestern College,2013,"All students, Undergraduate, Other degree/certificate-seeking",863,374,489,-2
154101,Northwestern College,2013,"All students, Undergraduate, Other degree/certifcate-seeking, Transfer-ins",40,22,18,-2
154101,Northwestern College,2013,"All students, Undergraduate, Other degree/certifcate-seeking, Continuing",823,352,471,-2
154101,Northwestern College,2013,"All students, Undergraduate, Non-degree/certificate-seeking",86,23,63,-2
154156,Des Moines University-Osteopathic Medical Center,2013,All students total,1763,814,949,-2
154156,Des Moines University-Osteopathic Medical Center,2013,"All students, Graduate",1763,814,949,-2
154174,Palmer College of Chiropractic-Davenport,2013,All students total,2135,1286,849,-2
154174,Palmer College of Chiropractic-Davenport,2013,"All students, Undergraduate total",39,19,20,-2
154174,Palmer College of Chiropractic-Davenport,2013,"All students, Undergraduate, Degree/certificate-seeking total",39,19,20,-2
154174,Palmer College of Chiropractic-Davenport,2013,"All students, Undergraduate, Degree/certificate-seeking, First-time",6,1,5,-2
154174,Palmer College of Chiropractic-Davenport,2013,"All students, Undergraduate, Other degree/certificate-seeking",33,18,15,-2
154174,Palmer College of Chiropractic-Davenport,2013,"All students, Undergraduate, Other degree/certifcate-seeking, Transfer-ins",12,6,6,-2
154174,Palmer College of Chiropractic-Davenport,2013,"All students, Undergraduate, Other degree/certifcate-seeking, Continuing",21,12,9,-2
154174,Palmer College of Chiropractic-Davenport,2013,"All students, Graduate",2096,1267,829,-2
154235,Saint Ambrose University,2013,All students total,3607,1456,2151,-2
154235,Saint Ambrose University,2013,"All students, Undergraduate total",2743,1137,1606,-2
154235,Saint Ambrose University,2013,"All students, Undergraduate, Degree/certificate-seeking total",2716,1129,1587,-2
154235,Saint Ambrose University,2013,"All students, Undergraduate, Degree/certificate-seeking, First-time",562,242,320,-2
154235,Saint Ambrose University,2013,"All students, Undergraduate, Other degree/certificate-seeking",2154,887,1267,-2
154235,Saint Ambrose University,2013,"All students, Undergraduate, Other degree/certifcate-seeking, Transfer-ins",267,114,153,-2
154235,Saint Ambrose University,2013,"All students, Undergraduate, Other degree/certifcate-seeking, Continuing",1887,773,1114,-2
154235,Saint Ambrose University,2013,"All students, Undergraduate, Non-degree/certificate-seeking",27,8,19,-2
154235,Saint Ambrose University,2013,"All students, Graduate",864,319,545,-2
154262,St Luke's College,2013,All students total,184,28,156,-2
154262,St Luke's College,2013,"All students, Undergraduate total",184,28,156,-2
154262,St Luke's College,2013,"All students, Undergraduate, Degree/certificate-seeking total",184,28,156,-2
154262,St Luke's College,2013,"All students, Undergraduate, Degree/certificate-seeking, First-time",1,0,1,-2
154262,St Luke's College,2013,"All students, Undergraduate, Other degree/certificate-seeking",183,28,155,-2
154262,St Luke's College,2013,"All students, Undergraduate, Other degree/certifcate-seeking, Transfer-ins",63,10,53,-2
154262,St Luke's College,2013,"All students, Undergraduate, Other degree/certifcate-seeking, Continuing",120,18,102,-2
154350,Simpson College,2013,All students total,1773,768,1005,-2
154350,Simpson College,2013,"All students, Undergraduate total",1712,749,963,-2
154350,Simpson College,2013,"All students, Undergraduate, Degree/certificate-seeking total",1687,740,947,-2
154350,Simpson College,2013,"All students, Undergraduate, Degree/certificate-seeking, First-time",377,152,225,-2
154350,Simpson College,2013,"All students, Undergraduate, Other degree/certificate-seeking",1310,588,722,-2
154350,Simpson College,2013,"All students, Undergraduate, Other degree/certifcate-seeking, Transfer-ins",111,52,59,-2
154350,Simpson College,2013,"All students, Undergraduate, Other degree/certifcate-seeking, Continuing",1199,536,663,-2
154350,Simpson College,2013,"All students, Undergraduate, Non-degree/certificate-seeking",25,9,16,-2
154350,Simpson College,2013,"All students, Graduate",61,19,42,-2
154493,Upper Iowa University,2013,All students total,5304,2048,3256,-2
154493,Upper Iowa University,2013,"All students, Undergraduate total",4632,1853,2779,-2
154493,Upper Iowa University,2013,"All students, Undergraduate, Degree/certificate-seeking total",4513,1808,2705,-2
154493,Upper Iowa University,2013,"All students, Undergraduate, Degree/certificate-seeking, First-time",267,139,128,-2
154493,Upper Iowa University,2013,"All students, Undergraduate, Other degree/certificate-seeking",4246,1669,2577,-2
154493,Upper Iowa University,2013,"All students, Undergraduate, Other degree/certifcate-seeking, Transfer-ins",183,56,127,-2
154493,Upper Iowa University,2013,"All students, Undergraduate, Other degree/certifcate-seeking, Continuing",4063,1613,2450,-2
154493,Upper Iowa University,2013,"All students, Undergraduate, Non-degree/certificate-seeking",119,45,74,-2
154493,Upper Iowa University,2013,"All students, Graduate",672,195,477,-2
154518,Waldorf College,2013,All students total,1150,700,450,-2
154518,Waldorf College,2013,"All students, Undergraduate total",1150,700,450,-2
154518,Waldorf College,2013,"All students, Undergraduate, Degree/certificate-seeking total",1090,671,419,-2
154518,Waldorf College,2013,"All students, Undergraduate, Degree/certificate-seeking, First-time",120,65,55,-2
154518,Waldorf College,2013,"All students, Undergraduate, Other degree/certificate-seeking",970,606,364,-2
154518,Waldorf College,2013,"All students, Undergraduate, Other degree/certifcate-seeking, Transfer-ins",183,120,63,-2
154518,Waldorf College,2013,"All students, Undergraduate, Other degree/certifcate-seeking, Continuing",787,486,301,-2
154518,Waldorf College,2013,"All students, Undergraduate, Non-degree/certificate-seeking",60,29,31,-2
154527,Wartburg College,2013,All students total,1714,812,902,-2
154527,Wartburg College,2013,"All students, Undergraduate total",1714,812,902,-2
154527,Wartburg College,2013,"All students, Undergraduate, Degree/certificate-seeking total",1669,794,875,-2
154527,Wartburg College,2013,"All students, Undergraduate, Degree/certificate-seeking, First-time",451,207,244,-2
154527,Wartburg College,2013,"All students, Undergraduate, Other degree/certificate-seeking",1218,587,631,-2
154527,Wartburg College,2013,"All students, Undergraduate, Other degree/certifcate-seeking, Transfer-ins",36,23,13,-2
154527,Wartburg College,2013,"All students, Undergraduate, Other degree/certifcate-seeking, Continuing",1182,564,618,-2
154527,Wartburg College,2013,"All students, Undergraduate, Non-degree/certificate-seeking",45,18,27,-2
154536,Wartburg Theological Seminary,2013,All students total,139,63,76,-2
154536,Wartburg Theological Seminary,2013,"All students, Graduate",139,63,76,-2
154590,William Penn University,2013,All students total,1875,910,965,-2
154590,William Penn University,2013,"All students, Undergraduate total",1728,862,866,-2
154590,William Penn University,2013,"All students, Undergraduate, Degree/certificate-seeking total",1558,792,766,-2
154590,William Penn University,2013,"All students, Undergraduate, Degree/certificate-seeking, First-time",264,173,91,-2
154590,William Penn University,2013,"All students, Undergraduate, Other degree/certificate-seeking",1294,619,675,-2
154590,William Penn University,2013,"All students, Undergraduate, Other degree/certifcate-seeking, Transfer-ins",217,106,111,-2
154590,William Penn University,2013,"All students, Undergraduate, Other degree/certifcate-seeking, Continuing",1077,513,564,-2
154590,William Penn University,2013,"All students, Undergraduate, Non-degree/certificate-seeking",170,70,100,-2
154590,William Penn University,2013,"All students, Graduate",147,48,99,-2
160940,Kaplan University-Maine Campus,2013,All students total,1017,232,785,-2
160940,Kaplan University-Maine Campus,2013,"All students, Undergraduate total",988,225,763,-2
160940,Kaplan University-Maine Campus,2013,"All students, Undergraduate, Degree/certificate-seeking total",977,220,757,-2
160940,Kaplan University-Maine Campus,2013,"All students, Undergraduate, Degree/certificate-seeking, First-time",146,38,108,-2
160940,Kaplan University-Maine Campus,2013,"All students, Undergraduate, Other degree/certificate-seeking",831,182,649,-2
160940,Kaplan University-Maine Campus,2013,"All students, Undergraduate, Other degree/certifcate-seeking, Transfer-ins",295,59,236,-2
160940,Kaplan University-Maine Campus,2013,"All students, Undergraduate, Other degree/certifcate-seeking, Continuing",536,123,413,-2
160940,Kaplan University-Maine Campus,2013,"All students, Undergraduate, Non-degree/certificate-seeking",11,5,6,-2
160940,Kaplan University-Maine Campus,2013,"All students, Graduate",29,7,22,-2
160959,College of the Atlantic,2013,All students total,370,120,250,-2
160959,College of the Atlantic,2013,"All students, Undergraduate total",362,119,243,-2
160959,College of the Atlantic,2013,"All students, Undergraduate, Degree/certificate-seeking total",356,114,242,-2
160959,College of the Atlantic,2013,"All students, Undergraduate, Degree/certificate-seeking, First-time",104,37,67,-2
160959,College of the Atlantic,2013,"All students, Undergraduate, Other degree/certificate-seeking",252,77,175,-2
160959,College of the Atlantic,2013,"All students, Undergraduate, Other degree/certifcate-seeking, Transfer-ins",28,9,19,-2
160959,College of the Atlantic,2013,"All students, Undergraduate, Other degree/certifcate-seeking, Continuing",224,68,156,-2
160959,College of the Atlantic,2013,"All students, Undergraduate, Non-degree/certificate-seeking",6,5,1,-2
160959,College of the Atlantic,2013,"All students, Graduate",8,1,7,-2
160968,Bangor Theological Seminary,2013,,,,,-2
160977,Bates College,2013,All students total,1791,890,901,-2
160977,Bates College,2013,"All students, Undergraduate total",1791,890,901,-2
160977,Bates College,2013,"All students, Undergraduate, Degree/certificate-seeking total",1791,890,901,-2
160977,Bates College,2013,"All students, Undergraduate, Degree/certificate-seeking, First-time",500,270,230,-2
160977,Bates College,2013,"All students, Undergraduate, Other degree/certificate-seeking",1291,620,671,-2
160977,Bates College,2013,"All students, Undergraduate, Other degree/certifcate-seeking, Transfer-ins",3,2,1,-2
160977,Bates College,2013,"All students, Undergraduate, Other degree/certifcate-seeking, Continuing",1288,618,670,-2
161004,Bowdoin College,2013,All students total,1795,902,893,-2
161004,Bowdoin College,2013,"All students, Undergraduate total",1795,902,893,-2
161004,Bowdoin College,2013,"All students, Undergraduate, Degree/certificate-seeking total",1789,901,888,-2
161004,Bowdoin College,2013,"All students, Undergraduate, Degree/certificate-seeking, First-time",497,245,252,-2
161004,Bowdoin College,2013,"All students, Undergraduate, Other degree/certificate-seeking",1292,656,636,-2
161004,Bowdoin College,2013,"All students, Undergraduate, Other degree/certifcate-seeking, Transfer-ins",5,2,3,-2
161004,Bowdoin College,2013,"All students, Undergraduate, Other degree/certifcate-seeking, Continuing",1287,654,633,-2
161004,Bowdoin College,2013,"All students, Undergraduate, Non-degree/certificate-seeking",6,1,5,-2
161086,Colby College,2013,All students total,1820,874,946,-2
161086,Colby College,2013,"All students, Undergraduate total",1820,874,946,-2
161086,Colby College,2013,"All students, Undergraduate, Degree/certificate-seeking total",1820,874,946,-2
161086,Colby College,2013,"All students, Undergraduate, Degree/certificate-seeking, First-time",483,243,240,-2
161086,Colby College,2013,"All students, Undergraduate, Other degree/certificate-seeking",1337,631,706,-2
161086,Colby College,2013,"All students, Undergraduate, Other degree/certifcate-seeking, Transfer-ins",9,5,4,-2
161086,Colby College,2013,"All students, Undergraduate, Other degree/certifcate-seeking, Continuing",1328,626,702,-2
161165,Husson University,2013,All students total,3049,1218,1831,-2
161165,Husson University,2013,"All students, Undergraduate total",2350,958,1392,-2
161165,Husson University,2013,"All students, Undergraduate, Degree/certificate-seeking total",2290,946,1344,-2
161165,Husson University,2013,"All students, Undergraduate, Degree/certificate-seeking, First-time",455,186,269,-2
161165,Husson University,2013,"All students, Undergraduate, Other degree/certificate-seeking",1835,760,1075,-2
161165,Husson University,2013,"All students, Undergraduate, Other degree/certifcate-seeking, Transfer-ins",157,74,83,-2
161165,Husson University,2013,"All students, Undergraduate, Other degree/certifcate-seeking, Continuing",1678,686,992,-2
161165,Husson University,2013,"All students, Undergraduate, Non-degree/certificate-seeking",60,12,48,-2
161165,Husson University,2013,"All students, Graduate",699,260,439,-2
161217,University of Maine at Augusta,2013,All students total,4770,1365,3405,-2
161217,University of Maine at Augusta,2013,"All students, Undergraduate total",4770,1365,3405,-2
161217,University of Maine at Augusta,2013,"All students, Undergraduate, Degree/certificate-seeking total",4306,1222,3084,-2
161217,University of Maine at Augusta,2013,"All students, Undergraduate, Degree/certificate-seeking, First-time",454,149,305,-2
161217,University of Maine at Augusta,2013,"All students, Undergraduate, Other degree/certificate-seeking",3852,1073,2779,-2
161217,University of Maine at Augusta,2013,"All students, Undergraduate, Other degree/certifcate-seeking, Transfer-ins",519,160,359,-2
161217,University of Maine at Augusta,2013,"All students, Undergraduate, Other degree/certifcate-seeking, Continuing",3333,913,2420,-2
161217,University of Maine at Augusta,2013,"All students, Undergraduate, Non-degree/certificate-seeking",464,143,321,-2
161226,University of Maine at Farmington,2013,All students total,2061,672,1389,-2
161226,University of Maine at Farmington,2013,"All students, Undergraduate total",1901,639,1262,-2
161226,University of Maine at Farmington,2013,"All students, Undergraduate, Degree/certificate-seeking total",1858,630,1228,-2
161226,University of Maine at Farmington,2013,"All students, Undergraduate, Degree/certificate-seeking, First-time",439,143,296,-2
161226,University of Maine at Farmington,2013,"All students, Undergraduate, Other degree/certificate-seeking",1419,487,932,-2
161226,University of Maine at Farmington,2013,"All students, Undergraduate, Other degree/certifcate-seeking, Transfer-ins",110,40,70,-2
161226,University of Maine at Farmington,2013,"All students, Undergraduate, Other degree/certifcate-seeking, Continuing",1309,447,862,-2
161226,University of Maine at Farmington,2013,"All students, Undergraduate, Non-degree/certificate-seeking",43,9,34,-2
161226,University of Maine at Farmington,2013,"All students, Graduate",160,33,127,-2
161235,University of Maine at Fort Kent,2013,All students total,1209,353,856,-2
161235,University of Maine at Fort Kent,2013,"All students, Undergraduate total",1209,353,856,-2
161235,University of Maine at Fort Kent,2013,"All students, Undergraduate, Degree/certificate-seeking total",913,269,644,-2
161235,University of Maine at Fort Kent,2013,"All students, Undergraduate, Degree/certificate-seeking, First-time",162,51,111,-2
161235,University of Maine at Fort Kent,2013,"All students, Undergraduate, Other degree/certificate-seeking",751,218,533,-2
161235,University of Maine at Fort Kent,2013,"All students, Undergraduate, Other degree/certifcate-seeking, Transfer-ins",206,54,152,-2
161235,University of Maine at Fort Kent,2013,"All students, Undergraduate, Other degree/certifcate-seeking, Continuing",545,164,381,-2
161235,University of Maine at Fort Kent,2013,"All students, Undergraduate, Non-degree/certificate-seeking",296,84,212,-2
161244,University of Maine at Machias,2013,All students total,892,268,624,-2
161244,University of Maine at Machias,2013,"All students, Undergraduate total",892,268,624,-2
161244,University of Maine at Machias,2013,"All students, Undergraduate, Degree/certificate-seeking total",596,202,394,-2
161244,University of Maine at Machias,2013,"All students, Undergraduate, Degree/certificate-seeking, First-time",104,44,60,-2
161244,University of Maine at Machias,2013,"All students, Undergraduate, Other degree/certificate-seeking",492,158,334,-2
161244,University of Maine at Machias,2013,"All students, Undergraduate, Other degree/certifcate-seeking, Transfer-ins",54,25,29,-2
161244,University of Maine at Machias,2013,"All students, Undergraduate, Other degree/certifcate-seeking, Continuing",438,133,305,-2
161244,University of Maine at Machias,2013,"All students, Undergraduate, Non-degree/certificate-seeking",296,66,230,-2
161253,University of Maine,2013,All students total,11247,5475,5772,-2
161253,University of Maine,2013,"All students, Undergraduate total",9182,4769,4413,-2
161253,University of Maine,2013,"All students, Undergraduate, Degree/certificate-seeking total",8619,4544,4075,-2
161253,University of Maine,2013,"All students, Undergraduate, Degree/certificate-seeking, First-time",2166,1159,1007,-2
161253,University of Maine,2013,"All students, Undergraduate, Other degree/certificate-seeking",6453,3385,3068,-2
161253,University of Maine,2013,"All students, Undergraduate, Other degree/certifcate-seeking, Transfer-ins",454,241,213,-2
161253,University of Maine,2013,"All students, Undergraduate, Other degree/certifcate-seeking, Continuing",5999,3144,2855,-2
161253,University of Maine,2013,"All students, Undergraduate, Non-degree/certificate-seeking",563,225,338,-2
161253,University of Maine,2013,"All students, Graduate",2065,706,1359,-2
161280,University of Maine-System Central Office,2013,,,,,-2
161299,Maine Maritime Academy,2013,All students total,1018,876,142,-2
161299,Maine Maritime Academy,2013,"All students, Undergraduate total",994,863,131,-2
161299,Maine Maritime Academy,2013,"All students, Undergraduate, Degree/certificate-seeking total",994,863,131,-2
161299,Maine Maritime Academy,2013,"All students, Undergraduate, Degree/certificate-seeking, First-time",234,204,30,-2
161299,Maine Maritime Academy,2013,"All students, Undergraduate, Other degree/certificate-seeking",760,659,101,-2
161299,Maine Maritime Academy,2013,"All students, Undergraduate, Other degree/certifcate-seeking, Transfer-ins",151,136,15,-2
161299,Maine Maritime Academy,2013,"All students, Undergraduate, Other degree/certifcate-seeking, Continuing",609,523,86,-2
161299,Maine Maritime Academy,2013,"All students, Graduate",24,13,11,-2
161341,University of Maine at Presque Isle,2013,All students total,1263,463,800,-2
161341,University of Maine at Presque Isle,2013,"All students, Undergraduate total",1263,463,800,-2
161341,University of Maine at Presque Isle,2013,"All students, Undergraduate, Degree/certificate-seeking total",924,365,559,-2
161341,University of Maine at Presque Isle,2013,"All students, Undergraduate, Degree/certificate-seeking, First-time",197,78,119,-2
161341,University of Maine at Presque Isle,2013,"All students, Undergraduate, Other degree/certificate-seeking",727,287,440,-2
161341,University of Maine at Presque Isle,2013,"All students, Undergraduate, Other degree/certifcate-seeking, Transfer-ins",92,29,63,-2
161341,University of Maine at Presque Isle,2013,"All students, Undergraduate, Other degree/certifcate-seeking, Continuing",635,258,377,-2
161341,University of Maine at Presque Isle,2013,"All students, Undergraduate, Non-degree/certificate-seeking",339,98,241,-2
161457,University of New England,2013,All students total,6032,1686,4346,-2
161457,University of New England,2013,"All students, Undergraduate total",2653,778,1875,-2
161457,University of New England,2013,"All students, Undergraduate, Degree/certificate-seeking total",2179,642,1537,-2
161457,University of New England,2013,"All students, Undergraduate, Degree/certificate-seeking, First-time",633,175,458,-2
161457,University of New England,2013,"All students, Undergraduate, Other degree/certificate-seeking",1546,467,1079,-2
161457,University of New England,2013,"All students, Undergraduate, Other degree/certifcate-seeking, Transfer-ins",72,26,46,-2
161457,University of New England,2013,"All students, Undergraduate, Other degree/certifcate-seeking, Continuing",1474,441,1033,-2
161457,University of New England,2013,"All students, Undergraduate, Non-degree/certificate-seeking",474,136,338,-2
161457,University of New England,2013,"All students, Graduate",3379,908,2471,-2
161509,Maine College of Art,2013,All students total,409,121,288,-2
161509,Maine College of Art,2013,"All students, Undergraduate total",378,110,268,-2
161509,Maine College of Art,2013,"All students, Undergraduate, Degree/certificate-seeking total",375,110,265,-2
161509,Maine College of Art,2013,"All students, Undergraduate, Degree/certificate-seeking, First-time",105,26,79,-2
161509,Maine College of Art,2013,"All students, Undergraduate, Other degree/certificate-seeking",270,84,186,-2
161509,Maine College of Art,2013,"All students, Undergraduate, Other degree/certifcate-seeking, Transfer-ins",27,5,22,-2
161509,Maine College of Art,2013,"All students, Undergraduate, Other degree/certifcate-seeking, Continuing",243,79,164,-2
161509,Maine College of Art,2013,"All students, Undergraduate, Non-degree/certificate-seeking",3,0,3,-2
161509,Maine College of Art,2013,"All students, Graduate",31,11,20,-2
161518,Saint Joseph's College of Maine,2013,All students total,1614,489,1125,-2
161518,Saint Joseph's College of Maine,2013,"All students, Undergraduate total",1276,417,859,-2
161518,Saint Joseph's College of Maine,2013,"All students, Undergraduate, Degree/certificate-seeking total",1276,417,859,-2
161518,Saint Joseph's College of Maine,2013,"All students, Undergraduate, Degree/certificate-seeking, First-time",388,157,231,-2
161518,Saint Joseph's College of Maine,2013,"All students, Undergraduate, Other degree/certificate-seeking",888,260,628,-2
161518,Saint Joseph's College of Maine,2013,"All students, Undergraduate, Other degree/certifcate-seeking, Transfer-ins",94,41,53,-2
161518,Saint Joseph's College of Maine,2013,"All students, Undergraduate, Other degree/certifcate-seeking, Continuing",794,219,575,-2
161518,Saint Joseph's College of Maine,2013,"All students, Graduate",338,72,266,-2
161554,University of Southern Maine,2013,All students total,8923,3629,5294,-2
161554,University of Southern Maine,2013,"All students, Undergraduate total",7098,3045,4053,-2
161554,University of Southern Maine,2013,"All students, Undergraduate, Degree/certificate-seeking total",6079,2597,3482,-2
161554,University of Southern Maine,2013,"All students, Undergraduate, Degree/certificate-seeking, First-time",780,341,439,-2
161554,University of Southern Maine,2013,"All students, Undergraduate, Other degree/certificate-seeking",5299,2256,3043,-2
161554,University of Southern Maine,2013,"All students, Undergraduate, Other degree/certifcate-seeking, Transfer-ins",817,347,470,-2
161554,University of Southern Maine,2013,"All students, Undergraduate, Other degree/certifcate-seeking, Continuing",4482,1909,2573,-2
161554,University of Southern Maine,2013,"All students, Undergraduate, Non-degree/certificate-seeking",1019,448,571,-2
161554,University of Southern Maine,2013,"All students, Graduate",1825,584,1241,-2
161563,Thomas College,2013,All students total,1522,707,815,-2
161563,Thomas College,2013,"All students, Undergraduate total",1339,640,699,-2
161563,Thomas College,2013,"All students, Undergraduate, Degree/certificate-seeking total",846,433,413,-2
161563,Thomas College,2013,"All students, Undergraduate, Degree/certificate-seeking, First-time",260,135,125,-2
161563,Thomas College,2013,"All students, Undergraduate, Other degree/certificate-seeking",586,298,288,-2
161563,Thomas College,2013,"All students, Undergraduate, Other degree/certifcate-seeking, Transfer-ins",37,20,17,-2
161563,Thomas College,2013,"All students, Undergraduate, Other degree/certifcate-seeking, Continuing",549,278,271,-2
161563,Thomas College,2013,"All students, Undergraduate, Non-degree/certificate-seeking",493,207,286,-2
161563,Thomas College,2013,"All students, Graduate",183,67,116,-2
161572,Unity College,2013,All students total,553,272,281,-2
161572,Unity College,2013,"All students, Undergraduate total",553,272,281,-2
161572,Unity College,2013,"All students, Undergraduate, Degree/certificate-seeking total",553,272,281,-2
161572,Unity College,2013,"All students, Undergraduate, Degree/certificate-seeking, First-time",146,83,63,-2
161572,Unity College,2013,"All students, Undergraduate, Other degree/certificate-seeking",407,189,218,-2
161572,Unity College,2013,"All students, Undergraduate, Other degree/certifcate-seeking, Transfer-ins",33,21,12,-2
161572,Unity College,2013,"All students, Undergraduate, Other degree/certifcate-seeking, Continuing",374,168,206,-2
161873,University of Baltimore,2013,All students total,6518,2744,3774,-2
161873,University of Baltimore,2013,"All students, Undergraduate total",3526,1505,2021,-2
161873,University of Baltimore,2013,"All students, Undergraduate, Degree/certificate-seeking total",3479,1482,1997,-2
161873,University of Baltimore,2013,"All students, Undergraduate, Degree/certificate-seeking, First-time",241,95,146,-2
161873,University of Baltimore,2013,"All students, Undergraduate, Other degree/certificate-seeking",3238,1387,1851,-2
161873,University of Baltimore,2013,"All students, Undergraduate, Other degree/certifcate-seeking, Transfer-ins",592,254,338,-2
161873,University of Baltimore,2013,"All students, Undergraduate, Other degree/certifcate-seeking, Continuing",2646,1133,1513,-2
161873,University of Baltimore,2013,"All students, Undergraduate, Non-degree/certificate-seeking",47,23,24,-2
161873,University of Baltimore,2013,"All students, Graduate",2992,1239,1753,-2
162007,Bowie State University,2013,All students total,5561,2026,3535,-2
162007,Bowie State University,2013,"All students, Undergraduate total",4358,1657,2701,-2
162007,Bowie State University,2013,"All students, Undergraduate, Degree/certificate-seeking total",4313,1642,2671,-2
162007,Bowie State University,2013,"All students, Undergraduate, Degree/certificate-seeking, First-time",629,253,376,-2
162007,Bowie State University,2013,"All students, Undergraduate, Other degree/certificate-seeking",3684,1389,2295,-2
162007,Bowie State University,2013,"All students, Undergraduate, Other degree/certifcate-seeking, Transfer-ins",564,217,347,-2
162007,Bowie State University,2013,"All students, Undergraduate, Other degree/certifcate-seeking, Continuing",3120,1172,1948,-2
162007,Bowie State University,2013,"All students, Undergraduate, Non-degree/certificate-seeking",45,15,30,-2
162007,Bowie State University,2013,"All students, Graduate",1203,369,834,-2
162061,Capitol College,2013,All students total,843,672,171,-2
162061,Capitol College,2013,"All students, Undergraduate total",442,351,91,-2
162061,Capitol College,2013,"All students, Undergraduate, Degree/certificate-seeking total",430,345,85,-2
162061,Capitol College,2013,"All students, Undergraduate, Degree/certificate-seeking, First-time",50,41,9,-2
162061,Capitol College,2013,"All students, Undergraduate, Other degree/certificate-seeking",380,304,76,-2
162061,Capitol College,2013,"All students, Undergraduate, Other degree/certifcate-seeking, Transfer-ins",46,41,5,-2
162061,Capitol College,2013,"All students, Undergraduate, Other degree/certifcate-seeking, Continuing",334,263,71,-2
162061,Capitol College,2013,"All students, Undergraduate, Non-degree/certificate-seeking",12,6,6,-2
162061,Capitol College,2013,"All students, Graduate",401,321,80,-2
162210,Washington Adventist University,2013,All students total,1185,399,786,-2
162210,Washington Adventist University,2013,"All students, Undergraduate total",1011,355,656,-2
162210,Washington Adventist University,2013,"All students, Undergraduate, Degree/certificate-seeking total",951,331,620,-2
162210,Washington Adventist University,2013,"All students, Undergraduate, Degree/certificate-seeking, First-time",126,49,77,-2
162210,Washington Adventist University,2013,"All students, Undergraduate, Other degree/certificate-seeking",825,282,543,-2
162210,Washington Adventist University,2013,"All students, Undergraduate, Other degree/certifcate-seeking, Transfer-ins",101,28,73,-2
162210,Washington Adventist University,2013,"All students, Undergraduate, Other degree/certifcate-seeking, Continuing",724,254,470,-2
162210,Washington Adventist University,2013,"All students, Undergraduate, Non-degree/certificate-seeking",60,24,36,-2
162210,Washington Adventist University,2013,"All students, Graduate",174,44,130,-2
162283,Coppin State University,2013,All students total,3383,865,2518,-2
162283,Coppin State University,2013,"All students, Undergraduate total",2920,755,2165,-2
162283,Coppin State University,2013,"All students, Undergraduate, Degree/certificate-seeking total",2880,748,2132,-2
162283,Coppin State University,2013,"All students, Undergraduate, Degree/certificate-seeking, First-time",368,110,258,-2
162283,Coppin State University,2013,"All students, Undergraduate, Other degree/certificate-seeking",2512,638,1874,-2
162283,Coppin State University,2013,"All students, Undergraduate, Other degree/certifcate-seeking, Transfer-ins",318,91,227,-2
162283,Coppin State University,2013,"All students, Undergraduate, Other degree/certifcate-seeking, Continuing",2194,547,1647,-2
162283,Coppin State University,2013,"All students, Undergraduate, Non-degree/certificate-seeking",40,7,33,-2
162283,Coppin State University,2013,"All students, Graduate",463,110,353,-2
162584,Frostburg State University,2013,All students total,5473,2704,2769,-2
162584,Frostburg State University,2013,"All students, Undergraduate total",4703,2400,2303,-2
162584,Frostburg State University,2013,"All students, Undergraduate, Degree/certificate-seeking total",4575,2335,2240,-2
162584,Frostburg State University,2013,"All students, Undergraduate, Degree/certificate-seeking, First-time",895,501,394,-2
162584,Frostburg State University,2013,"All students, Undergraduate, Other degree/certificate-seeking",3680,1834,1846,-2
162584,Frostburg State University,2013,"All students, Undergraduate, Other degree/certifcate-seeking, Transfer-ins",441,188,253,-2
162584,Frostburg State University,2013,"All students, Undergraduate, Other degree/certifcate-seeking, Continuing",3239,1646,1593,-2
162584,Frostburg State University,2013,"All students, Undergraduate, Non-degree/certificate-seeking",128,65,63,-2
162584,Frostburg State University,2013,"All students, Graduate",770,304,466,-2
162654,Goucher College,2013,All students total,2111,644,1467,-2
162654,Goucher College,2013,"All students, Undergraduate total",1449,488,961,-2
162654,Goucher College,2013,"All students, Undergraduate, Degree/certificate-seeking total",1444,485,959,-2
162654,Goucher College,2013,"All students, Undergraduate, Degree/certificate-seeking, First-time",401,129,272,-2
162654,Goucher College,2013,"All students, Undergraduate, Other degree/certificate-seeking",1043,356,687,-2
162654,Goucher College,2013,"All students, Undergraduate, Other degree/certifcate-seeking, Transfer-ins",36,10,26,-2
162654,Goucher College,2013,"All students, Undergraduate, Other degree/certifcate-seeking, Continuing",1007,346,661,-2
162654,Goucher College,2013,"All students, Undergraduate, Non-degree/certificate-seeking",5,3,2,-2
162654,Goucher College,2013,"All students, Graduate",662,156,506,-2
162681,Kaplan University-Hagerstown Campus,2013,All students total,893,194,699,-2
162681,Kaplan University-Hagerstown Campus,2013,"All students, Undergraduate total",845,180,665,-2
162681,Kaplan University-Hagerstown Campus,2013,"All students, Undergraduate, Degree/certificate-seeking total",845,180,665,-2
162681,Kaplan University-Hagerstown Campus,2013,"All students, Undergraduate, Degree/certificate-seeking, First-time",129,24,105,-2
162681,Kaplan University-Hagerstown Campus,2013,"All students, Undergraduate, Other degree/certificate-seeking",716,156,560,-2
162681,Kaplan University-Hagerstown Campus,2013,"All students, Undergraduate, Other degree/certifcate-seeking, Transfer-ins",207,47,160,-2
162681,Kaplan University-Hagerstown Campus,2013,"All students, Undergraduate, Other degree/certifcate-seeking, Continuing",509,109,400,-2
162681,Kaplan University-Hagerstown Campus,2013,"All students, Graduate",48,14,34,-2
162760,Hood College,2013,All students total,2392,826,1566,-2
162760,Hood College,2013,"All students, Undergraduate total",1388,478,910,-2
162760,Hood College,2013,"All students, Undergraduate, Degree/certificate-seeking total",1347,463,884,-2
162760,Hood College,2013,"All students, Undergraduate, Degree/certificate-seeking, First-time",281,111,170,-2
162760,Hood College,2013,"All students, Undergraduate, Other degree/certificate-seeking",1066,352,714,-2
162760,Hood College,2013,"All students, Undergraduate, Other degree/certifcate-seeking, Transfer-ins",119,36,83,-2
162760,Hood College,2013,"All students, Undergraduate, Other degree/certifcate-seeking, Continuing",947,316,631,-2
162760,Hood College,2013,"All students, Undergraduate, Non-degree/certificate-seeking",41,15,26,-2
162760,Hood College,2013,"All students, Graduate",1004,348,656,-2
162928,Johns Hopkins University,2013,All students total,20918,10230,10688,-2
162928,Johns Hopkins University,2013,"All students, Undergraduate total",6117,2981,3136,-2
162928,Johns Hopkins University,2013,"All students, Undergraduate, Degree/certificate-seeking total",5932,2939,2993,-2
162928,Johns Hopkins University,2013,"All students, Undergraduate, Degree/certificate-seeking, First-time",1390,700,690,-2
162928,Johns Hopkins University,2013,"All students, Undergraduate, Other degree/certificate-seeking",4542,2239,2303,-2
162928,Johns Hopkins University,2013,"All students, Undergraduate, Other degree/certifcate-seeking, Transfer-ins",277,84,193,-2
162928,Johns Hopkins University,2013,"All students, Undergraduate, Other degree/certifcate-seeking, Continuing",4265,2155,2110,-2
162928,Johns Hopkins University,2013,"All students, Undergraduate, Non-degree/certificate-seeking",185,42,143,-2
162928,Johns Hopkins University,2013,"All students, Graduate",14801,7249,7552,-2
163046,Loyola University Maryland,2013,All students total,5977,2283,3694,-2
163046,Loyola University Maryland,2013,"All students, Undergraduate total",4004,1628,2376,-2
163046,Loyola University Maryland,2013,"All students, Undergraduate, Degree/certificate-seeking total",3972,1616,2356,-2
163046,Loyola University Maryland,2013,"All students, Undergraduate, Degree/certificate-seeking, First-time",1096,477,619,-2
163046,Loyola University Maryland,2013,"All students, Undergraduate, Other degree/certificate-seeking",2876,1139,1737,-2
163046,Loyola University Maryland,2013,"All students, Undergraduate, Other degree/certifcate-seeking, Transfer-ins",50,24,26,-2
163046,Loyola University Maryland,2013,"All students, Undergraduate, Other degree/certifcate-seeking, Continuing",2826,1115,1711,-2
163046,Loyola University Maryland,2013,"All students, Undergraduate, Non-degree/certificate-seeking",32,12,20,-2
163046,Loyola University Maryland,2013,"All students, Graduate",1973,655,1318,-2
163204,University of Maryland-University College,2013,All students total,39557,19544,20013,-2
163204,University of Maryland-University College,2013,"All students, Undergraduate total",26740,13618,13122,-2
163204,University of Maryland-University College,2013,"All students, Undergraduate, Degree/certificate-seeking total",26006,13224,12782,-2
163204,University of Maryland-University College,2013,"All students, Undergraduate, Degree/certificate-seeking, First-time",603,288,315,-2
163204,University of Maryland-University College,2013,"All students, Undergraduate, Other degree/certificate-seeking",25403,12936,12467,-2
163204,University of Maryland-University College,2013,"All students, Undergraduate, Other degree/certifcate-seeking, Transfer-ins",3738,1892,1846,-2
163204,University of Maryland-University College,2013,"All students, Undergraduate, Other degree/certifcate-seeking, Continuing",21665,11044,10621,-2
163204,University of Maryland-University College,2013,"All students, Undergraduate, Non-degree/certificate-seeking",734,394,340,-2
163204,University of Maryland-University College,2013,"All students, Graduate",12817,5926,6891,-2
163259,University of Maryland-Baltimore,2013,All students total,6284,1816,4468,-2
163259,University of Maryland-Baltimore,2013,"All students, Undergraduate total",746,112,634,-2
163259,University of Maryland-Baltimore,2013,"All students, Undergraduate, Degree/certificate-seeking total",738,110,628,-2
163259,University of Maryland-Baltimore,2013,"All students, Undergraduate, Other degree/certificate-seeking",738,110,628,-2
163259,University of Maryland-Baltimore,2013,"All students, Undergraduate, Other degree/certifcate-seeking, Transfer-ins",220,32,188,-2
163259,University of Maryland-Baltimore,2013,"All students, Undergraduate, Other degree/certifcate-seeking, Continuing",518,78,440,-2
163259,University of Maryland-Baltimore,2013,"All students, Undergraduate, Non-degree/certificate-seeking",8,2,6,-2
163259,University of Maryland-Baltimore,2013,"All students, Graduate",5538,1704,3834,-2
163268,University of Maryland-Baltimore County,2013,All students total,13908,7490,6418,-2
163268,University of Maryland-Baltimore County,2013,"All students, Undergraduate total",11136,6083,5053,-2
163268,University of Maryland-Baltimore County,2013,"All students, Undergraduate, Degree/certificate-seeking total",11012,6024,4988,-2
163268,University of Maryland-Baltimore County,2013,"All students, Undergraduate, Degree/certificate-seeking, First-time",1657,953,704,-2
163268,University of Maryland-Baltimore County,2013,"All students, Undergraduate, Other degree/certificate-seeking",9355,5071,4284,-2
163268,University of Maryland-Baltimore County,2013,"All students, Undergraduate, Other degree/certifcate-seeking, Transfer-ins",1262,604,658,-2
163268,University of Maryland-Baltimore County,2013,"All students, Undergraduate, Other degree/certifcate-seeking, Continuing",8093,4467,3626,-2
163268,University of Maryland-Baltimore County,2013,"All students, Undergraduate, Non-degree/certificate-seeking",124,59,65,-2
163268,University of Maryland-Baltimore County,2013,"All students, Graduate",2772,1407,1365,-2
163286,University of Maryland-College Park,2013,All students total,37272,19712,17560,-2
163286,University of Maryland-College Park,2013,"All students, Undergraduate total",26658,14223,12435,-2
163286,University of Maryland-College Park,2013,"All students, Undergraduate, Degree/certificate-seeking total",26045,13897,12148,-2
163286,University of Maryland-College Park,2013,"All students, Undergraduate, Degree/certificate-seeking, First-time",4020,2125,1895,-2
163286,University of Maryland-College Park,2013,"All students, Undergraduate, Other degree/certificate-seeking",22025,11772,10253,-2
163286,University of Maryland-College Park,2013,"All students, Undergraduate, Other degree/certifcate-seeking, Transfer-ins",2022,1107,915,-2
163286,University of Maryland-College Park,2013,"All students, Undergraduate, Other degree/certifcate-seeking, Continuing",20003,10665,9338,-2
163286,University of Maryland-College Park,2013,"All students, Undergraduate, Non-degree/certificate-seeking",613,326,287,-2
163286,University of Maryland-College Park,2013,"All students, Graduate",10614,5489,5125,-2
163295,Maryland Institute College of Art,2013,All students total,2273,664,1609,-2
163295,Maryland Institute College of Art,2013,"All students, Undergraduate total",1896,535,1361,-2
163295,Maryland Institute College of Art,2013,"All students, Undergraduate, Degree/certificate-seeking total",1892,533,1359,-2
163295,Maryland Institute College of Art,2013,"All students, Undergraduate, Degree/certificate-seeking, First-time",400,98,302,-2
163295,Maryland Institute College of Art,2013,"All students, Undergraduate, Other degree/certificate-seeking",1492,435,1057,-2
163295,Maryland Institute College of Art,2013,"All students, Undergraduate, Other degree/certifcate-seeking, Transfer-ins",102,41,61,-2
163295,Maryland Institute College of Art,2013,"All students, Undergraduate, Other degree/certifcate-seeking, Continuing",1390,394,996,-2
163295,Maryland Institute College of Art,2013,"All students, Undergraduate, Non-degree/certificate-seeking",4,2,2,-2
163295,Maryland Institute College of Art,2013,"All students, Graduate",377,129,248,-2
163338,University of Maryland Eastern Shore,2013,All students total,4220,1831,2389,-2
163338,University of Maryland Eastern Shore,2013,"All students, Undergraduate total",3530,1572,1958,-2
163338,University of Maryland Eastern Shore,2013,"All students, Undergraduate, Degree/certificate-seeking total",3421,1522,1899,-2
163338,University of Maryland Eastern Shore,2013,"All students, Undergraduate, Degree/certificate-seeking, First-time",610,257,353,-2
163338,University of Maryland Eastern Shore,2013,"All students, Undergraduate, Other degree/certificate-seeking",2811,1265,1546,-2
163338,University of Maryland Eastern Shore,2013,"All students, Undergraduate, Other degree/certifcate-seeking, Transfer-ins",205,105,100,-2
163338,University of Maryland Eastern Shore,2013,"All students, Undergraduate, Other degree/certifcate-seeking, Continuing",2606,1160,1446,-2
163338,University of Maryland Eastern Shore,2013,"All students, Undergraduate, Non-degree/certificate-seeking",109,50,59,-2
163338,University of Maryland Eastern Shore,2013,"All students, Graduate",690,259,431,-2
163453,Morgan State University,2013,All students total,7546,3318,4228,-2
163453,Morgan State University,2013,"All students, Undergraduate total",6252,2785,3467,-2
163453,Morgan State University,2013,"All students, Undergraduate, Degree/certificate-seeking total",6197,2750,3447,-2
163453,Morgan State University,2013,"All students, Undergraduate, Degree/certificate-seeking, First-time",899,395,504,-2
163453,Morgan State University,2013,"All students, Undergraduate, Other degree/certificate-seeking",5298,2355,2943,-2
163453,Morgan State University,2013,"All students, Undergraduate, Other degree/certifcate-seeking, Transfer-ins",441,189,252,-2
163453,Morgan State University,2013,"All students, Undergraduate, Other degree/certifcate-seeking, Continuing",4857,2166,2691,-2
163453,Morgan State University,2013,"All students, Undergraduate, Non-degree/certificate-seeking",55,35,20,-2
163453,Morgan State University,2013,"All students, Graduate",1294,533,761,-2
163462,Mount St Mary's University,2013,All students total,2240,1076,1164,-2
163462,Mount St Mary's University,2013,"All students, Undergraduate total",1741,777,964,-2
163462,Mount St Mary's University,2013,"All students, Undergraduate, Degree/certificate-seeking total",1729,772,957,-2
163462,Mount St Mary's University,2013,"All students, Undergraduate, Degree/certificate-seeking, First-time",429,194,235,-2
163462,Mount St Mary's University,2013,"All students, Undergraduate, Other degree/certificate-seeking",1300,578,722,-2
163462,Mount St Mary's University,2013,"All students, Undergraduate, Other degree/certifcate-seeking, Transfer-ins",77,38,39,-2
163462,Mount St Mary's University,2013,"All students, Undergraduate, Other degree/certifcate-seeking, Continuing",1223,540,683,-2
163462,Mount St Mary's University,2013,"All students, Undergraduate, Non-degree/certificate-seeking",12,5,7,-2
163462,Mount St Mary's University,2013,"All students, Graduate",499,299,200,-2
163532,Ner Israel Rabbinical College,2013,All students total,523,523,0,-2
163532,Ner Israel Rabbinical College,2013,"All students, Undergraduate total",340,340,0,-2
163532,Ner Israel Rabbinical College,2013,"All students, Undergraduate, Degree/certificate-seeking total",340,340,0,-2
163532,Ner Israel Rabbinical College,2013,"All students, Undergraduate, Degree/certificate-seeking, First-time",41,41,0,-2
163532,Ner Israel Rabbinical College,2013,"All students, Undergraduate, Other degree/certificate-seeking",299,299,0,-2
163532,Ner Israel Rabbinical College,2013,"All students, Undergraduate, Other degree/certifcate-seeking, Transfer-ins",63,63,0,-2
163532,Ner Israel Rabbinical College,2013,"All students, Undergraduate, Other degree/certifcate-seeking, Continuing",236,236,0,-2
163532,Ner Israel Rabbinical College,2013,"All students, Graduate",183,183,0,-2
163578,Notre Dame of Maryland University,2013,All students total,2877,367,2510,-2
163578,Notre Dame of Maryland University,2013,"All students, Undergraduate total",1234,57,1177,-2
163578,Notre Dame of Maryland University,2013,"All students, Undergraduate, Degree/certificate-seeking total",1220,53,1167,-2
163578,Notre Dame of Maryland University,2013,"All students, Undergraduate, Degree/certificate-seeking, First-time",104,0,104,-2
163578,Notre Dame of Maryland University,2013,"All students, Undergraduate, Other degree/certificate-seeking",1116,53,1063,-2
163578,Notre Dame of Maryland University,2013,"All students, Undergraduate, Other degree/certifcate-seeking, Transfer-ins",188,10,178,-2
163578,Notre Dame of Maryland University,2013,"All students, Undergraduate, Other degree/certifcate-seeking, Continuing",928,43,885,-2
163578,Notre Dame of Maryland University,2013,"All students, Undergraduate, Non-degree/certificate-seeking",14,4,10,-2
163578,Notre Dame of Maryland University,2013,"All students, Graduate",1643,310,1333,-2
163842,St Mary's Seminary & University,2013,,,,,-2
163851,Salisbury University,2013,All students total,8643,3647,4996,-2
163851,Salisbury University,2013,"All students, Undergraduate total",8004,3479,4525,-2
163851,Salisbury University,2013,"All students, Undergraduate, Degree/certificate-seeking total",7767,3359,4408,-2
163851,Salisbury University,2013,"All students, Undergraduate, Degree/certificate-seeking, First-time",1246,509,737,-2
163851,Salisbury University,2013,"All students, Undergraduate, Other degree/certificate-seeking",6521,2850,3671,-2
163851,Salisbury University,2013,"All students, Undergraduate, Other degree/certifcate-seeking, Transfer-ins",915,394,521,-2
163851,Salisbury University,2013,"All students, Undergraduate, Other degree/certifcate-seeking, Continuing",5606,2456,3150,-2
163851,Salisbury University,2013,"All students, Undergraduate, Non-degree/certificate-seeking",237,120,117,-2
163851,Salisbury University,2013,"All students, Graduate",639,168,471,-2
163912,St Mary's College of Maryland,2013,All students total,1858,751,1107,-2
163912,St Mary's College of Maryland,2013,"All students, Undergraduate total",1819,744,1075,-2
163912,St Mary's College of Maryland,2013,"All students, Undergraduate, Degree/certificate-seeking total",1794,729,1065,-2
163912,St Mary's College of Maryland,2013,"All students, Undergraduate, Degree/certificate-seeking, First-time",383,156,227,-2
163912,St Mary's College of Maryland,2013,"All students, Undergraduate, Other degree/certificate-seeking",1411,573,838,-2
163912,St Mary's College of Maryland,2013,"All students, Undergraduate, Other degree/certifcate-seeking, Transfer-ins",95,43,52,-2
163912,St Mary's College of Maryland,2013,"All students, Undergraduate, Other degree/certifcate-seeking, Continuing",1316,530,786,-2
163912,St Mary's College of Maryland,2013,"All students, Undergraduate, Non-degree/certificate-seeking",25,15,10,-2
163912,St Mary's College of Maryland,2013,"All students, Graduate",39,7,32,-2
163921,Sojourner-Douglass College,2013,All students total,1080,123,957,-2
163921,Sojourner-Douglass College,2013,"All students, Undergraduate total",1037,119,918,-2
163921,Sojourner-Douglass College,2013,"All students, Undergraduate, Degree/certificate-seeking total",1037,119,918,-2
163921,Sojourner-Douglass College,2013,"All students, Undergraduate, Degree/certificate-seeking, First-time",91,11,80,-2
163921,Sojourner-Douglass College,2013,"All students, Undergraduate, Other degree/certificate-seeking",946,108,838,-2
163921,Sojourner-Douglass College,2013,"All students, Undergraduate, Other degree/certifcate-seeking, Transfer-ins",66,8,58,-2
163921,Sojourner-Douglass College,2013,"All students, Undergraduate, Other degree/certifcate-seeking, Continuing",880,100,780,-2
163921,Sojourner-Douglass College,2013,"All students, Graduate",43,4,39,-2
163976,St John's College,2013,All students total,490,275,215,-2
163976,St John's College,2013,"All students, Undergraduate total",443,244,199,-2
163976,St John's College,2013,"All students, Undergraduate, Degree/certificate-seeking total",443,244,199,-2
163976,St John's College,2013,"All students, Undergraduate, Degree/certificate-seeking, First-time",122,70,52,-2
163976,St John's College,2013,"All students, Undergraduate, Other degree/certificate-seeking",321,174,147,-2
163976,St John's College,2013,"All students, Undergraduate, Other degree/certifcate-seeking, Continuing",321,174,147,-2
163976,St John's College,2013,"All students, Graduate",47,31,16,-2
164076,Towson University,2013,All students total,22499,8572,13927,-2
164076,Towson University,2013,"All students, Undergraduate total",18779,7467,11312,-2
164076,Towson University,2013,"All students, Undergraduate, Degree/certificate-seeking total",18534,7348,11186,-2
164076,Towson University,2013,"All students, Undergraduate, Degree/certificate-seeking, First-time",2748,995,1753,-2
164076,Towson University,2013,"All students, Undergraduate, Other degree/certificate-seeking",15786,6353,9433,-2
164076,Towson University,2013,"All students, Undergraduate, Other degree/certifcate-seeking, Transfer-ins",2299,1001,1298,-2
164076,Towson University,2013,"All students, Undergraduate, Other degree/certifcate-seeking, Continuing",13487,5352,8135,-2
164076,Towson University,2013,"All students, Undergraduate, Non-degree/certificate-seeking",245,119,126,-2
164076,Towson University,2013,"All students, Graduate",3720,1105,2615,-2
164085,Maryland University of Integrative Health,2013,All students total,591,79,512,-2
164085,Maryland University of Integrative Health,2013,"All students, Graduate",591,79,512,-2
164146,University System of Maryland,2013,,,,,-2
164155,United States Naval Academy,2013,All students total,4526,3550,976,-2
164155,United States Naval Academy,2013,"All students, Undergraduate total",4526,3550,976,-2
164155,United States Naval Academy,2013,"All students, Undergraduate, Degree/certificate-seeking total",4526,3550,976,-2
164155,United States Naval Academy,2013,"All students, Undergraduate, Degree/certificate-seeking, First-time",1171,905,266,-2
164155,United States Naval Academy,2013,"All students, Undergraduate, Other degree/certificate-seeking",3355,2645,710,-2
164155,United States Naval Academy,2013,"All students, Undergraduate, Other degree/certifcate-seeking, Continuing",3355,2645,710,-2
164173,Stevenson University,2013,All students total,4404,1482,2922,-2
164173,Stevenson University,2013,"All students, Undergraduate total",3965,1371,2594,-2
164173,Stevenson University,2013,"All students, Undergraduate, Degree/certificate-seeking total",3923,1357,2566,-2
164173,Stevenson University,2013,"All students, Undergraduate, Degree/certificate-seeking, First-time",753,292,461,-2
164173,Stevenson University,2013,"All students, Undergraduate, Other degree/certificate-seeking",3170,1065,2105,-2
164173,Stevenson University,2013,"All students, Undergraduate, Other degree/certifcate-seeking, Transfer-ins",240,107,133,-2
164173,Stevenson University,2013,"All students, Undergraduate, Other degree/certifcate-seeking, Continuing",2930,958,1972,-2
164173,Stevenson University,2013,"All students, Undergraduate, Non-degree/certificate-seeking",42,14,28,-2
164173,Stevenson University,2013,"All students, Graduate",439,111,328,-2
164207,Washington Bible College-Capital Bible Seminary,2013,,,,,-2
164216,Washington College,2013,All students total,1512,645,867,-2
164216,Washington College,2013,"All students, Undergraduate total",1483,630,853,-2
164216,Washington College,2013,"All students, Undergraduate, Degree/certificate-seeking total",1424,603,821,-2
164216,Washington College,2013,"All students, Undergraduate, Degree/certificate-seeking, First-time",349,147,202,-2
164216,Washington College,2013,"All students, Undergraduate, Other degree/certificate-seeking",1075,456,619,-2
164216,Washington College,2013,"All students, Undergraduate, Other degree/certifcate-seeking, Transfer-ins",35,21,14,-2
164216,Washington College,2013,"All students, Undergraduate, Other degree/certifcate-seeking, Continuing",1040,435,605,-2
164216,Washington College,2013,"All students, Undergraduate, Non-degree/certificate-seeking",59,27,32,-2
164216,Washington College,2013,"All students, Graduate",29,15,14,-2
164270,McDaniel College,2013,All students total,3229,1157,2072,-2
164270,McDaniel College,2013,"All students, Undergraduate total",1692,793,899,-2
164270,McDaniel College,2013,"All students, Undergraduate, Degree/certificate-seeking total",1662,784,878,-2
164270,McDaniel College,2013,"All students, Undergraduate, Degree/certificate-seeking, First-time",453,226,227,-2
164270,McDaniel College,2013,"All students, Undergraduate, Other degree/certificate-seeking",1209,558,651,-2
164270,McDaniel College,2013,"All students, Undergraduate, Other degree/certifcate-seeking, Transfer-ins",69,38,31,-2
164270,McDaniel College,2013,"All students, Undergraduate, Other degree/certifcate-seeking, Continuing",1140,520,620,-2
164270,McDaniel College,2013,"All students, Undergraduate, Non-degree/certificate-seeking",30,9,21,-2
164270,McDaniel College,2013,"All students, Graduate",1537,364,1173,-2
164368,Hult International Business School,2013,All students total,641,440,201,-2
164368,Hult International Business School,2013,"All students, Graduate",641,440,201,-2
164438,New England College of Business and Finance,2013,All students total,1145,345,800,-2
164438,New England College of Business and Finance,2013,"All students, Undergraduate total",940,261,679,-2
164438,New England College of Business and Finance,2013,"All students, Undergraduate, Degree/certificate-seeking total",918,253,665,-2
164438,New England College of Business and Finance,2013,"All students, Undergraduate, Degree/certificate-seeking, First-time",24,9,15,-2
164438,New England College of Business and Finance,2013,"All students, Undergraduate, Other degree/certificate-seeking",894,244,650,-2
164438,New England College of Business and Finance,2013,"All students, Undergraduate, Other degree/certifcate-seeking, Transfer-ins",176,40,136,-2
164438,New England College of Business and Finance,2013,"All students, Undergraduate, Other degree/certifcate-seeking, Continuing",718,204,514,-2
164438,New England College of Business and Finance,2013,"All students, Undergraduate, Non-degree/certificate-seeking",22,8,14,-2
164438,New England College of Business and Finance,2013,"All students, Graduate",205,84,121,-2
164447,American International College,2013,All students total,3657,1117,2540,-2
164447,American International College,2013,"All students, Undergraduate total",1513,635,878,-2
164447,American International College,2013,"All students, Undergraduate, Degree/certificate-seeking total",1513,635,878,-2
164447,American International College,2013,"All students, Undergraduate, Degree/certificate-seeking, First-time",346,164,182,-2
164447,American International College,2013,"All students, Undergraduate, Other degree/certificate-seeking",1167,471,696,-2
164447,American International College,2013,"All students, Undergraduate, Other degree/certifcate-seeking, Transfer-ins",173,54,119,-2
164447,American International College,2013,"All students, Undergraduate, Other degree/certifcate-seeking, Continuing",994,417,577,-2
164447,American International College,2013,"All students, Graduate",2144,482,1662,-2
164465,Amherst College,2013,All students total,1785,900,885,-2
164465,Amherst College,2013,"All students, Undergraduate total",1785,900,885,-2
164465,Amherst College,2013,"All students, Undergraduate, Degree/certificate-seeking total",1785,900,885,-2
164465,Amherst College,2013,"All students, Undergraduate, Degree/certificate-seeking, First-time",466,231,235,-2
164465,Amherst College,2013,"All students, Undergraduate, Other degree/certificate-seeking",1319,669,650,-2
164465,Amherst College,2013,"All students, Undergraduate, Other degree/certifcate-seeking, Transfer-ins",13,10,3,-2
164465,Amherst College,2013,"All students, Undergraduate, Other degree/certifcate-seeking, Continuing",1306,659,647,-2
164474,Andover Newton Theological School,2013,All students total,272,96,176,-2
164474,Andover Newton Theological School,2013,"All students, Graduate",272,96,176,-2
164492,Anna Maria College,2013,All students total,1540,716,824,-2
164492,Anna Maria College,2013,"All students, Undergraduate total",1143,493,650,-2
164492,Anna Maria College,2013,"All students, Undergraduate, Degree/certificate-seeking total",1135,487,648,-2
164492,Anna Maria College,2013,"All students, Undergraduate, Degree/certificate-seeking, First-time",243,93,150,-2
164492,Anna Maria College,2013,"All students, Undergraduate, Other degree/certificate-seeking",892,394,498,-2
164492,Anna Maria College,2013,"All students, Undergraduate, Other degree/certifcate-seeking, Transfer-ins",45,19,26,-2
164492,Anna Maria College,2013,"All students, Undergraduate, Other degree/certifcate-seeking, Continuing",847,375,472,-2
164492,Anna Maria College,2013,"All students, Undergraduate, Non-degree/certificate-seeking",8,6,2,-2
164492,Anna Maria College,2013,"All students, Graduate",397,223,174,-2
164562,Assumption College,2013,All students total,2756,1009,1747,-2
164562,Assumption College,2013,"All students, Undergraduate total",2240,864,1376,-2
164562,Assumption College,2013,"All students, Undergraduate, Degree/certificate-seeking total",2181,841,1340,-2
164562,Assumption College,2013,"All students, Undergraduate, Degree/certificate-seeking, First-time",502,215,287,-2
164562,Assumption College,2013,"All students, Undergraduate, Other degree/certificate-seeking",1679,626,1053,-2
164562,Assumption College,2013,"All students, Undergraduate, Other degree/certifcate-seeking, Transfer-ins",44,18,26,-2
164562,Assumption College,2013,"All students, Undergraduate, Other degree/certifcate-seeking, Continuing",1635,608,1027,-2
164562,Assumption College,2013,"All students, Undergraduate, Non-degree/certificate-seeking",59,23,36,-2
164562,Assumption College,2013,"All students, Graduate",516,145,371,-2
164580,Babson College,2013,All students total,3343,1992,1351,-2
164580,Babson College,2013,"All students, Undergraduate total",2106,1151,955,-2
164580,Babson College,2013,"All students, Undergraduate, Degree/certificate-seeking total",2106,1151,955,-2
164580,Babson College,2013,"All students, Undergraduate, Degree/certificate-seeking, First-time",489,252,237,-2
164580,Babson College,2013,"All students, Undergraduate, Other degree/certificate-seeking",1617,899,718,-2
164580,Babson College,2013,"All students, Undergraduate, Other degree/certifcate-seeking, Transfer-ins",45,24,21,-2
164580,Babson College,2013,"All students, Undergraduate, Other degree/certifcate-seeking, Continuing",1572,875,697,-2
164580,Babson College,2013,"All students, Graduate",1237,841,396,-2
164614,Boston Baptist College,2013,All students total,96,55,41,-2
164614,Boston Baptist College,2013,"All students, Undergraduate total",96,55,41,-2
164614,Boston Baptist College,2013,"All students, Undergraduate, Degree/certificate-seeking total",83,51,32,-2
164614,Boston Baptist College,2013,"All students, Undergraduate, Degree/certificate-seeking, First-time",15,8,7,-2
164614,Boston Baptist College,2013,"All students, Undergraduate, Other degree/certificate-seeking",68,43,25,-2
164614,Boston Baptist College,2013,"All students, Undergraduate, Other degree/certifcate-seeking, Transfer-ins",11,6,5,-2
164614,Boston Baptist College,2013,"All students, Undergraduate, Other degree/certifcate-seeking, Continuing",57,37,20,-2
164614,Boston Baptist College,2013,"All students, Undergraduate, Non-degree/certificate-seeking",13,4,9,-2
164632,Bay Path College,2013,All students total,2357,105,2252,-2
164632,Bay Path College,2013,"All students, Undergraduate total",1458,0,1458,-2
164632,Bay Path College,2013,"All students, Undergraduate, Degree/certificate-seeking total",1454,0,1454,-2
164632,Bay Path College,2013,"All students, Undergraduate, Degree/certificate-seeking, First-time",136,0,136,-2
164632,Bay Path College,2013,"All students, Undergraduate, Other degree/certificate-seeking",1318,0,1318,-2
164632,Bay Path College,2013,"All students, Undergraduate, Other degree/certifcate-seeking, Transfer-ins",277,0,277,-2
164632,Bay Path College,2013,"All students, Undergraduate, Other degree/certifcate-seeking, Continuing",1041,0,1041,-2
164632,Bay Path College,2013,"All students, Undergraduate, Non-degree/certificate-seeking",4,0,4,-2
164632,Bay Path College,2013,"All students, Graduate",899,105,794,-2
164641,Bay State College,2013,All students total,1204,334,870,-2
164641,Bay State College,2013,"All students, Undergraduate total",1204,334,870,-2
164641,Bay State College,2013,"All students, Undergraduate, Degree/certificate-seeking total",1196,329,867,-2
164641,Bay State College,2013,"All students, Undergraduate, Degree/certificate-seeking, First-time",178,77,101,-2
164641,Bay State College,2013,"All students, Undergraduate, Other degree/certificate-seeking",1018,252,766,-2
164641,Bay State College,2013,"All students, Undergraduate, Other degree/certifcate-seeking, Transfer-ins",278,83,195,-2
164641,Bay State College,2013,"All students, Undergraduate, Other degree/certifcate-seeking, Continuing",740,169,571,-2
164641,Bay State College,2013,"All students, Undergraduate, Non-degree/certificate-seeking",8,5,3,-2
164720,Becker College,2013,All students total,1902,820,1082,-2
164720,Becker College,2013,"All students, Undergraduate total",1902,820,1082,-2
164720,Becker College,2013,"All students, Undergraduate, Degree/certificate-seeking total",1871,807,1064,-2
164720,Becker College,2013,"All students, Undergraduate, Degree/certificate-seeking, First-time",359,188,171,-2
164720,Becker College,2013,"All students, Undergraduate, Other degree/certificate-seeking",1512,619,893,-2
164720,Becker College,2013,"All students, Undergraduate, Other degree/certifcate-seeking, Transfer-ins",213,84,129,-2
164720,Becker College,2013,"All students, Undergraduate, Other degree/certifcate-seeking, Continuing",1299,535,764,-2
164720,Becker College,2013,"All students, Undergraduate, Non-degree/certificate-seeking",31,13,18,-2
164739,Bentley University,2013,All students total,5658,3255,2403,-2
164739,Bentley University,2013,"All students, Undergraduate total",4247,2549,1698,-2
164739,Bentley University,2013,"All students, Undergraduate, Degree/certificate-seeking total",4172,2512,1660,-2
164739,Bentley University,2013,"All students, Undergraduate, Degree/certificate-seeking, First-time",974,604,370,-2
164739,Bentley University,2013,"All students, Undergraduate, Other degree/certificate-seeking",3198,1908,1290,-2
164739,Bentley University,2013,"All students, Undergraduate, Other degree/certifcate-seeking, Transfer-ins",155,100,55,-2
164739,Bentley University,2013,"All students, Undergraduate, Other degree/certifcate-seeking, Continuing",3043,1808,1235,-2
164739,Bentley University,2013,"All students, Undergraduate, Non-degree/certificate-seeking",75,37,38,-2
164739,Bentley University,2013,"All students, Graduate",1411,706,705,-2
164748,Berklee College of Music,2013,All students total,4519,3121,1398,-2
164748,Berklee College of Music,2013,"All students, Undergraduate total",4402,3036,1366,-2
164748,Berklee College of Music,2013,"All students, Undergraduate, Degree/certificate-seeking total",4402,3036,1366,-2
164748,Berklee College of Music,2013,"All students, Undergraduate, Degree/certificate-seeking, First-time",910,601,309,-2
164748,Berklee College of Music,2013,"All students, Undergraduate, Other degree/certificate-seeking",3492,2435,1057,-2
164748,Berklee College of Music,2013,"All students, Undergraduate, Other degree/certifcate-seeking, Transfer-ins",162,107,55,-2
164748,Berklee College of Music,2013,"All students, Undergraduate, Other degree/certifcate-seeking, Continuing",3330,2328,1002,-2
164748,Berklee College of Music,2013,"All students, Graduate",117,85,32,-2
164872,Boston Architectural College,2013,All students total,1037,564,473,-2
164872,Boston Architectural College,2013,"All students, Undergraduate total",578,330,248,-2
164872,Boston Architectural College,2013,"All students, Undergraduate, Degree/certificate-seeking total",423,284,139,-2
164872,Boston Architectural College,2013,"All students, Undergraduate, Degree/certificate-seeking, First-time",15,11,4,-2
164872,Boston Architectural College,2013,"All students, Undergraduate, Other degree/certificate-seeking",408,273,135,-2
164872,Boston Architectural College,2013,"All students, Undergraduate, Other degree/certifcate-seeking, Transfer-ins",44,22,22,-2
164872,Boston Architectural College,2013,"All students, Undergraduate, Other degree/certifcate-seeking, Continuing",364,251,113,-2
164872,Boston Architectural College,2013,"All students, Undergraduate, Non-degree/certificate-seeking",155,46,109,-2
164872,Boston Architectural College,2013,"All students, Graduate",459,234,225,-2
164915,Boston Graduate School of Psychoanalysis Inc,2013,All students total,147,45,102,-2
164915,Boston Graduate School of Psychoanalysis Inc,2013,"All students, Graduate",147,45,102,-2
164924,Boston College,2013,All students total,14309,6500,7809,-2
164924,Boston College,2013,"All students, Undergraduate total",9698,4530,5168,-2
164924,Boston College,2013,"All students, Undergraduate, Degree/certificate-seeking total",9465,4408,5057,-2
164924,Boston College,2013,"All students, Undergraduate, Degree/certificate-seeking, First-time",2309,1066,1243,-2
164924,Boston College,2013,"All students, Undergraduate, Other degree/certificate-seeking",7156,3342,3814,-2
164924,Boston College,2013,"All students, Undergraduate, Other degree/certifcate-seeking, Transfer-ins",125,50,75,-2
164924,Boston College,2013,"All students, Undergraduate, Other degree/certifcate-seeking, Continuing",7031,3292,3739,-2
164924,Boston College,2013,"All students, Undergraduate, Non-degree/certificate-seeking",233,122,111,-2
164924,Boston College,2013,"All students, Graduate",4611,1970,2641,-2
164933,The Boston Conservatory,2013,All students total,774,308,466,-2
164933,The Boston Conservatory,2013,"All students, Undergraduate total",545,215,330,-2
164933,The Boston Conservatory,2013,"All students, Undergraduate, Degree/certificate-seeking total",545,215,330,-2
164933,The Boston Conservatory,2013,"All students, Undergraduate, Degree/certificate-seeking, First-time",133,52,81,-2
164933,The Boston Conservatory,2013,"All students, Undergraduate, Other degree/certificate-seeking",412,163,249,-2
164933,The Boston Conservatory,2013,"All students, Undergraduate, Other degree/certifcate-seeking, Transfer-ins",16,6,10,-2
164933,The Boston Conservatory,2013,"All students, Undergraduate, Other degree/certifcate-seeking, Continuing",396,157,239,-2
164933,The Boston Conservatory,2013,"All students, Graduate",229,93,136,-2
164988,Boston University,2013,All students total,32411,13628,18783,-2
164988,Boston University,2013,"All students, Undergraduate total",18165,7348,10817,-2
164988,Boston University,2013,"All students, Undergraduate, Degree/certificate-seeking total",16460,6527,9933,-2
164988,Boston University,2013,"All students, Undergraduate, Degree/certificate-seeking, First-time",3807,1445,2362,-2
164988,Boston University,2013,"All students, Undergraduate, Other degree/certificate-seeking",12653,5082,7571,-2
164988,Boston University,2013,"All students, Undergraduate, Other degree/certifcate-seeking, Transfer-ins",366,154,212,-2
164988,Boston University,2013,"All students, Undergraduate, Other degree/certifcate-seeking, Continuing",12287,4928,7359,-2
164988,Boston University,2013,"All students, Undergraduate, Non-degree/certificate-seeking",1705,821,884,-2
164988,Boston University,2013,"All students, Graduate",14246,6280,7966,-2
165015,Brandeis University,2013,All students total,5825,2658,3167,-2
165015,Brandeis University,2013,"All students, Undergraduate total",3614,1568,2046,-2
165015,Brandeis University,2013,"All students, Undergraduate, Degree/certificate-seeking total",3603,1565,2038,-2
165015,Brandeis University,2013,"All students, Undergraduate, Degree/certificate-seeking, First-time",833,376,457,-2
165015,Brandeis University,2013,"All students, Undergraduate, Other degree/certificate-seeking",2770,1189,1581,-2
165015,Brandeis University,2013,"All students, Undergraduate, Other degree/certifcate-seeking, Transfer-ins",69,31,38,-2
165015,Brandeis University,2013,"All students, Undergraduate, Other degree/certifcate-seeking, Continuing",2701,1158,1543,-2
165015,Brandeis University,2013,"All students, Undergraduate, Non-degree/certificate-seeking",11,3,8,-2
165015,Brandeis University,2013,"All students, Graduate",2211,1090,1121,-2
165024,Bridgewater State University,2013,All students total,11267,4453,6814,-2
165024,Bridgewater State University,2013,"All students, Undergraduate total",9615,3998,5617,-2
165024,Bridgewater State University,2013,"All students, Undergraduate, Degree/certificate-seeking total",9489,3943,5546,-2
165024,Bridgewater State University,2013,"All students, Undergraduate, Degree/certificate-seeking, First-time",1474,590,884,-2
165024,Bridgewater State University,2013,"All students, Undergraduate, Other degree/certificate-seeking",8015,3353,4662,-2
165024,Bridgewater State University,2013,"All students, Undergraduate, Other degree/certifcate-seeking, Transfer-ins",1019,431,588,-2
165024,Bridgewater State University,2013,"All students, Undergraduate, Other degree/certifcate-seeking, Continuing",6996,2922,4074,-2
165024,Bridgewater State University,2013,"All students, Undergraduate, Non-degree/certificate-seeking",126,55,71,-2
165024,Bridgewater State University,2013,"All students, Graduate",1652,455,1197,-2
165167,Cambridge College,2013,All students total,3114,880,2234,-2
165167,Cambridge College,2013,"All students, Undergraduate total",1050,367,683,-2
165167,Cambridge College,2013,"All students, Undergraduate, Degree/certificate-seeking total",1042,367,675,-2
165167,Cambridge College,2013,"All students, Undergraduate, Degree/certificate-seeking, First-time",186,83,103,-2
165167,Cambridge College,2013,"All students, Undergraduate, Other degree/certificate-seeking",856,284,572,-2
165167,Cambridge College,2013,"All students, Undergraduate, Other degree/certifcate-seeking, Transfer-ins",89,27,62,-2
165167,Cambridge College,2013,"All students, Undergraduate, Other degree/certifcate-seeking, Continuing",767,257,510,-2
165167,Cambridge College,2013,"All students, Undergraduate, Non-degree/certificate-seeking",8,0,8,-2
165167,Cambridge College,2013,"All students, Graduate",2064,513,1551,-2
165264,Laboure College,2013,All students total,698,75,623,-2
165264,Laboure College,2013,"All students, Undergraduate total",698,75,623,-2
165264,Laboure College,2013,"All students, Undergraduate, Degree/certificate-seeking total",680,74,606,-2
165264,Laboure College,2013,"All students, Undergraduate, Degree/certificate-seeking, First-time",18,3,15,-2
165264,Laboure College,2013,"All students, Undergraduate, Other degree/certificate-seeking",662,71,591,-2
165264,Laboure College,2013,"All students, Undergraduate, Other degree/certifcate-seeking, Transfer-ins",2,0,2,-2
165264,Laboure College,2013,"All students, Undergraduate, Other degree/certifcate-seeking, Continuing",660,71,589,-2
165264,Laboure College,2013,"All students, Undergraduate, Non-degree/certificate-seeking",18,1,17,-2
165334,Clark University,2013,All students total,3551,1508,2043,-2
165334,Clark University,2013,"All students, Undergraduate total",2380,997,1383,-2
165334,Clark University,2013,"All students, Undergraduate, Degree/certificate-seeking total",2312,971,1341,-2
165334,Clark University,2013,"All students, Undergraduate, Degree/certificate-seeking, First-time",621,235,386,-2
165334,Clark University,2013,"All students, Undergraduate, Other degree/certificate-seeking",1691,736,955,-2
165334,Clark University,2013,"All students, Undergraduate, Other degree/certifcate-seeking, Transfer-ins",51,24,27,-2
165334,Clark University,2013,"All students, Undergraduate, Other degree/certifcate-seeking, Continuing",1640,712,928,-2
165334,Clark University,2013,"All students, Undergraduate, Non-degree/certificate-seeking",68,26,42,-2
165334,Clark University,2013,"All students, Graduate",1171,511,660,-2
165495,Conway School of Landscape Design,2013,All students total,16,6,10,-2
165495,Conway School of Landscape Design,2013,"All students, Graduate",16,6,10,-2
165529,Curry College,2013,All students total,3074,1154,1920,-2
165529,Curry College,2013,"All students, Undergraduate total",2849,1067,1782,-2
165529,Curry College,2013,"All students, Undergraduate, Degree/certificate-seeking total",2794,1052,1742,-2
165529,Curry College,2013,"All students, Undergraduate, Degree/certificate-seeking, First-time",657,289,368,-2
165529,Curry College,2013,"All students, Undergraduate, Other degree/certificate-seeking",2137,763,1374,-2
165529,Curry College,2013,"All students, Undergraduate, Other degree/certifcate-seeking, Transfer-ins",175,53,122,-2
165529,Curry College,2013,"All students, Undergraduate, Other degree/certifcate-seeking, Continuing",1962,710,1252,-2
165529,Curry College,2013,"All students, Undergraduate, Non-degree/certificate-seeking",55,15,40,-2
165529,Curry College,2013,"All students, Graduate",225,87,138,-2
165574,Dean College,2013,All students total,1300,689,611,-2
165574,Dean College,2013,"All students, Undergraduate total",1300,689,611,-2
165574,Dean College,2013,"All students, Undergraduate, Degree/certificate-seeking total",1238,664,574,-2
165574,Dean College,2013,"All students, Undergraduate, Degree/certificate-seeking, First-time",528,317,211,-2
165574,Dean College,2013,"All students, Undergraduate, Other degree/certificate-seeking",710,347,363,-2
165574,Dean College,2013,"All students, Undergraduate, Other degree/certifcate-seeking, Transfer-ins",40,21,19,-2
165574,Dean College,2013,"All students, Undergraduate, Other degree/certifcate-seeking, Continuing",670,326,344,-2
165574,Dean College,2013,"All students, Undergraduate, Non-degree/certificate-seeking",62,25,37,-2
165644,Eastern Nazarene College,2013,All students total,1478,383,1095,-2
165644,Eastern Nazarene College,2013,"All students, Undergraduate total",1321,352,969,-2
165644,Eastern Nazarene College,2013,"All students, Undergraduate, Degree/certificate-seeking total",1313,348,965,-2
165644,Eastern Nazarene College,2013,"All students, Undergraduate, Degree/certificate-seeking, First-time",165,65,100,-2
165644,Eastern Nazarene College,2013,"All students, Undergraduate, Other degree/certificate-seeking",1148,283,865,-2
165644,Eastern Nazarene College,2013,"All students, Undergraduate, Other degree/certifcate-seeking, Transfer-ins",51,19,32,-2
165644,Eastern Nazarene College,2013,"All students, Undergraduate, Other degree/certifcate-seeking, Continuing",1097,264,833,-2
165644,Eastern Nazarene College,2013,"All students, Undergraduate, Non-degree/certificate-seeking",8,4,4,-2
165644,Eastern Nazarene College,2013,"All students, Graduate",157,31,126,-2
165662,Emerson College,2013,All students total,4561,1604,2957,-2
165662,Emerson College,2013,"All students, Undergraduate total",3758,1406,2352,-2
165662,Emerson College,2013,"All students, Undergraduate, Degree/certificate-seeking total",3720,1399,2321,-2
165662,Emerson College,2013,"All students, Undergraduate, Degree/certificate-seeking, First-time",863,304,559,-2
165662,Emerson College,2013,"All students, Undergraduate, Other degree/certificate-seeking",2857,1095,1762,-2
165662,Emerson College,2013,"All students, Undergraduate, Other degree/certifcate-seeking, Transfer-ins",188,66,122,-2
165662,Emerson College,2013,"All students, Undergraduate, Other degree/certifcate-seeking, Continuing",2669,1029,1640,-2
165662,Emerson College,2013,"All students, Undergraduate, Non-degree/certificate-seeking",38,7,31,-2
165662,Emerson College,2013,"All students, Graduate",803,198,605,-2
165671,Emmanuel College,2013,All students total,2436,630,1806,-2
165671,Emmanuel College,2013,"All students, Undergraduate total",2176,580,1596,-2
165671,Emmanuel College,2013,"All students, Undergraduate, Degree/certificate-seeking total",2040,555,1485,-2
165671,Emmanuel College,2013,"All students, Undergraduate, Degree/certificate-seeking, First-time",515,128,387,-2
165671,Emmanuel College,2013,"All students, Undergraduate, Other degree/certificate-seeking",1525,427,1098,-2
165671,Emmanuel College,2013,"All students, Undergraduate, Other degree/certifcate-seeking, Transfer-ins",55,15,40,-2
165671,Emmanuel College,2013,"All students, Undergraduate, Other degree/certifcate-seeking, Continuing",1470,412,1058,-2
165671,Emmanuel College,2013,"All students, Undergraduate, Non-degree/certificate-seeking",136,25,111,-2
165671,Emmanuel College,2013,"All students, Graduate",260,50,210,-2
165699,Endicott College,2013,All students total,5029,1613,3416,-2
165699,Endicott College,2013,"All students, Undergraduate total",2724,1079,1645,-2
165699,Endicott College,2013,"All students, Undergraduate, Degree/certificate-seeking total",2621,1017,1604,-2
165699,Endicott College,2013,"All students, Undergraduate, Degree/certificate-seeking, First-time",662,249,413,-2
165699,Endicott College,2013,"All students, Undergraduate, Other degree/certificate-seeking",1959,768,1191,-2
165699,Endicott College,2013,"All students, Undergraduate, Other degree/certifcate-seeking, Transfer-ins",99,30,69,-2
165699,Endicott College,2013,"All students, Undergraduate, Other degree/certifcate-seeking, Continuing",1860,738,1122,-2
165699,Endicott College,2013,"All students, Undergraduate, Non-degree/certificate-seeking",103,62,41,-2
165699,Endicott College,2013,"All students, Graduate",2305,534,1771,-2
165705,Episcopal Divinity School,2013,All students total,70,24,46,-2
165705,Episcopal Divinity School,2013,"All students, Graduate",70,24,46,-2
165802,Fisher College,2013,All students total,1930,504,1426,-2
165802,Fisher College,2013,"All students, Undergraduate total",1930,504,1426,-2
165802,Fisher College,2013,"All students, Undergraduate, Degree/certificate-seeking total",1733,487,1246,-2
165802,Fisher College,2013,"All students, Undergraduate, Degree/certificate-seeking, First-time",335,103,232,-2
165802,Fisher College,2013,"All students, Undergraduate, Other degree/certificate-seeking",1398,384,1014,-2
165802,Fisher College,2013,"All students, Undergraduate, Other degree/certifcate-seeking, Transfer-ins",553,134,419,-2
165802,Fisher College,2013,"All students, Undergraduate, Other degree/certifcate-seeking, Continuing",845,250,595,-2
165802,Fisher College,2013,"All students, Undergraduate, Non-degree/certificate-seeking",197,17,180,-2
165820,Fitchburg State University,2013,All students total,6680,2431,4249,-2
165820,Fitchburg State University,2013,"All students, Undergraduate total",4245,1853,2392,-2
165820,Fitchburg State University,2013,"All students, Undergraduate, Degree/certificate-seeking total",4148,1816,2332,-2
165820,Fitchburg State University,2013,"All students, Undergraduate, Degree/certificate-seeking, First-time",801,347,454,-2
165820,Fitchburg State University,2013,"All students, Undergraduate, Other degree/certificate-seeking",3347,1469,1878,-2
165820,Fitchburg State University,2013,"All students, Undergraduate, Other degree/certifcate-seeking, Transfer-ins",398,175,223,-2
165820,Fitchburg State University,2013,"All students, Undergraduate, Other degree/certifcate-seeking, Continuing",2949,1294,1655,-2
165820,Fitchburg State University,2013,"All students, Undergraduate, Non-degree/certificate-seeking",97,37,60,-2
165820,Fitchburg State University,2013,"All students, Graduate",2435,578,1857,-2
165866,Framingham State University,2013,All students total,6429,2036,4393,-2
165866,Framingham State University,2013,"All students, Undergraduate total",4584,1690,2894,-2
165866,Framingham State University,2013,"All students, Undergraduate, Degree/certificate-seeking total",4255,1512,2743,-2
165866,Framingham State University,2013,"All students, Undergraduate, Degree/certificate-seeking, First-time",809,249,560,-2
165866,Framingham State University,2013,"All students, Undergraduate, Other degree/certificate-seeking",3446,1263,2183,-2
165866,Framingham State University,2013,"All students, Undergraduate, Other degree/certifcate-seeking, Transfer-ins",413,181,232,-2
165866,Framingham State University,2013,"All students, Undergraduate, Other degree/certifcate-seeking, Continuing",3033,1082,1951,-2
165866,Framingham State University,2013,"All students, Undergraduate, Non-degree/certificate-seeking",329,178,151,-2
165866,Framingham State University,2013,"All students, Graduate",1845,346,1499,-2
165884,Benjamin Franklin Institute of Technology,2013,All students total,482,434,48,-2
165884,Benjamin Franklin Institute of Technology,2013,"All students, Undergraduate total",482,434,48,-2
165884,Benjamin Franklin Institute of Technology,2013,"All students, Undergraduate, Degree/certificate-seeking total",463,416,47,-2
165884,Benjamin Franklin Institute of Technology,2013,"All students, Undergraduate, Degree/certificate-seeking, First-time",184,170,14,-2
165884,Benjamin Franklin Institute of Technology,2013,"All students, Undergraduate, Other degree/certificate-seeking",279,246,33,-2
165884,Benjamin Franklin Institute of Technology,2013,"All students, Undergraduate, Other degree/certifcate-seeking, Transfer-ins",27,23,4,-2
165884,Benjamin Franklin Institute of Technology,2013,"All students, Undergraduate, Other degree/certifcate-seeking, Continuing",252,223,29,-2
165884,Benjamin Franklin Institute of Technology,2013,"All students, Undergraduate, Non-degree/certificate-seeking",19,18,1,-2
165936,Gordon College,2013,All students total,2073,721,1352,-2
165936,Gordon College,2013,"All students, Undergraduate total",1710,652,1058,-2
165936,Gordon College,2013,"All students, Undergraduate, Degree/certificate-seeking total",1681,644,1037,-2
165936,Gordon College,2013,"All students, Undergraduate, Degree/certificate-seeking, First-time",478,176,302,-2
165936,Gordon College,2013,"All students, Undergraduate, Other degree/certificate-seeking",1203,468,735,-2
165936,Gordon College,2013,"All students, Undergraduate, Other degree/certifcate-seeking, Transfer-ins",73,21,52,-2
165936,Gordon College,2013,"All students, Undergraduate, Other degree/certifcate-seeking, Continuing",1130,447,683,-2
165936,Gordon College,2013,"All students, Undergraduate, Non-degree/certificate-seeking",29,8,21,-2
165936,Gordon College,2013,"All students, Graduate",363,69,294,-2
165945,Gordon-Conwell Theological Seminary,2013,All students total,2137,1512,625,-2
165945,Gordon-Conwell Theological Seminary,2013,"All students, Graduate",2137,1512,625,-2
166018,Hampshire College,2013,All students total,1492,646,846,-2
166018,Hampshire College,2013,"All students, Undergraduate total",1492,646,846,-2
166018,Hampshire College,2013,"All students, Undergraduate, Degree/certificate-seeking total",1468,637,831,-2
166018,Hampshire College,2013,"All students, Undergraduate, Degree/certificate-seeking, First-time",381,153,228,-2
166018,Hampshire College,2013,"All students, Undergraduate, Other degree/certificate-seeking",1087,484,603,-2
166018,Hampshire College,2013,"All students, Undergraduate, Other degree/certifcate-seeking, Transfer-ins",73,34,39,-2
166018,Hampshire College,2013,"All students, Undergraduate, Other degree/certifcate-seeking, Continuing",1014,450,564,-2
166018,Hampshire College,2013,"All students, Undergraduate, Non-degree/certificate-seeking",24,9,15,-2
166027,Harvard University,2013,All students total,28297,14478,13819,-2
166027,Harvard University,2013,"All students, Undergraduate total",10534,5268,5266,-2
166027,Harvard University,2013,"All students, Undergraduate, Degree/certificate-seeking total",7278,3779,3499,-2
166027,Harvard University,2013,"All students, Undergraduate, Degree/certificate-seeking, First-time",1658,869,789,-2
166027,Harvard University,2013,"All students, Undergraduate, Other degree/certificate-seeking",5620,2910,2710,-2
166027,Harvard University,2013,"All students, Undergraduate, Other degree/certifcate-seeking, Transfer-ins",13,6,7,-2
166027,Harvard University,2013,"All students, Undergraduate, Other degree/certifcate-seeking, Continuing",5607,2904,2703,-2
166027,Harvard University,2013,"All students, Undergraduate, Non-degree/certificate-seeking",3256,1489,1767,-2
166027,Harvard University,2013,"All students, Graduate",17763,9210,8553,-2
166045,Hebrew College,2013,All students total,188,64,124,-2
166045,Hebrew College,2013,"All students, Undergraduate total",4,1,3,-2
166045,Hebrew College,2013,"All students, Undergraduate, Degree/certificate-seeking total",4,1,3,-2
166045,Hebrew College,2013,"All students, Undergraduate, Other degree/certificate-seeking",4,1,3,-2
166045,Hebrew College,2013,"All students, Undergraduate, Other degree/certifcate-seeking, Continuing",4,1,3,-2
166045,Hebrew College,2013,"All students, Graduate",184,63,121,-2
166054,Hellenic College-Holy Cross Greek Orthodox School of Theology,2013,All students total,208,154,54,-2
166054,Hellenic College-Holy Cross Greek Orthodox School of Theology,2013,"All students, Undergraduate total",92,49,43,-2
166054,Hellenic College-Holy Cross Greek Orthodox School of Theology,2013,"All students, Undergraduate, Degree/certificate-seeking total",92,49,43,-2
166054,Hellenic College-Holy Cross Greek Orthodox School of Theology,2013,"All students, Undergraduate, Degree/certificate-seeking, First-time",16,10,6,-2
166054,Hellenic College-Holy Cross Greek Orthodox School of Theology,2013,"All students, Undergraduate, Other degree/certificate-seeking",76,39,37,-2
166054,Hellenic College-Holy Cross Greek Orthodox School of Theology,2013,"All students, Undergraduate, Other degree/certifcate-seeking, Transfer-ins",15,7,8,-2
166054,Hellenic College-Holy Cross Greek Orthodox School of Theology,2013,"All students, Undergraduate, Other degree/certifcate-seeking, Continuing",61,32,29,-2
166054,Hellenic College-Holy Cross Greek Orthodox School of Theology,2013,"All students, Graduate",116,105,11,-2
166124,College of the Holy Cross,2013,All students total,2912,1449,1463,-2
166124,College of the Holy Cross,2013,"All students, Undergraduate total",2912,1449,1463,-2
166124,College of the Holy Cross,2013,"All students, Undergraduate, Degree/certificate-seeking total",2878,1438,1440,-2
166124,College of the Holy Cross,2013,"All students, Undergraduate, Degree/certificate-seeking, First-time",719,368,351,-2
166124,College of the Holy Cross,2013,"All students, Undergraduate, Other degree/certificate-seeking",2159,1070,1089,-2
166124,College of the Holy Cross,2013,"All students, Undergraduate, Other degree/certifcate-seeking, Transfer-ins",13,7,6,-2
166124,College of the Holy Cross,2013,"All students, Undergraduate, Other degree/certifcate-seeking, Continuing",2146,1063,1083,-2
166124,College of the Holy Cross,2013,"All students, Undergraduate, Non-degree/certificate-seeking",34,11,23,-2
166391,Lasell College,2013,All students total,2081,726,1355,-2
166391,Lasell College,2013,"All students, Undergraduate total",1687,608,1079,-2
166391,Lasell College,2013,"All students, Undergraduate, Degree/certificate-seeking total",1667,602,1065,-2
166391,Lasell College,2013,"All students, Undergraduate, Degree/certificate-seeking, First-time",485,162,323,-2
166391,Lasell College,2013,"All students, Undergraduate, Other degree/certificate-seeking",1182,440,742,-2
166391,Lasell College,2013,"All students, Undergraduate, Other degree/certifcate-seeking, Transfer-ins",73,36,37,-2
166391,Lasell College,2013,"All students, Undergraduate, Other degree/certifcate-seeking, Continuing",1109,404,705,-2
166391,Lasell College,2013,"All students, Undergraduate, Non-degree/certificate-seeking",20,6,14,-2
166391,Lasell College,2013,"All students, Graduate",394,118,276,-2
166452,Lesley University,2013,All students total,5195,929,4266,-2
166452,Lesley University,2013,"All students, Undergraduate total",1948,448,1500,-2
166452,Lesley University,2013,"All students, Undergraduate, Degree/certificate-seeking total",1785,402,1383,-2
166452,Lesley University,2013,"All students, Undergraduate, Degree/certificate-seeking, First-time",323,74,249,-2
166452,Lesley University,2013,"All students, Undergraduate, Other degree/certificate-seeking",1462,328,1134,-2
166452,Lesley University,2013,"All students, Undergraduate, Other degree/certifcate-seeking, Transfer-ins",152,30,122,-2
166452,Lesley University,2013,"All students, Undergraduate, Other degree/certifcate-seeking, Continuing",1310,298,1012,-2
166452,Lesley University,2013,"All students, Undergraduate, Non-degree/certificate-seeking",163,46,117,-2
166452,Lesley University,2013,"All students, Graduate",3247,481,2766,-2
166489,Longy School of Music of Bard College,2013,All students total,265,105,160,-2
166489,Longy School of Music of Bard College,2013,"All students, Undergraduate total",58,25,33,-2
166489,Longy School of Music of Bard College,2013,"All students, Undergraduate, Degree/certificate-seeking total",58,25,33,-2
166489,Longy School of Music of Bard College,2013,"All students, Undergraduate, Degree/certificate-seeking, First-time",12,7,5,-2
166489,Longy School of Music of Bard College,2013,"All students, Undergraduate, Other degree/certificate-seeking",46,18,28,-2
166489,Longy School of Music of Bard College,2013,"All students, Undergraduate, Other degree/certifcate-seeking, Transfer-ins",6,1,5,-2
166489,Longy School of Music of Bard College,2013,"All students, Undergraduate, Other degree/certifcate-seeking, Continuing",40,17,23,-2
166489,Longy School of Music of Bard College,2013,"All students, Graduate",207,80,127,-2
166513,University of Massachusetts-Lowell,2013,All students total,16932,10017,6915,-2
166513,University of Massachusetts-Lowell,2013,"All students, Undergraduate total",12734,7777,4957,-2
166513,University of Massachusetts-Lowell,2013,"All students, Undergraduate, Degree/certificate-seeking total",11830,7217,4613,-2
166513,University of Massachusetts-Lowell,2013,"All students, Undergraduate, Degree/certificate-seeking, First-time",1650,1057,593,-2
166513,University of Massachusetts-Lowell,2013,"All students, Undergraduate, Other degree/certificate-seeking",10180,6160,4020,-2
166513,University of Massachusetts-Lowell,2013,"All students, Undergraduate, Other degree/certifcate-seeking, Transfer-ins",1289,729,560,-2
166513,University of Massachusetts-Lowell,2013,"All students, Undergraduate, Other degree/certifcate-seeking, Continuing",8891,5431,3460,-2
166513,University of Massachusetts-Lowell,2013,"All students, Undergraduate, Non-degree/certificate-seeking",904,560,344,-2
166513,University of Massachusetts-Lowell,2013,"All students, Graduate",4198,2240,1958,-2
166601,Marian Court College,2013,All students total,266,73,193,-2
166601,Marian Court College,2013,"All students, Undergraduate total",266,73,193,-2
166601,Marian Court College,2013,"All students, Undergraduate, Degree/certificate-seeking total",173,41,132,-2
166601,Marian Court College,2013,"All students, Undergraduate, Degree/certificate-seeking, First-time",24,3,21,-2
166601,Marian Court College,2013,"All students, Undergraduate, Other degree/certificate-seeking",149,38,111,-2
166601,Marian Court College,2013,"All students, Undergraduate, Other degree/certifcate-seeking, Transfer-ins",13,4,9,-2
166601,Marian Court College,2013,"All students, Undergraduate, Other degree/certifcate-seeking, Continuing",136,34,102,-2
166601,Marian Court College,2013,"All students, Undergraduate, Non-degree/certificate-seeking",93,32,61,-2
166629,University of Massachusetts-Amherst,2013,All students total,28518,14467,14051,-2
166629,University of Massachusetts-Amherst,2013,"All students, Undergraduate total",22134,11260,10874,-2
166629,University of Massachusetts-Amherst,2013,"All students, Undergraduate, Degree/certificate-seeking total",21672,11067,10605,-2
166629,University of Massachusetts-Amherst,2013,"All students, Undergraduate, Degree/certificate-seeking, First-time",4686,2407,2279,-2
166629,University of Massachusetts-Amherst,2013,"All students, Undergraduate, Other degree/certificate-seeking",16986,8660,8326,-2
166629,University of Massachusetts-Amherst,2013,"All students, Undergraduate, Other degree/certifcate-seeking, Transfer-ins",1468,732,736,-2
166629,University of Massachusetts-Amherst,2013,"All students, Undergraduate, Other degree/certifcate-seeking, Continuing",15518,7928,7590,-2
166629,University of Massachusetts-Amherst,2013,"All students, Undergraduate, Non-degree/certificate-seeking",462,193,269,-2
166629,University of Massachusetts-Amherst,2013,"All students, Graduate",6384,3207,3177,-2
166638,University of Massachusetts-Boston,2013,All students total,16277,6664,9613,-2
166638,University of Massachusetts-Boston,2013,"All students, Undergraduate total",12366,5438,6928,-2
166638,University of Massachusetts-Boston,2013,"All students, Undergraduate, Degree/certificate-seeking total",11786,5154,6632,-2
166638,University of Massachusetts-Boston,2013,"All students, Undergraduate, Degree/certificate-seeking, First-time",1413,703,710,-2
166638,University of Massachusetts-Boston,2013,"All students, Undergraduate, Other degree/certificate-seeking",10373,4451,5922,-2
166638,University of Massachusetts-Boston,2013,"All students, Undergraduate, Other degree/certifcate-seeking, Transfer-ins",1719,707,1012,-2
166638,University of Massachusetts-Boston,2013,"All students, Undergraduate, Other degree/certifcate-seeking, Continuing",8654,3744,4910,-2
166638,University of Massachusetts-Boston,2013,"All students, Undergraduate, Non-degree/certificate-seeking",580,284,296,-2
166638,University of Massachusetts-Boston,2013,"All students, Graduate",3911,1226,2685,-2
166656,MCPHS University,2013,All students total,6548,2203,4345,-2
166656,MCPHS University,2013,"All students, Undergraduate total",3897,1286,2611,-2
166656,MCPHS University,2013,"All students, Undergraduate, Degree/certificate-seeking total",3808,1278,2530,-2
166656,MCPHS University,2013,"All students, Undergraduate, Degree/certificate-seeking, First-time",912,310,602,-2
166656,MCPHS University,2013,"All students, Undergraduate, Other degree/certificate-seeking",2896,968,1928,-2
166656,MCPHS University,2013,"All students, Undergraduate, Other degree/certifcate-seeking, Transfer-ins",217,56,161,-2
166656,MCPHS University,2013,"All students, Undergraduate, Other degree/certifcate-seeking, Continuing",2679,912,1767,-2
166656,MCPHS University,2013,"All students, Undergraduate, Non-degree/certificate-seeking",89,8,81,-2
166656,MCPHS University,2013,"All students, Graduate",2651,917,1734,-2
166665,University of Massachusetts-Central Office,2013,,,,,-2
166674,Massachusetts College of Art and Design,2013,All students total,2264,697,1567,-2
166674,Massachusetts College of Art and Design,2013,"All students, Undergraduate total",2120,634,1486,-2
166674,Massachusetts College of Art and Design,2013,"All students, Undergraduate, Degree/certificate-seeking total",1861,559,1302,-2
166674,Massachusetts College of Art and Design,2013,"All students, Undergraduate, Degree/certificate-seeking, First-time",367,97,270,-2
166674,Massachusetts College of Art and Design,2013,"All students, Undergraduate, Other degree/certificate-seeking",1494,462,1032,-2
166674,Massachusetts College of Art and Design,2013,"All students, Undergraduate, Other degree/certifcate-seeking, Transfer-ins",127,41,86,-2
166674,Massachusetts College of Art and Design,2013,"All students, Undergraduate, Other degree/certifcate-seeking, Continuing",1367,421,946,-2
166674,Massachusetts College of Art and Design,2013,"All students, Undergraduate, Non-degree/certificate-seeking",259,75,184,-2
166674,Massachusetts College of Art and Design,2013,"All students, Graduate",144,63,81,-2
166683,Massachusetts Institute of Technology,2013,All students total,11301,7139,4162,-2
166683,Massachusetts Institute of Technology,2013,"All students, Undergraduate total",4528,2487,2041,-2
166683,Massachusetts Institute of Technology,2013,"All students, Undergraduate, Degree/certificate-seeking total",4510,2475,2035,-2
166683,Massachusetts Institute of Technology,2013,"All students, Undergraduate, Degree/certificate-seeking, First-time",1115,609,506,-2
166683,Massachusetts Institute of Technology,2013,"All students, Undergraduate, Other degree/certificate-seeking",3395,1866,1529,-2
166683,Massachusetts Institute of Technology,2013,"All students, Undergraduate, Other degree/certifcate-seeking, Transfer-ins",19,14,5,-2
166683,Massachusetts Institute of Technology,2013,"All students, Undergraduate, Other degree/certifcate-seeking, Continuing",3376,1852,1524,-2
166683,Massachusetts Institute of Technology,2013,"All students, Undergraduate, Non-degree/certificate-seeking",18,12,6,-2
166683,Massachusetts Institute of Technology,2013,"All students, Graduate",6773,4652,2121,-2
166692,Massachusetts Maritime Academy,2013,All students total,1476,1296,180,-2
166692,Massachusetts Maritime Academy,2013,"All students, Undergraduate total",1376,1214,162,-2
166692,Massachusetts Maritime Academy,2013,"All students, Undergraduate, Degree/certificate-seeking total",1362,1205,157,-2
166692,Massachusetts Maritime Academy,2013,"All students, Undergraduate, Degree/certificate-seeking, First-time",332,278,54,-2
166692,Massachusetts Maritime Academy,2013,"All students, Undergraduate, Other degree/certificate-seeking",1030,927,103,-2
166692,Massachusetts Maritime Academy,2013,"All students, Undergraduate, Other degree/certifcate-seeking, Transfer-ins",49,45,4,-2
166692,Massachusetts Maritime Academy,2013,"All students, Undergraduate, Other degree/certifcate-seeking, Continuing",981,882,99,-2
166692,Massachusetts Maritime Academy,2013,"All students, Undergraduate, Non-degree/certificate-seeking",14,9,5,-2
166692,Massachusetts Maritime Academy,2013,"All students, Graduate",100,82,18,-2
166708,University of Massachusetts Medical School Worcester,2013,All students total,1161,465,696,-2
166708,University of Massachusetts Medical School Worcester,2013,"All students, Graduate",1161,465,696,-2
166717,Massachusetts School of Professional Psychology,2013,All students total,652,138,514,-2
166717,Massachusetts School of Professional Psychology,2013,"All students, Graduate",652,138,514,-2
166850,Merrimack College,2013,All students total,3067,1478,1589,-2
166850,Merrimack College,2013,"All students, Undergraduate total",2758,1397,1361,-2
166850,Merrimack College,2013,"All students, Undergraduate, Degree/certificate-seeking total",2722,1368,1354,-2
166850,Merrimack College,2013,"All students, Undergraduate, Degree/certificate-seeking, First-time",794,386,408,-2
166850,Merrimack College,2013,"All students, Undergraduate, Other degree/certificate-seeking",1928,982,946,-2
166850,Merrimack College,2013,"All students, Undergraduate, Other degree/certifcate-seeking, Transfer-ins",85,45,40,-2
166850,Merrimack College,2013,"All students, Undergraduate, Other degree/certifcate-seeking, Continuing",1843,937,906,-2
166850,Merrimack College,2013,"All students, Undergraduate, Non-degree/certificate-seeking",36,29,7,-2
166850,Merrimack College,2013,"All students, Graduate",309,81,228,-2
166869,MGH Institute of Health Professions,2013,All students total,1096,184,912,-2
166869,MGH Institute of Health Professions,2013,"All students, Undergraduate total",162,22,140,-2
166869,MGH Institute of Health Professions,2013,"All students, Undergraduate, Degree/certificate-seeking total",160,21,139,-2
166869,MGH Institute of Health Professions,2013,"All students, Undergraduate, Other degree/certificate-seeking",160,21,139,-2
166869,MGH Institute of Health Professions,2013,"All students, Undergraduate, Other degree/certifcate-seeking, Continuing",160,21,139,-2
166869,MGH Institute of Health Professions,2013,"All students, Undergraduate, Non-degree/certificate-seeking",2,1,1,-2
166869,MGH Institute of Health Professions,2013,"All students, Graduate",934,162,772,-2
166911,Montserrat College of Art,2013,All students total,392,106,286,-2
166911,Montserrat College of Art,2013,"All students, Undergraduate total",392,106,286,-2
166911,Montserrat College of Art,2013,"All students, Undergraduate, Degree/certificate-seeking total",378,100,278,-2
166911,Montserrat College of Art,2013,"All students, Undergraduate, Degree/certificate-seeking, First-time",103,22,81,-2
166911,Montserrat College of Art,2013,"All students, Undergraduate, Other degree/certificate-seeking",275,78,197,-2
166911,Montserrat College of Art,2013,"All students, Undergraduate, Other degree/certifcate-seeking, Transfer-ins",18,7,11,-2
166911,Montserrat College of Art,2013,"All students, Undergraduate, Other degree/certifcate-seeking, Continuing",257,71,186,-2
166911,Montserrat College of Art,2013,"All students, Undergraduate, Non-degree/certificate-seeking",14,6,8,-2
166939,Mount Holyoke College,2013,All students total,2251,12,2239,-2
166939,Mount Holyoke College,2013,"All students, Undergraduate total",2183,2,2181,-2
166939,Mount Holyoke College,2013,"All students, Undergraduate, Degree/certificate-seeking total",2154,0,2154,-2
166939,Mount Holyoke College,2013,"All students, Undergraduate, Degree/certificate-seeking, First-time",513,0,513,-2
166939,Mount Holyoke College,2013,"All students, Undergraduate, Other degree/certificate-seeking",1641,0,1641,-2
166939,Mount Holyoke College,2013,"All students, Undergraduate, Other degree/certifcate-seeking, Transfer-ins",58,0,58,-2
166939,Mount Holyoke College,2013,"All students, Undergraduate, Other degree/certifcate-seeking, Continuing",1583,0,1583,-2
166939,Mount Holyoke College,2013,"All students, Undergraduate, Non-degree/certificate-seeking",29,2,27,-2
166939,Mount Holyoke College,2013,"All students, Graduate",68,10,58,-2
166948,Mount Ida College,2013,All students total,1288,442,846,-2
166948,Mount Ida College,2013,"All students, Undergraduate total",1268,436,832,-2
166948,Mount Ida College,2013,"All students, Undergraduate, Degree/certificate-seeking total",1261,433,828,-2
166948,Mount Ida College,2013,"All students, Undergraduate, Degree/certificate-seeking, First-time",307,110,197,-2
166948,Mount Ida College,2013,"All students, Undergraduate, Other degree/certificate-seeking",954,323,631,-2
166948,Mount Ida College,2013,"All students, Undergraduate, Other degree/certifcate-seeking, Transfer-ins",116,30,86,-2
166948,Mount Ida College,2013,"All students, Undergraduate, Other degree/certifcate-seeking, Continuing",838,293,545,-2
166948,Mount Ida College,2013,"All students, Undergraduate, Non-degree/certificate-seeking",7,3,4,-2
166948,Mount Ida College,2013,"All students, Graduate",20,6,14,-2
166984,School of the Museum of Fine Arts-Boston,2013,All students total,651,181,470,-2
166984,School of the Museum of Fine Arts-Boston,2013,"All students, Undergraduate total",484,133,351,-2
166984,School of the Museum of Fine Arts-Boston,2013,"All students, Undergraduate, Degree/certificate-seeking total",340,98,242,-2
166984,School of the Museum of Fine Arts-Boston,2013,"All students, Undergraduate, Degree/certificate-seeking, First-time",54,16,38,-2
166984,School of the Museum of Fine Arts-Boston,2013,"All students, Undergraduate, Other degree/certificate-seeking",286,82,204,-2
166984,School of the Museum of Fine Arts-Boston,2013,"All students, Undergraduate, Other degree/certifcate-seeking, Transfer-ins",32,15,17,-2
166984,School of the Museum of Fine Arts-Boston,2013,"All students, Undergraduate, Other degree/certifcate-seeking, Continuing",254,67,187,-2
166984,School of the Museum of Fine Arts-Boston,2013,"All students, Undergraduate, Non-degree/certificate-seeking",144,35,109,-2
166984,School of the Museum of Fine Arts-Boston,2013,"All students, Graduate",167,48,119,-2
167057,The New England Conservatory of Music,2013,All students total,813,430,383,-2
167057,The New England Conservatory of Music,2013,"All students, Undergraduate total",431,253,178,-2
167057,The New England Conservatory of Music,2013,"All students, Undergraduate, Degree/certificate-seeking total",410,240,170,-2
167057,The New England Conservatory of Music,2013,"All students, Undergraduate, Degree/certificate-seeking, First-time",96,56,40,-2
167057,The New England Conservatory of Music,2013,"All students, Undergraduate, Other degree/certificate-seeking",314,184,130,-2
167057,The New England Conservatory of Music,2013,"All students, Undergraduate, Other degree/certifcate-seeking, Transfer-ins",13,6,7,-2
167057,The New England Conservatory of Music,2013,"All students, Undergraduate, Other degree/certifcate-seeking, Continuing",301,178,123,-2
167057,The New England Conservatory of Music,2013,"All students, Undergraduate, Non-degree/certificate-seeking",21,13,8,-2
167057,The New England Conservatory of Music,2013,"All students, Graduate",382,177,205,-2
167093,New England College of Optometry,2013,All students total,502,137,365,-2
167093,New England College of Optometry,2013,"All students, Graduate",502,137,365,-2
167181,New England School of Acupuncture,2013,All students total,179,42,137,-2
167181,New England School of Acupuncture,2013,"All students, Graduate",179,42,137,-2
167215,New England School of Law,2013,All students total,964,408,556,-2
167215,New England School of Law,2013,"All students, Graduate",964,408,556,-2
167251,Newbury College,2013,All students total,962,426,536,-2
167251,Newbury College,2013,"All students, Undergraduate total",962,426,536,-2
167251,Newbury College,2013,"All students, Undergraduate, Degree/certificate-seeking total",961,425,536,-2
167251,Newbury College,2013,"All students, Undergraduate, Degree/certificate-seeking, First-time",268,121,147,-2
167251,Newbury College,2013,"All students, Undergraduate, Other degree/certificate-seeking",693,304,389,-2
167251,Newbury College,2013,"All students, Undergraduate, Other degree/certifcate-seeking, Transfer-ins",41,21,20,-2
167251,Newbury College,2013,"All students, Undergraduate, Other degree/certifcate-seeking, Continuing",652,283,369,-2
167251,Newbury College,2013,"All students, Undergraduate, Non-degree/certificate-seeking",1,1,0,-2
167260,Nichols College,2013,All students total,1459,854,605,-2
167260,Nichols College,2013,"All students, Undergraduate total",1281,761,520,-2
167260,Nichols College,2013,"All students, Undergraduate, Degree/certificate-seeking total",1260,746,514,-2
167260,Nichols College,2013,"All students, Undergraduate, Degree/certificate-seeking, First-time",380,245,135,-2
167260,Nichols College,2013,"All students, Undergraduate, Other degree/certificate-seeking",880,501,379,-2
167260,Nichols College,2013,"All students, Undergraduate, Other degree/certifcate-seeking, Transfer-ins",58,25,33,-2
167260,Nichols College,2013,"All students, Undergraduate, Other degree/certifcate-seeking, Continuing",822,476,346,-2
167260,Nichols College,2013,"All students, Undergraduate, Non-degree/certificate-seeking",21,15,6,-2
167260,Nichols College,2013,"All students, Graduate",178,93,85,-2
167288,Massachusetts College of Liberal Arts,2013,All students total,1716,684,1032,-2
167288,Massachusetts College of Liberal Arts,2013,"All students, Undergraduate total",1538,612,926,-2
167288,Massachusetts College of Liberal Arts,2013,"All students, Undergraduate, Degree/certificate-seeking total",1483,587,896,-2
167288,Massachusetts College of Liberal Arts,2013,"All students, Undergraduate, Degree/certificate-seeking, First-time",275,92,183,-2
167288,Massachusetts College of Liberal Arts,2013,"All students, Undergraduate, Other degree/certificate-seeking",1208,495,713,-2
167288,Massachusetts College of Liberal Arts,2013,"All students, Undergraduate, Other degree/certifcate-seeking, Transfer-ins",128,49,79,-2
167288,Massachusetts College of Liberal Arts,2013,"All students, Undergraduate, Other degree/certifcate-seeking, Continuing",1080,446,634,-2
167288,Massachusetts College of Liberal Arts,2013,"All students, Undergraduate, Non-degree/certificate-seeking",55,25,30,-2
167288,Massachusetts College of Liberal Arts,2013,"All students, Graduate",178,72,106,-2
167321,The New England Institute of Art,2013,All students total,779,508,271,-2
167321,The New England Institute of Art,2013,"All students, Undergraduate total",779,508,271,-2
167321,The New England Institute of Art,2013,"All students, Undergraduate, Degree/certificate-seeking total",779,508,271,-2
167321,The New England Institute of Art,2013,"All students, Undergraduate, Degree/certificate-seeking, First-time",136,93,43,-2
167321,The New England Institute of Art,2013,"All students, Undergraduate, Other degree/certificate-seeking",643,415,228,-2
167321,The New England Institute of Art,2013,"All students, Undergraduate, Other degree/certifcate-seeking, Transfer-ins",78,53,25,-2
167321,The New England Institute of Art,2013,"All students, Undergraduate, Other degree/certifcate-seeking, Continuing",565,362,203,-2
167358,Northeastern University,2013,All students total,20053,10092,9961,-2
167358,Northeastern University,2013,"All students, Undergraduate total",13223,6427,6796,-2
167358,Northeastern University,2013,"All students, Undergraduate, Degree/certificate-seeking total",13204,6418,6786,-2
167358,Northeastern University,2013,"All students, Undergraduate, Degree/certificate-seeking, First-time",2891,1346,1545,-2
167358,Northeastern University,2013,"All students, Undergraduate, Other degree/certificate-seeking",10313,5072,5241,-2
167358,Northeastern University,2013,"All students, Undergraduate, Other degree/certifcate-seeking, Transfer-ins",656,297,359,-2
167358,Northeastern University,2013,"All students, Undergraduate, Other degree/certifcate-seeking, Continuing",9657,4775,4882,-2
167358,Northeastern University,2013,"All students, Undergraduate, Non-degree/certificate-seeking",19,9,10,-2
167358,Northeastern University,2013,"All students, Graduate",6830,3665,3165,-2
167394,College of Our Lady of the Elms,2013,All students total,1678,382,1296,-2
167394,College of Our Lady of the Elms,2013,"All students, Undergraduate total",1347,320,1027,-2
167394,College of Our Lady of the Elms,2013,"All students, Undergraduate, Degree/certificate-seeking total",1308,310,998,-2
167394,College of Our Lady of the Elms,2013,"All students, Undergraduate, Degree/certificate-seeking, First-time",192,52,140,-2
167394,College of Our Lady of the Elms,2013,"All students, Undergraduate, Other degree/certificate-seeking",1116,258,858,-2
167394,College of Our Lady of the Elms,2013,"All students, Undergraduate, Other degree/certifcate-seeking, Transfer-ins",239,65,174,-2
167394,College of Our Lady of the Elms,2013,"All students, Undergraduate, Other degree/certifcate-seeking, Continuing",877,193,684,-2
167394,College of Our Lady of the Elms,2013,"All students, Undergraduate, Non-degree/certificate-seeking",39,10,29,-2
167394,College of Our Lady of the Elms,2013,"All students, Graduate",331,62,269,-2
167455,Pine Manor College,2013,All students total,346,55,291,-2
167455,Pine Manor College,2013,"All students, Undergraduate total",313,47,266,-2
167455,Pine Manor College,2013,"All students, Undergraduate, Degree/certificate-seeking total",221,3,218,-2
167455,Pine Manor College,2013,"All students, Undergraduate, Degree/certificate-seeking, First-time",53,1,52,-2
167455,Pine Manor College,2013,"All students, Undergraduate, Other degree/certificate-seeking",168,2,166,-2
167455,Pine Manor College,2013,"All students, Undergraduate, Other degree/certifcate-seeking, Transfer-ins",13,0,13,-2
167455,Pine Manor College,2013,"All students, Undergraduate, Other degree/certifcate-seeking, Continuing",155,2,153,-2
167455,Pine Manor College,2013,"All students, Undergraduate, Non-degree/certificate-seeking",92,44,48,-2
167455,Pine Manor College,2013,"All students, Graduate",33,8,25,-2
167464,Blessed John XXIII National Seminary,2013,All students total,57,57,0,-2
167464,Blessed John XXIII National Seminary,2013,"All students, Graduate",57,57,0,-2
167598,Regis College,2013,All students total,2069,388,1681,-2
167598,Regis College,2013,"All students, Undergraduate total",1188,280,908,-2
167598,Regis College,2013,"All students, Undergraduate, Degree/certificate-seeking total",1188,280,908,-2
167598,Regis College,2013,"All students, Undergraduate, Degree/certificate-seeking, First-time",266,54,212,-2
167598,Regis College,2013,"All students, Undergraduate, Other degree/certificate-seeking",922,226,696,-2
167598,Regis College,2013,"All students, Undergraduate, Other degree/certifcate-seeking, Transfer-ins",58,12,46,-2
167598,Regis College,2013,"All students, Undergraduate, Other degree/certifcate-seeking, Continuing",864,214,650,-2
167598,Regis College,2013,"All students, Graduate",881,108,773,-2
167677,Saint John's Seminary,2013,All students total,192,140,52,-2
167677,Saint John's Seminary,2013,"All students, Undergraduate total",43,43,0,-2
167677,Saint John's Seminary,2013,"All students, Undergraduate, Degree/certificate-seeking total",35,35,0,-2
167677,Saint John's Seminary,2013,"All students, Undergraduate, Other degree/certificate-seeking",35,35,0,-2
167677,Saint John's Seminary,2013,"All students, Undergraduate, Other degree/certifcate-seeking, Transfer-ins",17,17,0,-2
167677,Saint John's Seminary,2013,"All students, Undergraduate, Other degree/certifcate-seeking, Continuing",18,18,0,-2
167677,Saint John's Seminary,2013,"All students, Undergraduate, Non-degree/certificate-seeking",8,8,0,-2
167677,Saint John's Seminary,2013,"All students, Graduate",149,97,52,-2
167729,Salem State University,2013,All students total,9301,3437,5864,-2
167729,Salem State University,2013,"All students, Undergraduate total",7664,3013,4651,-2
167729,Salem State University,2013,"All students, Undergraduate, Degree/certificate-seeking total",7134,2766,4368,-2
167729,Salem State University,2013,"All students, Undergraduate, Degree/certificate-seeking, First-time",1087,398,689,-2
167729,Salem State University,2013,"All students, Undergraduate, Other degree/certificate-seeking",6047,2368,3679,-2
167729,Salem State University,2013,"All students, Undergraduate, Other degree/certifcate-seeking, Transfer-ins",782,325,457,-2
167729,Salem State University,2013,"All students, Undergraduate, Other degree/certifcate-seeking, Continuing",5265,2043,3222,-2
167729,Salem State University,2013,"All students, Undergraduate, Non-degree/certificate-seeking",530,247,283,-2
167729,Salem State University,2013,"All students, Graduate",1637,424,1213,-2
167783,Simmons College,2013,All students total,4655,384,4271,-2
167783,Simmons College,2013,"All students, Undergraduate total",1732,3,1729,-2
167783,Simmons College,2013,"All students, Undergraduate, Degree/certificate-seeking total",1710,0,1710,-2
167783,Simmons College,2013,"All students, Undergraduate, Degree/certificate-seeking, First-time",338,0,338,-2
167783,Simmons College,2013,"All students, Undergraduate, Other degree/certificate-seeking",1372,0,1372,-2
167783,Simmons College,2013,"All students, Undergraduate, Other degree/certifcate-seeking, Transfer-ins",59,0,59,-2
167783,Simmons College,2013,"All students, Undergraduate, Other degree/certifcate-seeking, Continuing",1313,0,1313,-2
167783,Simmons College,2013,"All students, Undergraduate, Non-degree/certificate-seeking",22,3,19,-2
167783,Simmons College,2013,"All students, Graduate",2923,381,2542,-2
167792,Bard College at Simon's Rock,2013,All students total,350,148,202,-2
167792,Bard College at Simon's Rock,2013,"All students, Undergraduate total",350,148,202,-2
167792,Bard College at Simon's Rock,2013,"All students, Undergraduate, Degree/certificate-seeking total",344,145,199,-2
167792,Bard College at Simon's Rock,2013,"All students, Undergraduate, Degree/certificate-seeking, First-time",144,57,87,-2
167792,Bard College at Simon's Rock,2013,"All students, Undergraduate, Other degree/certificate-seeking",200,88,112,-2
167792,Bard College at Simon's Rock,2013,"All students, Undergraduate, Other degree/certifcate-seeking, Transfer-ins",2,0,2,-2
167792,Bard College at Simon's Rock,2013,"All students, Undergraduate, Other degree/certifcate-seeking, Continuing",198,88,110,-2
167792,Bard College at Simon's Rock,2013,"All students, Undergraduate, Non-degree/certificate-seeking",6,3,3,-2
167835,Smith College,2013,All students total,3033,68,2965,-2
167835,Smith College,2013,"All students, Undergraduate total",2606,2,2604,-2
167835,Smith College,2013,"All students, Undergraduate, Degree/certificate-seeking total",2606,2,2604,-2
167835,Smith College,2013,"All students, Undergraduate, Degree/certificate-seeking, First-time",643,0,643,-2
167835,Smith College,2013,"All students, Undergraduate, Other degree/certificate-seeking",1963,2,1961,-2
167835,Smith College,2013,"All students, Undergraduate, Other degree/certifcate-seeking, Transfer-ins",85,0,85,-2
167835,Smith College,2013,"All students, Undergraduate, Other degree/certifcate-seeking, Continuing",1878,2,1876,-2
167835,Smith College,2013,"All students, Graduate",427,66,361,-2
167899,Springfield College,2013,All students total,3255,1414,1841,-2
167899,Springfield College,2013,"All students, Undergraduate total",2182,1136,1046,-2
167899,Springfield College,2013,"All students, Undergraduate, Degree/certificate-seeking total",2157,1122,1035,-2
167899,Springfield College,2013,"All students, Undergraduate, Degree/certificate-seeking, First-time",510,261,249,-2
167899,Springfield College,2013,"All students, Undergraduate, Other degree/certificate-seeking",1647,861,786,-2
167899,Springfield College,2013,"All students, Undergraduate, Other degree/certifcate-seeking, Transfer-ins",69,30,39,-2
167899,Springfield College,2013,"All students, Undergraduate, Other degree/certifcate-seeking, Continuing",1578,831,747,-2
167899,Springfield College,2013,"All students, Undergraduate, Non-degree/certificate-seeking",25,14,11,-2
167899,Springfield College,2013,"All students, Graduate",1073,278,795,-2
167987,University of Massachusetts-Dartmouth,2013,All students total,9053,4638,4415,-2
167987,University of Massachusetts-Dartmouth,2013,"All students, Undergraduate total",7437,3885,3552,-2
167987,University of Massachusetts-Dartmouth,2013,"All students, Undergraduate, Degree/certificate-seeking total",7202,3753,3449,-2
167987,University of Massachusetts-Dartmouth,2013,"All students, Undergraduate, Degree/certificate-seeking, First-time",1519,829,690,-2
167987,University of Massachusetts-Dartmouth,2013,"All students, Undergraduate, Other degree/certificate-seeking",5683,2924,2759,-2
167987,University of Massachusetts-Dartmouth,2013,"All students, Undergraduate, Other degree/certifcate-seeking, Transfer-ins",590,291,299,-2
167987,University of Massachusetts-Dartmouth,2013,"All students, Undergraduate, Other degree/certifcate-seeking, Continuing",5093,2633,2460,-2
167987,University of Massachusetts-Dartmouth,2013,"All students, Undergraduate, Non-degree/certificate-seeking",235,132,103,-2
167987,University of Massachusetts-Dartmouth,2013,"All students, Graduate",1616,753,863,-2
167996,Stonehill College,2013,All students total,2481,949,1532,-2
167996,Stonehill College,2013,"All students, Undergraduate total",2481,949,1532,-2
167996,Stonehill College,2013,"All students, Undergraduate, Degree/certificate-seeking total",2473,946,1527,-2
167996,Stonehill College,2013,"All students, Undergraduate, Degree/certificate-seeking, First-time",610,248,362,-2
167996,Stonehill College,2013,"All students, Undergraduate, Other degree/certificate-seeking",1863,698,1165,-2
167996,Stonehill College,2013,"All students, Undergraduate, Other degree/certifcate-seeking, Transfer-ins",31,14,17,-2
167996,Stonehill College,2013,"All students, Undergraduate, Other degree/certifcate-seeking, Continuing",1832,684,1148,-2
167996,Stonehill College,2013,"All students, Undergraduate, Non-degree/certificate-seeking",8,3,5,-2
168005,Suffolk University,2013,All students total,8675,3854,4821,-2
168005,Suffolk University,2013,"All students, Undergraduate total",5658,2550,3108,-2
168005,Suffolk University,2013,"All students, Undergraduate, Degree/certificate-seeking total",5535,2494,3041,-2
168005,Suffolk University,2013,"All students, Undergraduate, Degree/certificate-seeking, First-time",1165,476,689,-2
168005,Suffolk University,2013,"All students, Undergraduate, Other degree/certificate-seeking",4370,2018,2352,-2
168005,Suffolk University,2013,"All students, Undergraduate, Other degree/certifcate-seeking, Transfer-ins",382,195,187,-2
168005,Suffolk University,2013,"All students, Undergraduate, Other degree/certifcate-seeking, Continuing",3988,1823,2165,-2
168005,Suffolk University,2013,"All students, Undergraduate, Non-degree/certificate-seeking",123,56,67,-2
168005,Suffolk University,2013,"All students, Graduate",3017,1304,1713,-2
168148,Tufts University,2013,All students total,10872,4945,5927,-2
168148,Tufts University,2013,"All students, Undergraduate total",5180,2556,2624,-2
168148,Tufts University,2013,"All students, Undergraduate, Degree/certificate-seeking total",5146,2545,2601,-2
168148,Tufts University,2013,"All students, Undergraduate, Degree/certificate-seeking, First-time",1307,650,657,-2
168148,Tufts University,2013,"All students, Undergraduate, Other degree/certificate-seeking",3839,1895,1944,-2
168148,Tufts University,2013,"All students, Undergraduate, Other degree/certifcate-seeking, Transfer-ins",56,25,31,-2
168148,Tufts University,2013,"All students, Undergraduate, Other degree/certifcate-seeking, Continuing",3783,1870,1913,-2
168148,Tufts University,2013,"All students, Undergraduate, Non-degree/certificate-seeking",34,11,23,-2
168148,Tufts University,2013,"All students, Graduate",5692,2389,3303,-2
168218,Wellesley College,2013,All students total,2474,50,2424,-2
168218,Wellesley College,2013,"All students, Undergraduate total",2474,50,2424,-2
168218,Wellesley College,2013,"All students, Undergraduate, Degree/certificate-seeking total",2347,0,2347,-2
168218,Wellesley College,2013,"All students, Undergraduate, Degree/certificate-seeking, First-time",590,0,590,-2
168218,Wellesley College,2013,"All students, Undergraduate, Other degree/certificate-seeking",1757,0,1757,-2
168218,Wellesley College,2013,"All students, Undergraduate, Other degree/certifcate-seeking, Transfer-ins",20,0,20,-2
168218,Wellesley College,2013,"All students, Undergraduate, Other degree/certifcate-seeking, Continuing",1737,0,1737,-2
168218,Wellesley College,2013,"All students, Undergraduate, Non-degree/certificate-seeking",127,50,77,-2
168227,Wentworth Institute of Technology,2013,All students total,4179,3395,784,-2
168227,Wentworth Institute of Technology,2013,"All students, Undergraduate total",4012,3280,732,-2
168227,Wentworth Institute of Technology,2013,"All students, Undergraduate, Degree/certificate-seeking total",3975,3249,726,-2
168227,Wentworth Institute of Technology,2013,"All students, Undergraduate, Degree/certificate-seeking, First-time",900,728,172,-2
168227,Wentworth Institute of Technology,2013,"All students, Undergraduate, Other degree/certificate-seeking",3075,2521,554,-2
168227,Wentworth Institute of Technology,2013,"All students, Undergraduate, Other degree/certifcate-seeking, Transfer-ins",239,188,51,-2
168227,Wentworth Institute of Technology,2013,"All students, Undergraduate, Other degree/certifcate-seeking, Continuing",2836,2333,503,-2
168227,Wentworth Institute of Technology,2013,"All students, Undergraduate, Non-degree/certificate-seeking",37,31,6,-2
168227,Wentworth Institute of Technology,2013,"All students, Graduate",167,115,52,-2
168254,Western New England University,2013,All students total,3800,2113,1687,-2
168254,Western New England University,2013,"All students, Undergraduate total",2667,1610,1057,-2
168254,Western New England University,2013,"All students, Undergraduate, Degree/certificate-seeking total",2648,1605,1043,-2
168254,Western New England University,2013,"All students, Undergraduate, Degree/certificate-seeking, First-time",691,423,268,-2
168254,Western New England University,2013,"All students, Undergraduate, Other degree/certificate-seeking",1957,1182,775,-2
168254,Western New England University,2013,"All students, Undergraduate, Other degree/certifcate-seeking, Transfer-ins",88,55,33,-2
168254,Western New England University,2013,"All students, Undergraduate, Other degree/certifcate-seeking, Continuing",1869,1127,742,-2
168254,Western New England University,2013,"All students, Undergraduate, Non-degree/certificate-seeking",19,5,14,-2
168254,Western New England University,2013,"All students, Graduate",1133,503,630,-2
168263,Westfield State University,2013,All students total,6371,2979,3392,-2
168263,Westfield State University,2013,"All students, Undergraduate total",5692,2760,2932,-2
168263,Westfield State University,2013,"All students, Undergraduate, Degree/certificate-seeking total",5524,2661,2863,-2
168263,Westfield State University,2013,"All students, Undergraduate, Degree/certificate-seeking, First-time",1287,607,680,-2
168263,Westfield State University,2013,"All students, Undergraduate, Other degree/certificate-seeking",4237,2054,2183,-2
168263,Westfield State University,2013,"All students, Undergraduate, Other degree/certifcate-seeking, Transfer-ins",450,239,211,-2
168263,Westfield State University,2013,"All students, Undergraduate, Other degree/certifcate-seeking, Continuing",3787,1815,1972,-2
168263,Westfield State University,2013,"All students, Undergraduate, Non-degree/certificate-seeking",168,99,69,-2
168263,Westfield State University,2013,"All students, Graduate",679,219,460,-2
168281,Wheaton College,2013,All students total,1654,574,1080,-2
168281,Wheaton College,2013,"All students, Undergraduate total",1654,574,1080,-2
168281,Wheaton College,2013,"All students, Undergraduate, Degree/certificate-seeking total",1640,568,1072,-2
168281,Wheaton College,2013,"All students, Undergraduate, Degree/certificate-seeking, First-time",458,158,300,-2
168281,Wheaton College,2013,"All students, Undergraduate, Other degree/certificate-seeking",1182,410,772,-2
168281,Wheaton College,2013,"All students, Undergraduate, Other degree/certifcate-seeking, Transfer-ins",14,4,10,-2
168281,Wheaton College,2013,"All students, Undergraduate, Other degree/certifcate-seeking, Continuing",1168,406,762,-2
168281,Wheaton College,2013,"All students, Undergraduate, Non-degree/certificate-seeking",14,6,8,-2
168290,Wheelock College,2013,All students total,1378,155,1223,-2
168290,Wheelock College,2013,"All students, Undergraduate total",880,105,775,-2
168290,Wheelock College,2013,"All students, Undergraduate, Degree/certificate-seeking total",839,97,742,-2
168290,Wheelock College,2013,"All students, Undergraduate, Degree/certificate-seeking, First-time",215,31,184,-2
168290,Wheelock College,2013,"All students, Undergraduate, Other degree/certificate-seeking",624,66,558,-2
168290,Wheelock College,2013,"All students, Undergraduate, Other degree/certifcate-seeking, Transfer-ins",42,13,29,-2
168290,Wheelock College,2013,"All students, Undergraduate, Other degree/certifcate-seeking, Continuing",582,53,529,-2
168290,Wheelock College,2013,"All students, Undergraduate, Non-degree/certificate-seeking",41,8,33,-2
168290,Wheelock College,2013,"All students, Graduate",498,50,448,-2
168342,Williams College,2013,All students total,2150,1042,1108,-2
168342,Williams College,2013,"All students, Undergraduate total",2096,1014,1082,-2
168342,Williams College,2013,"All students, Undergraduate, Degree/certificate-seeking total",2051,997,1054,-2
168342,Williams College,2013,"All students, Undergraduate, Degree/certificate-seeking, First-time",544,273,271,-2
168342,Williams College,2013,"All students, Undergraduate, Other degree/certificate-seeking",1507,724,783,-2
168342,Williams College,2013,"All students, Undergraduate, Other degree/certifcate-seeking, Transfer-ins",3,1,2,-2
168342,Williams College,2013,"All students, Undergraduate, Other degree/certifcate-seeking, Continuing",1504,723,781,-2
168342,Williams College,2013,"All students, Undergraduate, Non-degree/certificate-seeking",45,17,28,-2
168342,Williams College,2013,"All students, Graduate",54,28,26,-2
168421,Worcester Polytechnic Institute,2013,All students total,6296,4359,1937,-2
168421,Worcester Polytechnic Institute,2013,"All students, Undergraduate total",4134,2784,1350,-2
168421,Worcester Polytechnic Institute,2013,"All students, Undergraduate, Degree/certificate-seeking total",4012,2706,1306,-2
168421,Worcester Polytechnic Institute,2013,"All students, Undergraduate, Degree/certificate-seeking, First-time",1103,737,366,-2
168421,Worcester Polytechnic Institute,2013,"All students, Undergraduate, Other degree/certificate-seeking",2909,1969,940,-2
168421,Worcester Polytechnic Institute,2013,"All students, Undergraduate, Other degree/certifcate-seeking, Transfer-ins",44,26,18,-2
168421,Worcester Polytechnic Institute,2013,"All students, Undergraduate, Other degree/certifcate-seeking, Continuing",2865,1943,922,-2
168421,Worcester Polytechnic Institute,2013,"All students, Undergraduate, Non-degree/certificate-seeking",122,78,44,-2
168421,Worcester Polytechnic Institute,2013,"All students, Graduate",2162,1575,587,-2
168430,Worcester State University,2013,All students total,6447,2452,3995,-2
168430,Worcester State University,2013,"All students, Undergraduate total",5556,2234,3322,-2
168430,Worcester State University,2013,"All students, Undergraduate, Degree/certificate-seeking total",5033,2032,3001,-2
168430,Worcester State University,2013,"All students, Undergraduate, Degree/certificate-seeking, First-time",780,318,462,-2
168430,Worcester State University,2013,"All students, Undergraduate, Other degree/certificate-seeking",4253,1714,2539,-2
168430,Worcester State University,2013,"All students, Undergraduate, Other degree/certifcate-seeking, Transfer-ins",606,270,336,-2
168430,Worcester State University,2013,"All students, Undergraduate, Other degree/certifcate-seeking, Continuing",3647,1444,2203,-2
168430,Worcester State University,2013,"All students, Undergraduate, Non-degree/certificate-seeking",523,202,321,-2
168430,Worcester State University,2013,"All students, Graduate",891,218,673,-2
168528,Adrian College,2013,All students total,1658,853,805,-2
168528,Adrian College,2013,"All students, Undergraduate total",1649,847,802,-2
168528,Adrian College,2013,"All students, Undergraduate, Degree/certificate-seeking total",1616,835,781,-2
168528,Adrian College,2013,"All students, Undergraduate, Degree/certificate-seeking, First-time",467,253,214,-2
168528,Adrian College,2013,"All students, Undergraduate, Other degree/certificate-seeking",1149,582,567,-2
168528,Adrian College,2013,"All students, Undergraduate, Other degree/certifcate-seeking, Transfer-ins",188,116,72,-2
168528,Adrian College,2013,"All students, Undergraduate, Other degree/certifcate-seeking, Continuing",961,466,495,-2
168528,Adrian College,2013,"All students, Undergraduate, Non-degree/certificate-seeking",33,12,21,-2
168528,Adrian College,2013,"All students, Graduate",9,6,3,-2
168546,Albion College,2013,All students total,1307,664,643,-2
168546,Albion College,2013,"All students, Undergraduate total",1307,664,643,-2
168546,Albion College,2013,"All students, Undergraduate, Degree/certificate-seeking total",1284,652,632,-2
168546,Albion College,2013,"All students, Undergraduate, Degree/certificate-seeking, First-time",346,164,182,-2
168546,Albion College,2013,"All students, Undergraduate, Other degree/certificate-seeking",938,488,450,-2
168546,Albion College,2013,"All students, Undergraduate, Other degree/certifcate-seeking, Transfer-ins",27,14,13,-2
168546,Albion College,2013,"All students, Undergraduate, Other degree/certifcate-seeking, Continuing",911,474,437,-2
168546,Albion College,2013,"All students, Undergraduate, Non-degree/certificate-seeking",23,12,11,-2
168591,Alma College,2013,All students total,1419,640,779,-2
168591,Alma College,2013,"All students, Undergraduate total",1419,640,779,-2
168591,Alma College,2013,"All students, Undergraduate, Degree/certificate-seeking total",1385,631,754,-2
168591,Alma College,2013,"All students, Undergraduate, Degree/certificate-seeking, First-time",378,174,204,-2
168591,Alma College,2013,"All students, Undergraduate, Other degree/certificate-seeking",1007,457,550,-2
168591,Alma College,2013,"All students, Undergraduate, Other degree/certifcate-seeking, Transfer-ins",37,25,12,-2
168591,Alma College,2013,"All students, Undergraduate, Other degree/certifcate-seeking, Continuing",970,432,538,-2
168591,Alma College,2013,"All students, Undergraduate, Non-degree/certificate-seeking",34,9,25,-2
168740,Andrews University,2013,All students total,3516,1846,1670,-2
168740,Andrews University,2013,"All students, Undergraduate total",1905,831,1074,-2
168740,Andrews University,2013,"All students, Undergraduate, Degree/certificate-seeking total",1765,762,1003,-2
168740,Andrews University,2013,"All students, Undergraduate, Degree/certificate-seeking, First-time",321,129,192,-2
168740,Andrews University,2013,"All students, Undergraduate, Other degree/certificate-seeking",1444,633,811,-2
168740,Andrews University,2013,"All students, Undergraduate, Other degree/certifcate-seeking, Transfer-ins",159,69,90,-2
168740,Andrews University,2013,"All students, Undergraduate, Other degree/certifcate-seeking, Continuing",1285,564,721,-2
168740,Andrews University,2013,"All students, Undergraduate, Non-degree/certificate-seeking",140,69,71,-2
168740,Andrews University,2013,"All students, Graduate",1611,1015,596,-2
168786,Aquinas College,2013,All students total,2001,751,1250,-2
168786,Aquinas College,2013,"All students, Undergraduate total",1863,713,1150,-2
168786,Aquinas College,2013,"All students, Undergraduate, Degree/certificate-seeking total",1843,702,1141,-2
168786,Aquinas College,2013,"All students, Undergraduate, Degree/certificate-seeking, First-time",391,139,252,-2
168786,Aquinas College,2013,"All students, Undergraduate, Other degree/certificate-seeking",1452,563,889,-2
168786,Aquinas College,2013,"All students, Undergraduate, Other degree/certifcate-seeking, Transfer-ins",93,38,55,-2
168786,Aquinas College,2013,"All students, Undergraduate, Other degree/certifcate-seeking, Continuing",1359,525,834,-2
168786,Aquinas College,2013,"All students, Undergraduate, Non-degree/certificate-seeking",20,11,9,-2
168786,Aquinas College,2013,"All students, Graduate",138,38,100,-2
168838,Baker College of Owosso,2013,All students total,2828,1185,1643,-2
168838,Baker College of Owosso,2013,"All students, Undergraduate total",2815,1181,1634,-2
168838,Baker College of Owosso,2013,"All students, Undergraduate, Degree/certificate-seeking total",2726,1116,1610,-2
168838,Baker College of Owosso,2013,"All students, Undergraduate, Degree/certificate-seeking, First-time",622,324,298,-2
168838,Baker College of Owosso,2013,"All students, Undergraduate, Other degree/certificate-seeking",2104,792,1312,-2
168838,Baker College of Owosso,2013,"All students, Undergraduate, Other degree/certifcate-seeking, Transfer-ins",152,54,98,-2
168838,Baker College of Owosso,2013,"All students, Undergraduate, Other degree/certifcate-seeking, Continuing",1952,738,1214,-2
168838,Baker College of Owosso,2013,"All students, Undergraduate, Non-degree/certificate-seeking",89,65,24,-2
168838,Baker College of Owosso,2013,"All students, Graduate",13,4,9,-2
168847,Baker College of Flint,2013,All students total,4977,1748,3229,-2
168847,Baker College of Flint,2013,"All students, Undergraduate total",4948,1730,3218,-2
168847,Baker College of Flint,2013,"All students, Undergraduate, Degree/certificate-seeking total",4886,1702,3184,-2
168847,Baker College of Flint,2013,"All students, Undergraduate, Degree/certificate-seeking, First-time",847,366,481,-2
168847,Baker College of Flint,2013,"All students, Undergraduate, Other degree/certificate-seeking",4039,1336,2703,-2
168847,Baker College of Flint,2013,"All students, Undergraduate, Other degree/certifcate-seeking, Transfer-ins",457,135,322,-2
168847,Baker College of Flint,2013,"All students, Undergraduate, Other degree/certifcate-seeking, Continuing",3582,1201,2381,-2
168847,Baker College of Flint,2013,"All students, Undergraduate, Non-degree/certificate-seeking",62,28,34,-2
168847,Baker College of Flint,2013,"All students, Graduate",29,18,11,-2
169080,Calvin College,2013,All students total,4034,1809,2225,-2
169080,Calvin College,2013,"All students, Undergraduate total",3959,1787,2172,-2
169080,Calvin College,2013,"All students, Undergraduate, Degree/certificate-seeking total",3895,1761,2134,-2
169080,Calvin College,2013,"All students, Undergraduate, Degree/certificate-seeking, First-time",1006,460,546,-2
169080,Calvin College,2013,"All students, Undergraduate, Other degree/certificate-seeking",2889,1301,1588,-2
169080,Calvin College,2013,"All students, Undergraduate, Other degree/certifcate-seeking, Transfer-ins",101,40,61,-2
169080,Calvin College,2013,"All students, Undergraduate, Other degree/certifcate-seeking, Continuing",2788,1261,1527,-2
169080,Calvin College,2013,"All students, Undergraduate, Non-degree/certificate-seeking",64,26,38,-2
169080,Calvin College,2013,"All students, Graduate",75,22,53,-2
169099,Calvin Theological Seminary,2013,All students total,306,245,61,-2
169099,Calvin Theological Seminary,2013,"All students, Graduate",306,245,61,-2
169220,Michigan School of Professional Psychology,2013,All students total,161,39,122,-2
169220,Michigan School of Professional Psychology,2013,"All students, Graduate",161,39,122,-2
169248,Central Michigan University,2013,All students total,26841,11501,15340,-2
169248,Central Michigan University,2013,"All students, Undergraduate total",20534,8999,11535,-2
169248,Central Michigan University,2013,"All students, Undergraduate, Degree/certificate-seeking total",20070,8821,11249,-2
169248,Central Michigan University,2013,"All students, Undergraduate, Degree/certificate-seeking, First-time",3012,1332,1680,-2
169248,Central Michigan University,2013,"All students, Undergraduate, Other degree/certificate-seeking",17058,7489,9569,-2
169248,Central Michigan University,2013,"All students, Undergraduate, Other degree/certifcate-seeking, Transfer-ins",1448,671,777,-2
169248,Central Michigan University,2013,"All students, Undergraduate, Other degree/certifcate-seeking, Continuing",15610,6818,8792,-2
169248,Central Michigan University,2013,"All students, Undergraduate, Non-degree/certificate-seeking",464,178,286,-2
169248,Central Michigan University,2013,"All students, Graduate",6307,2502,3805,-2
169327,Cleary University,2013,All students total,546,217,329,-2
169327,Cleary University,2013,"All students, Undergraduate total",457,191,266,-2
169327,Cleary University,2013,"All students, Undergraduate, Degree/certificate-seeking total",450,189,261,-2
169327,Cleary University,2013,"All students, Undergraduate, Degree/certificate-seeking, First-time",48,26,22,-2
169327,Cleary University,2013,"All students, Undergraduate, Other degree/certificate-seeking",402,163,239,-2
169327,Cleary University,2013,"All students, Undergraduate, Other degree/certifcate-seeking, Transfer-ins",68,30,38,-2
169327,Cleary University,2013,"All students, Undergraduate, Other degree/certifcate-seeking, Continuing",334,133,201,-2
169327,Cleary University,2013,"All students, Undergraduate, Non-degree/certificate-seeking",7,2,5,-2
169327,Cleary University,2013,"All students, Graduate",89,26,63,-2
169363,Concordia University-Ann Arbor,2013,All students total,740,362,378,-2
169363,Concordia University-Ann Arbor,2013,"All students, Undergraduate total",584,313,271,-2
169363,Concordia University-Ann Arbor,2013,"All students, Undergraduate, Degree/certificate-seeking total",529,286,243,-2
169363,Concordia University-Ann Arbor,2013,"All students, Undergraduate, Degree/certificate-seeking, First-time",188,107,81,-2
169363,Concordia University-Ann Arbor,2013,"All students, Undergraduate, Other degree/certificate-seeking",341,179,162,-2
169363,Concordia University-Ann Arbor,2013,"All students, Undergraduate, Other degree/certifcate-seeking, Transfer-ins",44,27,17,-2
169363,Concordia University-Ann Arbor,2013,"All students, Undergraduate, Other degree/certifcate-seeking, Continuing",297,152,145,-2
169363,Concordia University-Ann Arbor,2013,"All students, Undergraduate, Non-degree/certificate-seeking",55,27,28,-2
169363,Concordia University-Ann Arbor,2013,"All students, Graduate",156,49,107,-2
169424,Cranbrook Academy of Art,2013,All students total,149,61,88,-2
169424,Cranbrook Academy of Art,2013,"All students, Graduate",149,61,88,-2
169442,College for Creative Studies,2013,All students total,1423,739,684,-2
169442,College for Creative Studies,2013,"All students, Undergraduate total",1363,701,662,-2
169442,College for Creative Studies,2013,"All students, Undergraduate, Degree/certificate-seeking total",1352,694,658,-2
169442,College for Creative Studies,2013,"All students, Undergraduate, Degree/certificate-seeking, First-time",241,118,123,-2
169442,College for Creative Studies,2013,"All students, Undergraduate, Other degree/certificate-seeking",1111,576,535,-2
169442,College for Creative Studies,2013,"All students, Undergraduate, Other degree/certifcate-seeking, Transfer-ins",147,82,65,-2
169442,College for Creative Studies,2013,"All students, Undergraduate, Other degree/certifcate-seeking, Continuing",964,494,470,-2
169442,College for Creative Studies,2013,"All students, Undergraduate, Non-degree/certificate-seeking",11,7,4,-2
169442,College for Creative Studies,2013,"All students, Graduate",60,38,22,-2
169479,Davenport University,2013,All students total,9591,3704,5887,-2
169479,Davenport University,2013,"All students, Undergraduate total",7356,2763,4593,-2
169479,Davenport University,2013,"All students, Undergraduate, Degree/certificate-seeking total",7119,2675,4444,-2
169479,Davenport University,2013,"All students, Undergraduate, Degree/certificate-seeking, First-time",589,298,291,-2
169479,Davenport University,2013,"All students, Undergraduate, Other degree/certificate-seeking",6530,2377,4153,-2
169479,Davenport University,2013,"All students, Undergraduate, Other degree/certifcate-seeking, Transfer-ins",842,317,525,-2
169479,Davenport University,2013,"All students, Undergraduate, Other degree/certifcate-seeking, Continuing",5688,2060,3628,-2
169479,Davenport University,2013,"All students, Undergraduate, Non-degree/certificate-seeking",237,88,149,-2
169479,Davenport University,2013,"All students, Graduate",2235,941,1294,-2
169628,Michigan State University-College of Law,2013,All students total,998,565,433,-2
169628,Michigan State University-College of Law,2013,"All students, Graduate",998,565,433,-2
169716,University of Detroit Mercy,2013,All students total,5112,2093,3019,-2
169716,University of Detroit Mercy,2013,"All students, Undergraduate total",2888,1016,1872,-2
169716,University of Detroit Mercy,2013,"All students, Undergraduate, Degree/certificate-seeking total",2871,1008,1863,-2
169716,University of Detroit Mercy,2013,"All students, Undergraduate, Degree/certificate-seeking, First-time",493,197,296,-2
169716,University of Detroit Mercy,2013,"All students, Undergraduate, Other degree/certificate-seeking",2378,811,1567,-2
169716,University of Detroit Mercy,2013,"All students, Undergraduate, Other degree/certifcate-seeking, Transfer-ins",201,65,136,-2
169716,University of Detroit Mercy,2013,"All students, Undergraduate, Other degree/certifcate-seeking, Continuing",2177,746,1431,-2
169716,University of Detroit Mercy,2013,"All students, Undergraduate, Non-degree/certificate-seeking",17,8,9,-2
169716,University of Detroit Mercy,2013,"All students, Graduate",2224,1077,1147,-2
169798,Eastern Michigan University,2013,All students total,23447,9557,13890,-2
169798,Eastern Michigan University,2013,"All students, Undergraduate total",19189,8047,11142,-2
169798,Eastern Michigan University,2013,"All students, Undergraduate, Degree/certificate-seeking total",18543,7808,10735,-2
169798,Eastern Michigan University,2013,"All students, Undergraduate, Degree/certificate-seeking, First-time",2885,1173,1712,-2
169798,Eastern Michigan University,2013,"All students, Undergraduate, Other degree/certificate-seeking",15658,6635,9023,-2
169798,Eastern Michigan University,2013,"All students, Undergraduate, Other degree/certifcate-seeking, Transfer-ins",1965,888,1077,-2
169798,Eastern Michigan University,2013,"All students, Undergraduate, Other degree/certifcate-seeking, Continuing",13693,5747,7946,-2
169798,Eastern Michigan University,2013,"All students, Undergraduate, Non-degree/certificate-seeking",646,239,407,-2
169798,Eastern Michigan University,2013,"All students, Graduate",4258,1510,2748,-2
169910,Ferris State University,2013,All students total,14707,7017,7690,-2
169910,Ferris State University,2013,"All students, Undergraduate total",13477,6486,6991,-2
169910,Ferris State University,2013,"All students, Undergraduate, Degree/certificate-seeking total",12646,6227,6419,-2
169910,Ferris State University,2013,"All students, Undergraduate, Degree/certificate-seeking, First-time",2035,987,1048,-2
169910,Ferris State University,2013,"All students, Undergraduate, Other degree/certificate-seeking",10611,5240,5371,-2
169910,Ferris State University,2013,"All students, Undergraduate, Other degree/certifcate-seeking, Transfer-ins",1556,793,763,-2
169910,Ferris State University,2013,"All students, Undergraduate, Other degree/certifcate-seeking, Continuing",9055,4447,4608,-2
169910,Ferris State University,2013,"All students, Undergraduate, Non-degree/certificate-seeking",831,259,572,-2
169910,Ferris State University,2013,"All students, Graduate",1230,531,699,-2
169983,Kettering University,2013,All students total,1985,1602,383,-2
169983,Kettering University,2013,"All students, Undergraduate total",1684,1377,307,-2
169983,Kettering University,2013,"All students, Undergraduate, Degree/certificate-seeking total",1640,1339,301,-2
169983,Kettering University,2013,"All students, Undergraduate, Degree/certificate-seeking, First-time",376,308,68,-2
169983,Kettering University,2013,"All students, Undergraduate, Other degree/certificate-seeking",1264,1031,233,-2
169983,Kettering University,2013,"All students, Undergraduate, Other degree/certifcate-seeking, Transfer-ins",34,29,5,-2
169983,Kettering University,2013,"All students, Undergraduate, Other degree/certifcate-seeking, Continuing",1230,1002,228,-2
169983,Kettering University,2013,"All students, Undergraduate, Non-degree/certificate-seeking",44,38,6,-2
169983,Kettering University,2013,"All students, Graduate",301,225,76,-2
170000,Grace Bible College,2013,All students total,579,275,304,-2
170000,Grace Bible College,2013,"All students, Undergraduate total",579,275,304,-2
170000,Grace Bible College,2013,"All students, Undergraduate, Degree/certificate-seeking total",576,273,303,-2
170000,Grace Bible College,2013,"All students, Undergraduate, Degree/certificate-seeking, First-time",141,62,79,-2
170000,Grace Bible College,2013,"All students, Undergraduate, Other degree/certificate-seeking",435,211,224,-2
170000,Grace Bible College,2013,"All students, Undergraduate, Other degree/certifcate-seeking, Transfer-ins",103,52,51,-2
170000,Grace Bible College,2013,"All students, Undergraduate, Other degree/certifcate-seeking, Continuing",332,159,173,-2
170000,Grace Bible College,2013,"All students, Undergraduate, Non-degree/certificate-seeking",3,2,1,-2
170037,Cornerstone University,2013,All students total,2809,1197,1612,-2
170037,Cornerstone University,2013,"All students, Undergraduate total",2200,902,1298,-2
170037,Cornerstone University,2013,"All students, Undergraduate, Degree/certificate-seeking total",2100,850,1250,-2
170037,Cornerstone University,2013,"All students, Undergraduate, Degree/certificate-seeking, First-time",373,159,214,-2
170037,Cornerstone University,2013,"All students, Undergraduate, Other degree/certificate-seeking",1727,691,1036,-2
170037,Cornerstone University,2013,"All students, Undergraduate, Other degree/certifcate-seeking, Transfer-ins",51,23,28,-2
170037,Cornerstone University,2013,"All students, Undergraduate, Other degree/certifcate-seeking, Continuing",1676,668,1008,-2
170037,Cornerstone University,2013,"All students, Undergraduate, Non-degree/certificate-seeking",100,52,48,-2
170037,Cornerstone University,2013,"All students, Graduate",609,295,314,-2
170082,Grand Valley State University,2013,All students total,24477,9981,14496,-2
170082,Grand Valley State University,2013,"All students, Undergraduate total",21235,8931,12304,-2
170082,Grand Valley State University,2013,"All students, Undergraduate, Degree/certificate-seeking total",21137,8883,12254,-2
170082,Grand Valley State University,2013,"All students, Undergraduate, Degree/certificate-seeking, First-time",4078,1615,2463,-2
170082,Grand Valley State University,2013,"All students, Undergraduate, Other degree/certificate-seeking",17059,7268,9791,-2
170082,Grand Valley State University,2013,"All students, Undergraduate, Other degree/certifcate-seeking, Transfer-ins",1707,767,940,-2
170082,Grand Valley State University,2013,"All students, Undergraduate, Other degree/certifcate-seeking, Continuing",15352,6501,8851,-2
170082,Grand Valley State University,2013,"All students, Undergraduate, Non-degree/certificate-seeking",98,48,50,-2
170082,Grand Valley State University,2013,"All students, Graduate",3242,1050,2192,-2
170091,Great Lakes Christian College,2013,All students total,194,120,74,-2
170091,Great Lakes Christian College,2013,"All students, Undergraduate total",194,120,74,-2
170091,Great Lakes Christian College,2013,"All students, Undergraduate, Degree/certificate-seeking total",194,120,74,-2
170091,Great Lakes Christian College,2013,"All students, Undergraduate, Degree/certificate-seeking, First-time",51,30,21,-2
170091,Great Lakes Christian College,2013,"All students, Undergraduate, Other degree/certificate-seeking",143,90,53,-2
170091,Great Lakes Christian College,2013,"All students, Undergraduate, Other degree/certifcate-seeking, Transfer-ins",25,16,9,-2
170091,Great Lakes Christian College,2013,"All students, Undergraduate, Other degree/certifcate-seeking, Continuing",118,74,44,-2
170301,Hope College,2013,All students total,3388,1344,2044,-2
170301,Hope College,2013,"All students, Undergraduate total",3388,1344,2044,-2
170301,Hope College,2013,"All students, Undergraduate, Degree/certificate-seeking total",3296,1308,1988,-2
170301,Hope College,2013,"All students, Undergraduate, Degree/certificate-seeking, First-time",822,311,511,-2
170301,Hope College,2013,"All students, Undergraduate, Other degree/certificate-seeking",2474,997,1477,-2
170301,Hope College,2013,"All students, Undergraduate, Other degree/certifcate-seeking, Transfer-ins",50,21,29,-2
170301,Hope College,2013,"All students, Undergraduate, Other degree/certifcate-seeking, Continuing",2424,976,1448,-2
170301,Hope College,2013,"All students, Undergraduate, Non-degree/certificate-seeking",92,36,56,-2
170417,ITT Technical Institute-Wyoming,2013,All students total,343,272,71,-2
170417,ITT Technical Institute-Wyoming,2013,"All students, Undergraduate total",343,272,71,-2
170417,ITT Technical Institute-Wyoming,2013,"All students, Undergraduate, Degree/certificate-seeking total",343,272,71,-2
170417,ITT Technical Institute-Wyoming,2013,"All students, Undergraduate, Degree/certificate-seeking, First-time",56,42,14,-2
170417,ITT Technical Institute-Wyoming,2013,"All students, Undergraduate, Other degree/certificate-seeking",287,230,57,-2
170417,ITT Technical Institute-Wyoming,2013,"All students, Undergraduate, Other degree/certifcate-seeking, Transfer-ins",9,7,2,-2
170417,ITT Technical Institute-Wyoming,2013,"All students, Undergraduate, Other degree/certifcate-seeking, Continuing",278,223,55,-2
170532,Kalamazoo College,2013,All students total,1458,635,823,-2
170532,Kalamazoo College,2013,"All students, Undergraduate total",1458,635,823,-2
170532,Kalamazoo College,2013,"All students, Undergraduate, Degree/certificate-seeking total",1427,625,802,-2
170532,Kalamazoo College,2013,"All students, Undergraduate, Degree/certificate-seeking, First-time",453,215,238,-2
170532,Kalamazoo College,2013,"All students, Undergraduate, Other degree/certificate-seeking",974,410,564,-2
170532,Kalamazoo College,2013,"All students, Undergraduate, Other degree/certifcate-seeking, Transfer-ins",22,12,10,-2
170532,Kalamazoo College,2013,"All students, Undergraduate, Other degree/certifcate-seeking, Continuing",952,398,554,-2
170532,Kalamazoo College,2013,"All students, Undergraduate, Non-degree/certificate-seeking",31,10,21,-2
170639,Lake Superior State University,2013,All students total,2435,1209,1226,-2
170639,Lake Superior State University,2013,"All students, Undergraduate total",2429,1208,1221,-2
170639,Lake Superior State University,2013,"All students, Undergraduate, Degree/certificate-seeking total",2299,1154,1145,-2
170639,Lake Superior State University,2013,"All students, Undergraduate, Degree/certificate-seeking, First-time",409,202,207,-2
170639,Lake Superior State University,2013,"All students, Undergraduate, Other degree/certificate-seeking",1890,952,938,-2
170639,Lake Superior State University,2013,"All students, Undergraduate, Other degree/certifcate-seeking, Transfer-ins",220,119,101,-2
170639,Lake Superior State University,2013,"All students, Undergraduate, Other degree/certifcate-seeking, Continuing",1670,833,837,-2
170639,Lake Superior State University,2013,"All students, Undergraduate, Non-degree/certificate-seeking",130,54,76,-2
170639,Lake Superior State University,2013,"All students, Graduate",6,1,5,-2
170675,Lawrence Technological University,2013,All students total,4002,2951,1051,-2
170675,Lawrence Technological University,2013,"All students, Undergraduate total",3033,2290,743,-2
170675,Lawrence Technological University,2013,"All students, Undergraduate, Degree/certificate-seeking total",3033,2290,743,-2
170675,Lawrence Technological University,2013,"All students, Undergraduate, Degree/certificate-seeking, First-time",365,255,110,-2
170675,Lawrence Technological University,2013,"All students, Undergraduate, Other degree/certificate-seeking",2668,2035,633,-2
170675,Lawrence Technological University,2013,"All students, Undergraduate, Other degree/certifcate-seeking, Transfer-ins",1069,768,301,-2
170675,Lawrence Technological University,2013,"All students, Undergraduate, Other degree/certifcate-seeking, Continuing",1599,1267,332,-2
170675,Lawrence Technological University,2013,"All students, Graduate",969,661,308,-2
170806,Madonna University,2013,All students total,4399,1329,3070,-2
170806,Madonna University,2013,"All students, Undergraduate total",3352,1098,2254,-2
170806,Madonna University,2013,"All students, Undergraduate, Degree/certificate-seeking total",3080,974,2106,-2
170806,Madonna University,2013,"All students, Undergraduate, Degree/certificate-seeking, First-time",205,77,128,-2
170806,Madonna University,2013,"All students, Undergraduate, Other degree/certificate-seeking",2875,897,1978,-2
170806,Madonna University,2013,"All students, Undergraduate, Other degree/certifcate-seeking, Transfer-ins",654,247,407,-2
170806,Madonna University,2013,"All students, Undergraduate, Other degree/certifcate-seeking, Continuing",2221,650,1571,-2
170806,Madonna University,2013,"All students, Undergraduate, Non-degree/certificate-seeking",272,124,148,-2
170806,Madonna University,2013,"All students, Graduate",1047,231,816,-2
170842,Marygrove College,2013,All students total,1960,473,1487,-2
170842,Marygrove College,2013,"All students, Undergraduate total",1041,260,781,-2
170842,Marygrove College,2013,"All students, Undergraduate, Degree/certificate-seeking total",1041,260,781,-2
170842,Marygrove College,2013,"All students, Undergraduate, Degree/certificate-seeking, First-time",182,48,134,-2
170842,Marygrove College,2013,"All students, Undergraduate, Other degree/certificate-seeking",859,212,647,-2
170842,Marygrove College,2013,"All students, Undergraduate, Other degree/certifcate-seeking, Transfer-ins",182,32,150,-2
170842,Marygrove College,2013,"All students, Undergraduate, Other degree/certifcate-seeking, Continuing",677,180,497,-2
170842,Marygrove College,2013,"All students, Graduate",919,213,706,-2
170967,Rochester College,2013,All students total,1129,451,678,-2
170967,Rochester College,2013,"All students, Undergraduate total",1117,442,675,-2
170967,Rochester College,2013,"All students, Undergraduate, Degree/certificate-seeking total",960,395,565,-2
170967,Rochester College,2013,"All students, Undergraduate, Degree/certificate-seeking, First-time",162,80,82,-2
170967,Rochester College,2013,"All students, Undergraduate, Other degree/certificate-seeking",798,315,483,-2
170967,Rochester College,2013,"All students, Undergraduate, Other degree/certifcate-seeking, Transfer-ins",166,63,103,-2
170967,Rochester College,2013,"All students, Undergraduate, Other degree/certifcate-seeking, Continuing",632,252,380,-2
170967,Rochester College,2013,"All students, Undergraduate, Non-degree/certificate-seeking",157,47,110,-2
170967,Rochester College,2013,"All students, Graduate",12,9,3,-2
170976,University of Michigan-Ann Arbor,2013,All students total,43710,22830,20880,-2
170976,University of Michigan-Ann Arbor,2013,"All students, Undergraduate total",28283,14407,13876,-2
170976,University of Michigan-Ann Arbor,2013,"All students, Undergraduate, Degree/certificate-seeking total",28077,14301,13776,-2
170976,University of Michigan-Ann Arbor,2013,"All students, Undergraduate, Degree/certificate-seeking, First-time",6200,3016,3184,-2
170976,University of Michigan-Ann Arbor,2013,"All students, Undergraduate, Other degree/certificate-seeking",21877,11285,10592,-2
170976,University of Michigan-Ann Arbor,2013,"All students, Undergraduate, Other degree/certifcate-seeking, Transfer-ins",966,562,404,-2
170976,University of Michigan-Ann Arbor,2013,"All students, Undergraduate, Other degree/certifcate-seeking, Continuing",20911,10723,10188,-2
170976,University of Michigan-Ann Arbor,2013,"All students, Undergraduate, Non-degree/certificate-seeking",206,106,100,-2
170976,University of Michigan-Ann Arbor,2013,"All students, Graduate",15427,8423,7004,-2
171100,Michigan State University,2013,All students total,49317,23884,25433,-2
171100,Michigan State University,2013,"All students, Undergraduate total",37985,18922,19063,-2
171100,Michigan State University,2013,"All students, Undergraduate, Degree/certificate-seeking total",37622,18752,18870,-2
171100,Michigan State University,2013,"All students, Undergraduate, Degree/certificate-seeking, First-time",8061,3918,4143,-2
171100,Michigan State University,2013,"All students, Undergraduate, Other degree/certificate-seeking",29561,14834,14727,-2
171100,Michigan State University,2013,"All students, Undergraduate, Other degree/certifcate-seeking, Transfer-ins",1513,784,729,-2
171100,Michigan State University,2013,"All students, Undergraduate, Other degree/certifcate-seeking, Continuing",28048,14050,13998,-2
171100,Michigan State University,2013,"All students, Undergraduate, Non-degree/certificate-seeking",363,170,193,-2
171100,Michigan State University,2013,"All students, Graduate",11332,4962,6370,-2
171128,Michigan Technological University,2013,All students total,6975,5164,1811,-2
171128,Michigan Technological University,2013,"All students, Undergraduate total",5617,4198,1419,-2
171128,Michigan Technological University,2013,"All students, Undergraduate, Degree/certificate-seeking total",5536,4149,1387,-2
171128,Michigan Technological University,2013,"All students, Undergraduate, Degree/certificate-seeking, First-time",1253,944,309,-2
171128,Michigan Technological University,2013,"All students, Undergraduate, Other degree/certificate-seeking",4283,3205,1078,-2
171128,Michigan Technological University,2013,"All students, Undergraduate, Other degree/certifcate-seeking, Transfer-ins",195,132,63,-2
171128,Michigan Technological University,2013,"All students, Undergraduate, Other degree/certifcate-seeking, Continuing",4088,3073,1015,-2
171128,Michigan Technological University,2013,"All students, Undergraduate, Non-degree/certificate-seeking",81,49,32,-2
171128,Michigan Technological University,2013,"All students, Graduate",1358,966,392,-2
171137,University of Michigan-Dearborn,2013,All students total,8748,4554,4194,-2
171137,University of Michigan-Dearborn,2013,"All students, Undergraduate total",7144,3584,3560,-2
171137,University of Michigan-Dearborn,2013,"All students, Undergraduate, Degree/certificate-seeking total",6793,3405,3388,-2
171137,University of Michigan-Dearborn,2013,"All students, Undergraduate, Degree/certificate-seeking, First-time",954,524,430,-2
171137,University of Michigan-Dearborn,2013,"All students, Undergraduate, Other degree/certificate-seeking",5839,2881,2958,-2
171137,University of Michigan-Dearborn,2013,"All students, Undergraduate, Other degree/certifcate-seeking, Transfer-ins",727,352,375,-2
171137,University of Michigan-Dearborn,2013,"All students, Undergraduate, Other degree/certifcate-seeking, Continuing",5112,2529,2583,-2
171137,University of Michigan-Dearborn,2013,"All students, Undergraduate, Non-degree/certificate-seeking",351,179,172,-2
171137,University of Michigan-Dearborn,2013,"All students, Graduate",1604,970,634,-2
171146,University of Michigan-Flint,2013,All students total,8555,3405,5150,-2
171146,University of Michigan-Flint,2013,"All students, Undergraduate total",7143,2849,4294,-2
171146,University of Michigan-Flint,2013,"All students, Undergraduate, Degree/certificate-seeking total",6746,2692,4054,-2
171146,University of Michigan-Flint,2013,"All students, Undergraduate, Degree/certificate-seeking, First-time",724,341,383,-2
171146,University of Michigan-Flint,2013,"All students, Undergraduate, Other degree/certificate-seeking",6022,2351,3671,-2
171146,University of Michigan-Flint,2013,"All students, Undergraduate, Other degree/certifcate-seeking, Transfer-ins",810,279,531,-2
171146,University of Michigan-Flint,2013,"All students, Undergraduate, Other degree/certifcate-seeking, Continuing",5212,2072,3140,-2
171146,University of Michigan-Flint,2013,"All students, Undergraduate, Non-degree/certificate-seeking",397,157,240,-2
171146,University of Michigan-Flint,2013,"All students, Graduate",1412,556,856,-2
171298,Baker College of Muskegon,2013,All students total,4021,1202,2819,-2
171298,Baker College of Muskegon,2013,"All students, Undergraduate total",4005,1197,2808,-2
171298,Baker College of Muskegon,2013,"All students, Undergraduate, Degree/certificate-seeking total",3988,1191,2797,-2
171298,Baker College of Muskegon,2013,"All students, Undergraduate, Degree/certificate-seeking, First-time",757,259,498,-2
171298,Baker College of Muskegon,2013,"All students, Undergraduate, Other degree/certificate-seeking",3231,932,2299,-2
171298,Baker College of Muskegon,2013,"All students, Undergraduate, Other degree/certifcate-seeking, Transfer-ins",383,109,274,-2
171298,Baker College of Muskegon,2013,"All students, Undergraduate, Other degree/certifcate-seeking, Continuing",2848,823,2025,-2
171298,Baker College of Muskegon,2013,"All students, Undergraduate, Non-degree/certificate-seeking",17,6,11,-2
171298,Baker College of Muskegon,2013,"All students, Graduate",16,5,11,-2
171456,Northern Michigan University,2013,All students total,8918,4038,4880,-2
171456,Northern Michigan University,2013,"All students, Undergraduate total",8221,3780,4441,-2
171456,Northern Michigan University,2013,"All students, Undergraduate, Degree/certificate-seeking total",7959,3705,4254,-2
171456,Northern Michigan University,2013,"All students, Undergraduate, Degree/certificate-seeking, First-time",1665,757,908,-2
171456,Northern Michigan University,2013,"All students, Undergraduate, Other degree/certificate-seeking",6294,2948,3346,-2
171456,Northern Michigan University,2013,"All students, Undergraduate, Other degree/certifcate-seeking, Transfer-ins",502,268,234,-2
171456,Northern Michigan University,2013,"All students, Undergraduate, Other degree/certifcate-seeking, Continuing",5792,2680,3112,-2
171456,Northern Michigan University,2013,"All students, Undergraduate, Non-degree/certificate-seeking",262,75,187,-2
171456,Northern Michigan University,2013,"All students, Graduate",697,258,439,-2
171483,Northwestern Michigan College,2013,All students total,4724,2158,2566,-2
171483,Northwestern Michigan College,2013,"All students, Undergraduate total",4724,2158,2566,-2
171483,Northwestern Michigan College,2013,"All students, Undergraduate, Degree/certificate-seeking total",4241,1968,2273,-2
171483,Northwestern Michigan College,2013,"All students, Undergraduate, Degree/certificate-seeking, First-time",898,430,468,-2
171483,Northwestern Michigan College,2013,"All students, Undergraduate, Other degree/certificate-seeking",3343,1538,1805,-2
171483,Northwestern Michigan College,2013,"All students, Undergraduate, Other degree/certifcate-seeking, Transfer-ins",316,171,145,-2
171483,Northwestern Michigan College,2013,"All students, Undergraduate, Other degree/certifcate-seeking, Continuing",3027,1367,1660,-2
171483,Northwestern Michigan College,2013,"All students, Undergraduate, Non-degree/certificate-seeking",483,190,293,-2
171492,Northwood University-Michigan,2013,All students total,3194,1797,1397,-2
171492,Northwood University-Michigan,2013,"All students, Undergraduate total",2964,1675,1289,-2
171492,Northwood University-Michigan,2013,"All students, Undergraduate, Degree/certificate-seeking total",2920,1639,1281,-2
171492,Northwood University-Michigan,2013,"All students, Undergraduate, Degree/certificate-seeking, First-time",299,182,117,-2
171492,Northwood University-Michigan,2013,"All students, Undergraduate, Other degree/certificate-seeking",2621,1457,1164,-2
171492,Northwood University-Michigan,2013,"All students, Undergraduate, Other degree/certifcate-seeking, Transfer-ins",603,317,286,-2
171492,Northwood University-Michigan,2013,"All students, Undergraduate, Other degree/certifcate-seeking, Continuing",2018,1140,878,-2
171492,Northwood University-Michigan,2013,"All students, Undergraduate, Non-degree/certificate-seeking",44,36,8,-2
171492,Northwood University-Michigan,2013,"All students, Graduate",230,122,108,-2
171571,Oakland University,2013,All students total,20169,8232,11937,-2
171571,Oakland University,2013,"All students, Undergraduate total",16594,6820,9774,-2
171571,Oakland University,2013,"All students, Undergraduate, Degree/certificate-seeking total",16113,6606,9507,-2
171571,Oakland University,2013,"All students, Undergraduate, Degree/certificate-seeking, First-time",2569,1124,1445,-2
171571,Oakland University,2013,"All students, Undergraduate, Other degree/certificate-seeking",13544,5482,8062,-2
171571,Oakland University,2013,"All students, Undergraduate, Other degree/certifcate-seeking, Transfer-ins",1900,800,1100,-2
171571,Oakland University,2013,"All students, Undergraduate, Other degree/certifcate-seeking, Continuing",11644,4682,6962,-2
171571,Oakland University,2013,"All students, Undergraduate, Non-degree/certificate-seeking",481,214,267,-2
171571,Oakland University,2013,"All students, Graduate",3575,1412,2163,-2
171599,Olivet College,2013,All students total,1133,649,484,-2
171599,Olivet College,2013,"All students, Undergraduate total",1119,641,478,-2
171599,Olivet College,2013,"All students, Undergraduate, Degree/certificate-seeking total",1016,594,422,-2
171599,Olivet College,2013,"All students, Undergraduate, Degree/certificate-seeking, First-time",279,180,99,-2
171599,Olivet College,2013,"All students, Undergraduate, Other degree/certificate-seeking",737,414,323,-2
171599,Olivet College,2013,"All students, Undergraduate, Other degree/certifcate-seeking, Transfer-ins",71,43,28,-2
171599,Olivet College,2013,"All students, Undergraduate, Other degree/certifcate-seeking, Continuing",666,371,295,-2
171599,Olivet College,2013,"All students, Undergraduate, Non-degree/certificate-seeking",103,47,56,-2
171599,Olivet College,2013,"All students, Graduate",14,8,6,-2
171881,Kuyper College,2013,All students total,291,140,151,-2
171881,Kuyper College,2013,"All students, Undergraduate total",288,139,149,-2
171881,Kuyper College,2013,"All students, Undergraduate, Degree/certificate-seeking total",283,135,148,-2
171881,Kuyper College,2013,"All students, Undergraduate, Degree/certificate-seeking, First-time",38,16,22,-2
171881,Kuyper College,2013,"All students, Undergraduate, Other degree/certificate-seeking",245,119,126,-2
171881,Kuyper College,2013,"All students, Undergraduate, Other degree/certifcate-seeking, Transfer-ins",42,20,22,-2
171881,Kuyper College,2013,"All students, Undergraduate, Other degree/certifcate-seeking, Continuing",203,99,104,-2
171881,Kuyper College,2013,"All students, Undergraduate, Non-degree/certificate-seeking",5,4,1,-2
171881,Kuyper College,2013,"All students, Graduate",3,1,2,-2
172033,Sacred Heart Major Seminary,2013,All students total,436,278,158,-2
172033,Sacred Heart Major Seminary,2013,"All students, Undergraduate total",264,153,111,-2
172033,Sacred Heart Major Seminary,2013,"All students, Undergraduate, Degree/certificate-seeking total",154,108,46,-2
172033,Sacred Heart Major Seminary,2013,"All students, Undergraduate, Degree/certificate-seeking, First-time",1,1,0,-2
172033,Sacred Heart Major Seminary,2013,"All students, Undergraduate, Other degree/certificate-seeking",153,107,46,-2
172033,Sacred Heart Major Seminary,2013,"All students, Undergraduate, Other degree/certifcate-seeking, Transfer-ins",22,19,3,-2
172033,Sacred Heart Major Seminary,2013,"All students, Undergraduate, Other degree/certifcate-seeking, Continuing",131,88,43,-2
172033,Sacred Heart Major Seminary,2013,"All students, Undergraduate, Non-degree/certificate-seeking",110,45,65,-2
172033,Sacred Heart Major Seminary,2013,"All students, Graduate",172,125,47,-2
172051,Saginaw Valley State University,2013,All students total,10240,4239,6001,-2
172051,Saginaw Valley State University,2013,"All students, Undergraduate total",9163,3931,5232,-2
172051,Saginaw Valley State University,2013,"All students, Undergraduate, Degree/certificate-seeking total",8687,3731,4956,-2
172051,Saginaw Valley State University,2013,"All students, Undergraduate, Degree/certificate-seeking, First-time",1593,648,945,-2
172051,Saginaw Valley State University,2013,"All students, Undergraduate, Other degree/certificate-seeking",7094,3083,4011,-2
172051,Saginaw Valley State University,2013,"All students, Undergraduate, Other degree/certifcate-seeking, Transfer-ins",640,281,359,-2
172051,Saginaw Valley State University,2013,"All students, Undergraduate, Other degree/certifcate-seeking, Continuing",6454,2802,3652,-2
172051,Saginaw Valley State University,2013,"All students, Undergraduate, Non-degree/certificate-seeking",476,200,276,-2
172051,Saginaw Valley State University,2013,"All students, Graduate",1077,308,769,-2
172264,Siena Heights University,2013,All students total,2684,1127,1557,-2
172264,Siena Heights University,2013,"All students, Undergraduate total",2424,1053,1371,-2
172264,Siena Heights University,2013,"All students, Undergraduate, Degree/certificate-seeking total",2325,1007,1318,-2
172264,Siena Heights University,2013,"All students, Undergraduate, Degree/certificate-seeking, First-time",301,162,139,-2
172264,Siena Heights University,2013,"All students, Undergraduate, Other degree/certificate-seeking",2024,845,1179,-2
172264,Siena Heights University,2013,"All students, Undergraduate, Other degree/certifcate-seeking, Transfer-ins",471,188,283,-2
172264,Siena Heights University,2013,"All students, Undergraduate, Other degree/certifcate-seeking, Continuing",1553,657,896,-2
172264,Siena Heights University,2013,"All students, Undergraduate, Non-degree/certificate-seeking",99,46,53,-2
172264,Siena Heights University,2013,"All students, Graduate",260,74,186,-2
172334,Spring Arbor University,2013,All students total,3962,1152,2810,-2
172334,Spring Arbor University,2013,"All students, Undergraduate total",2968,919,2049,-2
172334,Spring Arbor University,2013,"All students, Undergraduate, Degree/certificate-seeking total",2860,873,1987,-2
172334,Spring Arbor University,2013,"All students, Undergraduate, Degree/certificate-seeking, First-time",369,125,244,-2
172334,Spring Arbor University,2013,"All students, Undergraduate, Other degree/certificate-seeking",2491,748,1743,-2
172334,Spring Arbor University,2013,"All students, Undergraduate, Other degree/certifcate-seeking, Transfer-ins",481,120,361,-2
172334,Spring Arbor University,2013,"All students, Undergraduate, Other degree/certifcate-seeking, Continuing",2010,628,1382,-2
172334,Spring Arbor University,2013,"All students, Undergraduate, Non-degree/certificate-seeking",108,46,62,-2
172334,Spring Arbor University,2013,"All students, Graduate",994,233,761,-2
172440,Finlandia University,2013,All students total,525,225,300,-2
172440,Finlandia University,2013,"All students, Undergraduate total",525,225,300,-2
172440,Finlandia University,2013,"All students, Undergraduate, Degree/certificate-seeking total",498,218,280,-2
172440,Finlandia University,2013,"All students, Undergraduate, Degree/certificate-seeking, First-time",107,59,48,-2
172440,Finlandia University,2013,"All students, Undergraduate, Other degree/certificate-seeking",391,159,232,-2
172440,Finlandia University,2013,"All students, Undergraduate, Other degree/certifcate-seeking, Transfer-ins",59,21,38,-2
172440,Finlandia University,2013,"All students, Undergraduate, Other degree/certifcate-seeking, Continuing",332,138,194,-2
172440,Finlandia University,2013,"All students, Undergraduate, Non-degree/certificate-seeking",27,7,20,-2
172477,Thomas M Cooley Law School,2013,All students total,2477,1201,1276,-2
172477,Thomas M Cooley Law School,2013,"All students, Graduate",2477,1201,1276,-2
172608,Walsh College of Accountancy and Business Administration,2013,All students total,2864,1410,1454,-2
172608,Walsh College of Accountancy and Business Administration,2013,"All students, Undergraduate total",994,518,476,-2
172608,Walsh College of Accountancy and Business Administration,2013,"All students, Undergraduate, Degree/certificate-seeking total",967,505,462,-2
172608,Walsh College of Accountancy and Business Administration,2013,"All students, Undergraduate, Other degree/certificate-seeking",967,505,462,-2
172608,Walsh College of Accountancy and Business Administration,2013,"All students, Undergraduate, Other degree/certifcate-seeking, Transfer-ins",235,115,120,-2
172608,Walsh College of Accountancy and Business Administration,2013,"All students, Undergraduate, Other degree/certifcate-seeking, Continuing",732,390,342,-2
172608,Walsh College of Accountancy and Business Administration,2013,"All students, Undergraduate, Non-degree/certificate-seeking",27,13,14,-2
172608,Walsh College of Accountancy and Business Administration,2013,"All students, Graduate",1870,892,978,-2
172644,Wayne State University,2013,All students total,27897,12133,15764,-2
172644,Wayne State University,2013,"All students, Undergraduate total",18602,8236,10366,-2
172644,Wayne State University,2013,"All students, Undergraduate, Degree/certificate-seeking total",17789,7915,9874,-2
172644,Wayne State University,2013,"All students, Undergraduate, Degree/certificate-seeking, First-time",2167,971,1196,-2
172644,Wayne State University,2013,"All students, Undergraduate, Other degree/certificate-seeking",15622,6944,8678,-2
172644,Wayne State University,2013,"All students, Undergraduate, Other degree/certifcate-seeking, Transfer-ins",1883,798,1085,-2
172644,Wayne State University,2013,"All students, Undergraduate, Other degree/certifcate-seeking, Continuing",13739,6146,7593,-2
172644,Wayne State University,2013,"All students, Undergraduate, Non-degree/certificate-seeking",813,321,492,-2
172644,Wayne State University,2013,"All students, Graduate",9295,3897,5398,-2
172699,Western Michigan University,2013,All students total,24294,11741,12553,-2
172699,Western Michigan University,2013,"All students, Undergraduate total",19198,9576,9622,-2
172699,Western Michigan University,2013,"All students, Undergraduate, Degree/certificate-seeking total",18755,9336,9419,-2
172699,Western Michigan University,2013,"All students, Undergraduate, Degree/certificate-seeking, First-time",3190,1549,1641,-2
172699,Western Michigan University,2013,"All students, Undergraduate, Other degree/certificate-seeking",15565,7787,7778,-2
172699,Western Michigan University,2013,"All students, Undergraduate, Other degree/certifcate-seeking, Transfer-ins",1641,812,829,-2
172699,Western Michigan University,2013,"All students, Undergraduate, Other degree/certifcate-seeking, Continuing",13924,6975,6949,-2
172699,Western Michigan University,2013,"All students, Undergraduate, Non-degree/certificate-seeking",443,240,203,-2
172699,Western Michigan University,2013,"All students, Graduate",5096,2165,2931,-2
172705,Western Theological Seminary,2013,All students total,275,182,93,-2
172705,Western Theological Seminary,2013,"All students, Graduate",275,182,93,-2
172866,Academy College,2013,All students total,149,118,31,-2
172866,Academy College,2013,"All students, Undergraduate total",149,118,31,-2
172866,Academy College,2013,"All students, Undergraduate, Degree/certificate-seeking total",140,111,29,-2
172866,Academy College,2013,"All students, Undergraduate, Degree/certificate-seeking, First-time",9,8,1,-2
172866,Academy College,2013,"All students, Undergraduate, Other degree/certificate-seeking",131,103,28,-2
172866,Academy College,2013,"All students, Undergraduate, Other degree/certifcate-seeking, Transfer-ins",17,16,1,-2
172866,Academy College,2013,"All students, Undergraduate, Other degree/certifcate-seeking, Continuing",114,87,27,-2
172866,Academy College,2013,"All students, Undergraduate, Non-degree/certificate-seeking",9,7,2,-2
172972,Apostolic Bible Institute Inc,2013,,,,,-2
173045,Augsburg College,2013,All students total,3554,1484,2070,-2
173045,Augsburg College,2013,"All students, Undergraduate total",2716,1232,1484,-2
173045,Augsburg College,2013,"All students, Undergraduate, Degree/certificate-seeking total",2661,1209,1452,-2
173045,Augsburg College,2013,"All students, Undergraduate, Degree/certificate-seeking, First-time",466,223,243,-2
173045,Augsburg College,2013,"All students, Undergraduate, Other degree/certificate-seeking",2195,986,1209,-2
173045,Augsburg College,2013,"All students, Undergraduate, Other degree/certifcate-seeking, Transfer-ins",298,130,168,-2
173045,Augsburg College,2013,"All students, Undergraduate, Other degree/certifcate-seeking, Continuing",1897,856,1041,-2
173045,Augsburg College,2013,"All students, Undergraduate, Non-degree/certificate-seeking",55,23,32,-2
173045,Augsburg College,2013,"All students, Graduate",838,252,586,-2
173124,Bemidji State University,2013,All students total,4963,2167,2796,-2
173124,Bemidji State University,2013,"All students, Undergraduate total",4727,2092,2635,-2
173124,Bemidji State University,2013,"All students, Undergraduate, Degree/certificate-seeking total",4397,1969,2428,-2
173124,Bemidji State University,2013,"All students, Undergraduate, Degree/certificate-seeking, First-time",828,407,421,-2
173124,Bemidji State University,2013,"All students, Undergraduate, Other degree/certificate-seeking",3569,1562,2007,-2
173124,Bemidji State University,2013,"All students, Undergraduate, Other degree/certifcate-seeking, Transfer-ins",585,232,353,-2
173124,Bemidji State University,2013,"All students, Undergraduate, Other degree/certifcate-seeking, Continuing",2984,1330,1654,-2
173124,Bemidji State University,2013,"All students, Undergraduate, Non-degree/certificate-seeking",330,123,207,-2
173124,Bemidji State University,2013,"All students, Graduate",236,75,161,-2
173142,Bethany Lutheran College,2013,All students total,579,283,296,-2
173142,Bethany Lutheran College,2013,"All students, Undergraduate total",579,283,296,-2
173142,Bethany Lutheran College,2013,"All students, Undergraduate, Degree/certificate-seeking total",552,270,282,-2
173142,Bethany Lutheran College,2013,"All students, Undergraduate, Degree/certificate-seeking, First-time",147,67,80,-2
173142,Bethany Lutheran College,2013,"All students, Undergraduate, Other degree/certificate-seeking",405,203,202,-2
173142,Bethany Lutheran College,2013,"All students, Undergraduate, Other degree/certifcate-seeking, Transfer-ins",37,26,11,-2
173142,Bethany Lutheran College,2013,"All students, Undergraduate, Other degree/certifcate-seeking, Continuing",368,177,191,-2
173142,Bethany Lutheran College,2013,"All students, Undergraduate, Non-degree/certificate-seeking",27,13,14,-2
173160,Bethel University,2013,All students total,4340,1590,2750,-2
173160,Bethel University,2013,"All students, Undergraduate total",3280,1211,2069,-2
173160,Bethel University,2013,"All students, Undergraduate, Degree/certificate-seeking total",3178,1174,2004,-2
173160,Bethel University,2013,"All students, Undergraduate, Degree/certificate-seeking, First-time",612,228,384,-2
173160,Bethel University,2013,"All students, Undergraduate, Other degree/certificate-seeking",2566,946,1620,-2
173160,Bethel University,2013,"All students, Undergraduate, Other degree/certifcate-seeking, Transfer-ins",236,79,157,-2
173160,Bethel University,2013,"All students, Undergraduate, Other degree/certifcate-seeking, Continuing",2330,867,1463,-2
173160,Bethel University,2013,"All students, Undergraduate, Non-degree/certificate-seeking",102,37,65,-2
173160,Bethel University,2013,"All students, Graduate",1060,379,681,-2
173179,Bethel Seminary-St Paul,2013,All students total,512,315,197,-2
173179,Bethel Seminary-St Paul,2013,"All students, Graduate",512,315,197,-2
173258,Carleton College,2013,All students total,2045,960,1085,-2
173258,Carleton College,2013,"All students, Undergraduate total",2045,960,1085,-2
173258,Carleton College,2013,"All students, Undergraduate, Degree/certificate-seeking total",2023,953,1070,-2
173258,Carleton College,2013,"All students, Undergraduate, Degree/certificate-seeking, First-time",527,259,268,-2
173258,Carleton College,2013,"All students, Undergraduate, Other degree/certificate-seeking",1496,694,802,-2
173258,Carleton College,2013,"All students, Undergraduate, Other degree/certifcate-seeking, Transfer-ins",2,1,1,-2
173258,Carleton College,2013,"All students, Undergraduate, Other degree/certifcate-seeking, Continuing",1494,693,801,-2
173258,Carleton College,2013,"All students, Undergraduate, Non-degree/certificate-seeking",22,7,15,-2
173300,Concordia College at Moorhead,2013,All students total,2558,972,1586,-2
173300,Concordia College at Moorhead,2013,"All students, Undergraduate total",2531,968,1563,-2
173300,Concordia College at Moorhead,2013,"All students, Undergraduate, Degree/certificate-seeking total",2464,951,1513,-2
173300,Concordia College at Moorhead,2013,"All students, Undergraduate, Degree/certificate-seeking, First-time",684,277,407,-2
173300,Concordia College at Moorhead,2013,"All students, Undergraduate, Other degree/certificate-seeking",1780,674,1106,-2
173300,Concordia College at Moorhead,2013,"All students, Undergraduate, Other degree/certifcate-seeking, Transfer-ins",42,25,17,-2
173300,Concordia College at Moorhead,2013,"All students, Undergraduate, Other degree/certifcate-seeking, Continuing",1738,649,1089,-2
173300,Concordia College at Moorhead,2013,"All students, Undergraduate, Non-degree/certificate-seeking",67,17,50,-2
173300,Concordia College at Moorhead,2013,"All students, Graduate",27,4,23,-2
173328,Concordia University-Saint Paul,2013,All students total,3661,1372,2289,-2
173328,Concordia University-Saint Paul,2013,"All students, Undergraduate total",2206,932,1274,-2
173328,Concordia University-Saint Paul,2013,"All students, Undergraduate, Degree/certificate-seeking total",1927,827,1100,-2
173328,Concordia University-Saint Paul,2013,"All students, Undergraduate, Degree/certificate-seeking, First-time",294,160,134,-2
173328,Concordia University-Saint Paul,2013,"All students, Undergraduate, Other degree/certificate-seeking",1633,667,966,-2
173328,Concordia University-Saint Paul,2013,"All students, Undergraduate, Other degree/certifcate-seeking, Transfer-ins",550,219,331,-2
173328,Concordia University-Saint Paul,2013,"All students, Undergraduate, Other degree/certifcate-seeking, Continuing",1083,448,635,-2
173328,Concordia University-Saint Paul,2013,"All students, Undergraduate, Non-degree/certificate-seeking",279,105,174,-2
173328,Concordia University-Saint Paul,2013,"All students, Graduate",1455,440,1015,-2
173452,Martin Luther College,2013,All students total,824,418,406,-2
173452,Martin Luther College,2013,"All students, Undergraduate total",763,380,383,-2
173452,Martin Luther College,2013,"All students, Undergraduate, Degree/certificate-seeking total",729,361,368,-2
173452,Martin Luther College,2013,"All students, Undergraduate, Degree/certificate-seeking, First-time",164,79,85,-2
173452,Martin Luther College,2013,"All students, Undergraduate, Other degree/certificate-seeking",565,282,283,-2
173452,Martin Luther College,2013,"All students, Undergraduate, Other degree/certifcate-seeking, Transfer-ins",32,16,16,-2
173452,Martin Luther College,2013,"All students, Undergraduate, Other degree/certifcate-seeking, Continuing",533,266,267,-2
173452,Martin Luther College,2013,"All students, Undergraduate, Non-degree/certificate-seeking",34,19,15,-2
173452,Martin Luther College,2013,"All students, Graduate",61,38,23,-2
173489,Duluth Business University,2013,All students total,201,27,174,-2
173489,Duluth Business University,2013,"All students, Undergraduate total",201,27,174,-2
173489,Duluth Business University,2013,"All students, Undergraduate, Degree/certificate-seeking total",201,27,174,-2
173489,Duluth Business University,2013,"All students, Undergraduate, Degree/certificate-seeking, First-time",12,1,11,-2
173489,Duluth Business University,2013,"All students, Undergraduate, Other degree/certificate-seeking",189,26,163,-2
173489,Duluth Business University,2013,"All students, Undergraduate, Other degree/certifcate-seeking, Transfer-ins",30,1,29,-2
173489,Duluth Business University,2013,"All students, Undergraduate, Other degree/certifcate-seeking, Continuing",159,25,134,-2
173629,Globe University-Woodbury,2013,All students total,983,325,658,-2
173629,Globe University-Woodbury,2013,"All students, Undergraduate total",898,300,598,-2
173629,Globe University-Woodbury,2013,"All students, Undergraduate, Degree/certificate-seeking total",845,279,566,-2
173629,Globe University-Woodbury,2013,"All students, Undergraduate, Degree/certificate-seeking, First-time",70,28,42,-2
173629,Globe University-Woodbury,2013,"All students, Undergraduate, Other degree/certificate-seeking",775,251,524,-2
173629,Globe University-Woodbury,2013,"All students, Undergraduate, Other degree/certifcate-seeking, Transfer-ins",195,65,130,-2
173629,Globe University-Woodbury,2013,"All students, Undergraduate, Other degree/certifcate-seeking, Continuing",580,186,394,-2
173629,Globe University-Woodbury,2013,"All students, Undergraduate, Non-degree/certificate-seeking",53,21,32,-2
173629,Globe University-Woodbury,2013,"All students, Graduate",85,25,60,-2
173647,Gustavus Adolphus College,2013,All students total,2449,1135,1314,-2
173647,Gustavus Adolphus College,2013,"All students, Undergraduate total",2449,1135,1314,-2
173647,Gustavus Adolphus College,2013,"All students, Undergraduate, Degree/certificate-seeking total",2439,1131,1308,-2
173647,Gustavus Adolphus College,2013,"All students, Undergraduate, Degree/certificate-seeking, First-time",610,296,314,-2
173647,Gustavus Adolphus College,2013,"All students, Undergraduate, Other degree/certificate-seeking",1829,835,994,-2
173647,Gustavus Adolphus College,2013,"All students, Undergraduate, Other degree/certifcate-seeking, Transfer-ins",121,67,54,-2
173647,Gustavus Adolphus College,2013,"All students, Undergraduate, Other degree/certifcate-seeking, Continuing",1708,768,940,-2
173647,Gustavus Adolphus College,2013,"All students, Undergraduate, Non-degree/certificate-seeking",10,4,6,-2
173665,Hamline University,2013,All students total,4581,1750,2831,-2
173665,Hamline University,2013,"All students, Undergraduate total",2164,904,1260,-2
173665,Hamline University,2013,"All students, Undergraduate, Degree/certificate-seeking total",2108,892,1216,-2
173665,Hamline University,2013,"All students, Undergraduate, Degree/certificate-seeking, First-time",536,218,318,-2
173665,Hamline University,2013,"All students, Undergraduate, Other degree/certificate-seeking",1572,674,898,-2
173665,Hamline University,2013,"All students, Undergraduate, Other degree/certifcate-seeking, Transfer-ins",142,73,69,-2
173665,Hamline University,2013,"All students, Undergraduate, Other degree/certifcate-seeking, Continuing",1430,601,829,-2
173665,Hamline University,2013,"All students, Undergraduate, Non-degree/certificate-seeking",56,12,44,-2
173665,Hamline University,2013,"All students, Graduate",2417,846,1571,-2
173683,Hazelden Graduate School of Addiction Studies,2013,All students total,90,35,55,-2
173683,Hazelden Graduate School of Addiction Studies,2013,"All students, Graduate",90,35,55,-2
173887,The Art Institutes International-Minnesota,2013,All students total,1161,486,675,-2
173887,The Art Institutes International-Minnesota,2013,"All students, Undergraduate total",1161,486,675,-2
173887,The Art Institutes International-Minnesota,2013,"All students, Undergraduate, Degree/certificate-seeking total",1161,486,675,-2
173887,The Art Institutes International-Minnesota,2013,"All students, Undergraduate, Degree/certificate-seeking, First-time",205,96,109,-2
173887,The Art Institutes International-Minnesota,2013,"All students, Undergraduate, Other degree/certificate-seeking",956,390,566,-2
173887,The Art Institutes International-Minnesota,2013,"All students, Undergraduate, Other degree/certifcate-seeking, Transfer-ins",173,50,123,-2
173887,The Art Institutes International-Minnesota,2013,"All students, Undergraduate, Other degree/certifcate-seeking, Continuing",783,340,443,-2
173896,Luther Seminary,2013,All students total,705,372,333,-2
173896,Luther Seminary,2013,"All students, Graduate",705,372,333,-2
173902,Macalester College,2013,All students total,2039,802,1237,-2
173902,Macalester College,2013,"All students, Undergraduate total",2039,802,1237,-2
173902,Macalester College,2013,"All students, Undergraduate, Degree/certificate-seeking total",2029,799,1230,-2
173902,Macalester College,2013,"All students, Undergraduate, Degree/certificate-seeking, First-time",555,227,328,-2
173902,Macalester College,2013,"All students, Undergraduate, Other degree/certificate-seeking",1474,572,902,-2
173902,Macalester College,2013,"All students, Undergraduate, Other degree/certifcate-seeking, Transfer-ins",13,5,8,-2
173902,Macalester College,2013,"All students, Undergraduate, Other degree/certifcate-seeking, Continuing",1461,567,894,-2
173902,Macalester College,2013,"All students, Undergraduate, Non-degree/certificate-seeking",10,3,7,-2
173920,Minnesota State University-Mankato,2013,All students total,15426,7210,8216,-2
173920,Minnesota State University-Mankato,2013,"All students, Undergraduate total",13467,6478,6989,-2
173920,Minnesota State University-Mankato,2013,"All students, Undergraduate, Degree/certificate-seeking total",12542,6115,6427,-2
173920,Minnesota State University-Mankato,2013,"All students, Undergraduate, Degree/certificate-seeking, First-time",2452,1098,1354,-2
173920,Minnesota State University-Mankato,2013,"All students, Undergraduate, Other degree/certificate-seeking",10090,5017,5073,-2
173920,Minnesota State University-Mankato,2013,"All students, Undergraduate, Other degree/certifcate-seeking, Transfer-ins",1091,531,560,-2
173920,Minnesota State University-Mankato,2013,"All students, Undergraduate, Other degree/certifcate-seeking, Continuing",8999,4486,4513,-2
173920,Minnesota State University-Mankato,2013,"All students, Undergraduate, Non-degree/certificate-seeking",925,363,562,-2
173920,Minnesota State University-Mankato,2013,"All students, Graduate",1959,732,1227,-2
173957,Mayo Medical School,2013,All students total,195,100,95,-2
173957,Mayo Medical School,2013,"All students, Graduate",195,100,95,-2
173966,Mayo School of Health Sciences,2013,All students total,335,89,246,-2
173966,Mayo School of Health Sciences,2013,"All students, Undergraduate total",131,27,104,-2
173966,Mayo School of Health Sciences,2013,"All students, Undergraduate, Degree/certificate-seeking total",131,27,104,-2
173966,Mayo School of Health Sciences,2013,"All students, Undergraduate, Other degree/certificate-seeking",131,27,104,-2
173966,Mayo School of Health Sciences,2013,"All students, Undergraduate, Other degree/certifcate-seeking, Continuing",131,27,104,-2
173966,Mayo School of Health Sciences,2013,"All students, Graduate",204,62,142,-2
173984,Argosy University-Twin Cities,2013,All students total,1626,317,1309,-2
173984,Argosy University-Twin Cities,2013,"All students, Undergraduate total",1122,191,931,-2
173984,Argosy University-Twin Cities,2013,"All students, Undergraduate, Degree/certificate-seeking total",1113,190,923,-2
173984,Argosy University-Twin Cities,2013,"All students, Undergraduate, Degree/certificate-seeking, First-time",100,15,85,-2
173984,Argosy University-Twin Cities,2013,"All students, Undergraduate, Other degree/certificate-seeking",1013,175,838,-2
173984,Argosy University-Twin Cities,2013,"All students, Undergraduate, Other degree/certifcate-seeking, Transfer-ins",232,46,186,-2
173984,Argosy University-Twin Cities,2013,"All students, Undergraduate, Other degree/certifcate-seeking, Continuing",781,129,652,-2
173984,Argosy University-Twin Cities,2013,"All students, Undergraduate, Non-degree/certificate-seeking",9,1,8,-2
173984,Argosy University-Twin Cities,2013,"All students, Graduate",504,126,378,-2
174020,Metropolitan State University,2013,All students total,8510,3731,4779,-2
174020,Metropolitan State University,2013,"All students, Undergraduate total",7647,3388,4259,-2
174020,Metropolitan State University,2013,"All students, Undergraduate, Degree/certificate-seeking total",7322,3248,4074,-2
174020,Metropolitan State University,2013,"All students, Undergraduate, Degree/certificate-seeking, First-time",100,53,47,-2
174020,Metropolitan State University,2013,"All students, Undergraduate, Other degree/certificate-seeking",7222,3195,4027,-2
174020,Metropolitan State University,2013,"All students, Undergraduate, Other degree/certifcate-seeking, Transfer-ins",1811,842,969,-2
174020,Metropolitan State University,2013,"All students, Undergraduate, Other degree/certifcate-seeking, Continuing",5411,2353,3058,-2
174020,Metropolitan State University,2013,"All students, Undergraduate, Non-degree/certificate-seeking",325,140,185,-2
174020,Metropolitan State University,2013,"All students, Graduate",863,343,520,-2
174066,University of Minnesota-Twin Cities,2013,All students total,51526,25050,26476,-2
174066,University of Minnesota-Twin Cities,2013,"All students, Undergraduate total",34449,16791,17658,-2
174066,University of Minnesota-Twin Cities,2013,"All students, Undergraduate, Degree/certificate-seeking total",30271,14856,15415,-2
174066,University of Minnesota-Twin Cities,2013,"All students, Undergraduate, Degree/certificate-seeking, First-time",5544,2629,2915,-2
174066,University of Minnesota-Twin Cities,2013,"All students, Undergraduate, Other degree/certificate-seeking",24727,12227,12500,-2
174066,University of Minnesota-Twin Cities,2013,"All students, Undergraduate, Other degree/certifcate-seeking, Transfer-ins",2525,1237,1288,-2
174066,University of Minnesota-Twin Cities,2013,"All students, Undergraduate, Other degree/certifcate-seeking, Continuing",22202,10990,11212,-2
174066,University of Minnesota-Twin Cities,2013,"All students, Undergraduate, Non-degree/certificate-seeking",4178,1935,2243,-2
174066,University of Minnesota-Twin Cities,2013,"All students, Graduate",17077,8259,8818,-2
174075,University of Minnesota-Crookston,2013,All students total,2839,1343,1496,-2
174075,University of Minnesota-Crookston,2013,"All students, Undergraduate total",2839,1343,1496,-2
174075,University of Minnesota-Crookston,2013,"All students, Undergraduate, Degree/certificate-seeking total",1813,916,897,-2
174075,University of Minnesota-Crookston,2013,"All students, Undergraduate, Degree/certificate-seeking, First-time",213,108,105,-2
174075,University of Minnesota-Crookston,2013,"All students, Undergraduate, Other degree/certificate-seeking",1600,808,792,-2
174075,University of Minnesota-Crookston,2013,"All students, Undergraduate, Other degree/certifcate-seeking, Transfer-ins",242,118,124,-2
174075,University of Minnesota-Crookston,2013,"All students, Undergraduate, Other degree/certifcate-seeking, Continuing",1358,690,668,-2
174075,University of Minnesota-Crookston,2013,"All students, Undergraduate, Non-degree/certificate-seeking",1026,427,599,-2
174127,Minneapolis College of Art and Design,2013,All students total,791,283,508,-2
174127,Minneapolis College of Art and Design,2013,"All students, Undergraduate total",688,246,442,-2
174127,Minneapolis College of Art and Design,2013,"All students, Undergraduate, Degree/certificate-seeking total",683,244,439,-2
174127,Minneapolis College of Art and Design,2013,"All students, Undergraduate, Degree/certificate-seeking, First-time",116,34,82,-2
174127,Minneapolis College of Art and Design,2013,"All students, Undergraduate, Other degree/certificate-seeking",567,210,357,-2
174127,Minneapolis College of Art and Design,2013,"All students, Undergraduate, Other degree/certifcate-seeking, Transfer-ins",102,39,63,-2
174127,Minneapolis College of Art and Design,2013,"All students, Undergraduate, Other degree/certifcate-seeking, Continuing",465,171,294,-2
174127,Minneapolis College of Art and Design,2013,"All students, Undergraduate, Non-degree/certificate-seeking",5,2,3,-2
174127,Minneapolis College of Art and Design,2013,"All students, Graduate",103,37,66,-2
174154,Herzing University-Minneapolis,2013,All students total,262,23,239,-2
174154,Herzing University-Minneapolis,2013,"All students, Undergraduate total",262,23,239,-2
174154,Herzing University-Minneapolis,2013,"All students, Undergraduate, Degree/certificate-seeking total",262,23,239,-2
174154,Herzing University-Minneapolis,2013,"All students, Undergraduate, Degree/certificate-seeking, First-time",9,1,8,-2
174154,Herzing University-Minneapolis,2013,"All students, Undergraduate, Other degree/certificate-seeking",253,22,231,-2
174154,Herzing University-Minneapolis,2013,"All students, Undergraduate, Other degree/certifcate-seeking, Transfer-ins",15,1,14,-2
174154,Herzing University-Minneapolis,2013,"All students, Undergraduate, Other degree/certifcate-seeking, Continuing",238,21,217,-2
174206,Crossroads College,2013,All students total,101,46,55,-2
174206,Crossroads College,2013,"All students, Undergraduate total",101,46,55,-2
174206,Crossroads College,2013,"All students, Undergraduate, Degree/certificate-seeking total",97,45,52,-2
174206,Crossroads College,2013,"All students, Undergraduate, Degree/certificate-seeking, First-time",13,10,3,-2
174206,Crossroads College,2013,"All students, Undergraduate, Other degree/certificate-seeking",84,35,49,-2
174206,Crossroads College,2013,"All students, Undergraduate, Other degree/certifcate-seeking, Transfer-ins",13,9,4,-2
174206,Crossroads College,2013,"All students, Undergraduate, Other degree/certifcate-seeking, Continuing",71,26,45,-2
174206,Crossroads College,2013,"All students, Undergraduate, Non-degree/certificate-seeking",4,1,3,-2
174233,University of Minnesota-Duluth,2013,All students total,11241,5905,5336,-2
174233,University of Minnesota-Duluth,2013,"All students, Undergraduate total",10079,5393,4686,-2
174233,University of Minnesota-Duluth,2013,"All students, Undergraduate, Degree/certificate-seeking total",9239,5059,4180,-2
174233,University of Minnesota-Duluth,2013,"All students, Undergraduate, Degree/certificate-seeking, First-time",2054,1079,975,-2
174233,University of Minnesota-Duluth,2013,"All students, Undergraduate, Other degree/certificate-seeking",7185,3980,3205,-2
174233,University of Minnesota-Duluth,2013,"All students, Undergraduate, Other degree/certifcate-seeking, Transfer-ins",570,307,263,-2
174233,University of Minnesota-Duluth,2013,"All students, Undergraduate, Other degree/certifcate-seeking, Continuing",6615,3673,2942,-2
174233,University of Minnesota-Duluth,2013,"All students, Undergraduate, Non-degree/certificate-seeking",840,334,506,-2
174233,University of Minnesota-Duluth,2013,"All students, Graduate",1162,512,650,-2
174251,University of Minnesota-Morris,2013,All students total,1946,873,1073,-2
174251,University of Minnesota-Morris,2013,"All students, Undergraduate total",1946,873,1073,-2
174251,University of Minnesota-Morris,2013,"All students, Undergraduate, Degree/certificate-seeking total",1846,840,1006,-2
174251,University of Minnesota-Morris,2013,"All students, Undergraduate, Degree/certificate-seeking, First-time",469,188,281,-2
174251,University of Minnesota-Morris,2013,"All students, Undergraduate, Other degree/certificate-seeking",1377,652,725,-2
174251,University of Minnesota-Morris,2013,"All students, Undergraduate, Other degree/certifcate-seeking, Transfer-ins",100,64,36,-2
174251,University of Minnesota-Morris,2013,"All students, Undergraduate, Other degree/certifcate-seeking, Continuing",1277,588,689,-2
174251,University of Minnesota-Morris,2013,"All students, Undergraduate, Non-degree/certificate-seeking",100,33,67,-2
174279,Minnesota School of Business-Richfield,2013,All students total,1037,341,696,-2
174279,Minnesota School of Business-Richfield,2013,"All students, Undergraduate total",947,303,644,-2
174279,Minnesota School of Business-Richfield,2013,"All students, Undergraduate, Degree/certificate-seeking total",896,282,614,-2
174279,Minnesota School of Business-Richfield,2013,"All students, Undergraduate, Degree/certificate-seeking, First-time",44,22,22,-2
174279,Minnesota School of Business-Richfield,2013,"All students, Undergraduate, Other degree/certificate-seeking",852,260,592,-2
174279,Minnesota School of Business-Richfield,2013,"All students, Undergraduate, Other degree/certifcate-seeking, Transfer-ins",186,59,127,-2
174279,Minnesota School of Business-Richfield,2013,"All students, Undergraduate, Other degree/certifcate-seeking, Continuing",666,201,465,-2
174279,Minnesota School of Business-Richfield,2013,"All students, Undergraduate, Non-degree/certificate-seeking",51,21,30,-2
174279,Minnesota School of Business-Richfield,2013,"All students, Graduate",90,38,52,-2
174358,Minnesota State University-Moorhead,2013,All students total,6634,2606,4028,-2
174358,Minnesota State University-Moorhead,2013,"All students, Undergraduate total",6163,2487,3676,-2
174358,Minnesota State University-Moorhead,2013,"All students, Undergraduate, Degree/certificate-seeking total",5912,2397,3515,-2
174358,Minnesota State University-Moorhead,2013,"All students, Undergraduate, Degree/certificate-seeking, First-time",987,360,627,-2
174358,Minnesota State University-Moorhead,2013,"All students, Undergraduate, Other degree/certificate-seeking",4925,2037,2888,-2
174358,Minnesota State University-Moorhead,2013,"All students, Undergraduate, Other degree/certifcate-seeking, Transfer-ins",629,284,345,-2
174358,Minnesota State University-Moorhead,2013,"All students, Undergraduate, Other degree/certifcate-seeking, Continuing",4296,1753,2543,-2
174358,Minnesota State University-Moorhead,2013,"All students, Undergraduate, Non-degree/certificate-seeking",251,90,161,-2
174358,Minnesota State University-Moorhead,2013,"All students, Graduate",471,119,352,-2
174385,National American University-Roseville,2013,All students total,371,131,240,-2
174385,National American University-Roseville,2013,"All students, Undergraduate total",371,131,240,-2
174385,National American University-Roseville,2013,"All students, Undergraduate, Degree/certificate-seeking total",369,130,239,-2
174385,National American University-Roseville,2013,"All students, Undergraduate, Degree/certificate-seeking, First-time",29,18,11,-2
174385,National American University-Roseville,2013,"All students, Undergraduate, Other degree/certificate-seeking",340,112,228,-2
174385,National American University-Roseville,2013,"All students, Undergraduate, Other degree/certifcate-seeking, Transfer-ins",59,23,36,-2
174385,National American University-Roseville,2013,"All students, Undergraduate, Other degree/certifcate-seeking, Continuing",281,89,192,-2
174385,National American University-Roseville,2013,"All students, Undergraduate, Non-degree/certificate-seeking",2,1,1,-2
174394,Brown College-Mendota Heights,2013,All students total,237,132,105,-2
174394,Brown College-Mendota Heights,2013,"All students, Undergraduate total",237,132,105,-2
174394,Brown College-Mendota Heights,2013,"All students, Undergraduate, Degree/certificate-seeking total",237,132,105,-2
174394,Brown College-Mendota Heights,2013,"All students, Undergraduate, Degree/certificate-seeking, First-time",20,8,12,-2
174394,Brown College-Mendota Heights,2013,"All students, Undergraduate, Other degree/certificate-seeking",217,124,93,-2
174394,Brown College-Mendota Heights,2013,"All students, Undergraduate, Other degree/certifcate-seeking, Transfer-ins",14,6,8,-2
174394,Brown College-Mendota Heights,2013,"All students, Undergraduate, Other degree/certifcate-seeking, Continuing",203,118,85,-2
174437,North Central University,2013,All students total,1305,597,708,-2
174437,North Central University,2013,"All students, Undergraduate total",1301,596,705,-2
174437,North Central University,2013,"All students, Undergraduate, Degree/certificate-seeking total",1106,521,585,-2
174437,North Central University,2013,"All students, Undergraduate, Degree/certificate-seeking, First-time",246,103,143,-2
174437,North Central University,2013,"All students, Undergraduate, Other degree/certificate-seeking",860,418,442,-2
174437,North Central University,2013,"All students, Undergraduate, Other degree/certifcate-seeking, Transfer-ins",95,50,45,-2
174437,North Central University,2013,"All students, Undergraduate, Other degree/certifcate-seeking, Continuing",765,368,397,-2
174437,North Central University,2013,"All students, Undergraduate, Non-degree/certificate-seeking",195,75,120,-2
174437,North Central University,2013,"All students, Graduate",4,1,3,-2
174491,University of Northwestern-St Paul,2013,All students total,3352,1380,1972,-2
174491,University of Northwestern-St Paul,2013,"All students, Undergraduate total",3149,1255,1894,-2
174491,University of Northwestern-St Paul,2013,"All students, Undergraduate, Degree/certificate-seeking total",2038,821,1217,-2
174491,University of Northwestern-St Paul,2013,"All students, Undergraduate, Degree/certificate-seeking, First-time",468,182,286,-2
174491,University of Northwestern-St Paul,2013,"All students, Undergraduate, Other degree/certificate-seeking",1570,639,931,-2
174491,University of Northwestern-St Paul,2013,"All students, Undergraduate, Other degree/certifcate-seeking, Transfer-ins",139,58,81,-2
174491,University of Northwestern-St Paul,2013,"All students, Undergraduate, Other degree/certifcate-seeking, Continuing",1431,581,850,-2
174491,University of Northwestern-St Paul,2013,"All students, Undergraduate, Non-degree/certificate-seeking",1111,434,677,-2
174491,University of Northwestern-St Paul,2013,"All students, Graduate",203,125,78,-2
174507,Northwestern Health Sciences University,2013,All students total,904,430,474,-2
174507,Northwestern Health Sciences University,2013,"All students, Undergraduate total",113,47,66,-2
174507,Northwestern Health Sciences University,2013,"All students, Undergraduate, Degree/certificate-seeking total",113,47,66,-2
174507,Northwestern Health Sciences University,2013,"All students, Undergraduate, Degree/certificate-seeking, First-time",10,5,5,-2
174507,Northwestern Health Sciences University,2013,"All students, Undergraduate, Other degree/certificate-seeking",103,42,61,-2
174507,Northwestern Health Sciences University,2013,"All students, Undergraduate, Other degree/certifcate-seeking, Transfer-ins",89,36,53,-2
174507,Northwestern Health Sciences University,2013,"All students, Undergraduate, Other degree/certifcate-seeking, Continuing",14,6,8,-2
174507,Northwestern Health Sciences University,2013,"All students, Graduate",791,383,408,-2
174525,Oak Hills Christian College,2013,All students total,143,71,72,-2
174525,Oak Hills Christian College,2013,"All students, Undergraduate total",143,71,72,-2
174525,Oak Hills Christian College,2013,"All students, Undergraduate, Degree/certificate-seeking total",126,64,62,-2
174525,Oak Hills Christian College,2013,"All students, Undergraduate, Degree/certificate-seeking, First-time",29,15,14,-2
174525,Oak Hills Christian College,2013,"All students, Undergraduate, Other degree/certificate-seeking",97,49,48,-2
174525,Oak Hills Christian College,2013,"All students, Undergraduate, Other degree/certifcate-seeking, Transfer-ins",21,13,8,-2
174525,Oak Hills Christian College,2013,"All students, Undergraduate, Other degree/certifcate-seeking, Continuing",76,36,40,-2
174525,Oak Hills Christian College,2013,"All students, Undergraduate, Non-degree/certificate-seeking",17,7,10,-2
174747,College of Saint Benedict,2013,All students total,2051,0,2051,-2
174747,College of Saint Benedict,2013,"All students, Undergraduate total",2051,0,2051,-2
174747,College of Saint Benedict,2013,"All students, Undergraduate, Degree/certificate-seeking total",2051,0,2051,-2
174747,College of Saint Benedict,2013,"All students, Undergraduate, Degree/certificate-seeking, First-time",543,0,543,-2
174747,College of Saint Benedict,2013,"All students, Undergraduate, Other degree/certificate-seeking",1508,0,1508,-2
174747,College of Saint Benedict,2013,"All students, Undergraduate, Other degree/certifcate-seeking, Transfer-ins",38,0,38,-2
174747,College of Saint Benedict,2013,"All students, Undergraduate, Other degree/certifcate-seeking, Continuing",1470,0,1470,-2
174783,Saint Cloud State University,2013,All students total,16765,7949,8816,-2
174783,Saint Cloud State University,2013,"All students, Undergraduate total",15134,7285,7849,-2
174783,Saint Cloud State University,2013,"All students, Undergraduate, Degree/certificate-seeking total",11535,5798,5737,-2
174783,Saint Cloud State University,2013,"All students, Undergraduate, Degree/certificate-seeking, First-time",1701,779,922,-2
174783,Saint Cloud State University,2013,"All students, Undergraduate, Other degree/certificate-seeking",9834,5019,4815,-2
174783,Saint Cloud State University,2013,"All students, Undergraduate, Other degree/certifcate-seeking, Transfer-ins",1078,524,554,-2
174783,Saint Cloud State University,2013,"All students, Undergraduate, Other degree/certifcate-seeking, Continuing",8756,4495,4261,-2
174783,Saint Cloud State University,2013,"All students, Undergraduate, Non-degree/certificate-seeking",3599,1487,2112,-2
174783,Saint Cloud State University,2013,"All students, Graduate",1631,664,967,-2
174792,Saint Johns University,2013,All students total,1979,1924,55,-2
174792,Saint Johns University,2013,"All students, Undergraduate total",1871,1871,0,-2
174792,Saint Johns University,2013,"All students, Undergraduate, Degree/certificate-seeking total",1871,1871,0,-2
174792,Saint Johns University,2013,"All students, Undergraduate, Degree/certificate-seeking, First-time",500,500,0,-2
174792,Saint Johns University,2013,"All students, Undergraduate, Other degree/certificate-seeking",1371,1371,0,-2
174792,Saint Johns University,2013,"All students, Undergraduate, Other degree/certifcate-seeking, Transfer-ins",26,26,0,-2
174792,Saint Johns University,2013,"All students, Undergraduate, Other degree/certifcate-seeking, Continuing",1345,1345,0,-2
174792,Saint Johns University,2013,"All students, Graduate",108,53,55,-2
174817,Saint Mary's University of Minnesota,2013,All students total,5528,1961,3567,-2
174817,Saint Mary's University of Minnesota,2013,"All students, Undergraduate total",1932,876,1056,-2
174817,Saint Mary's University of Minnesota,2013,"All students, Undergraduate, Degree/certificate-seeking total",1897,859,1038,-2
174817,Saint Mary's University of Minnesota,2013,"All students, Undergraduate, Degree/certificate-seeking, First-time",319,138,181,-2
174817,Saint Mary's University of Minnesota,2013,"All students, Undergraduate, Other degree/certificate-seeking",1578,721,857,-2
174817,Saint Mary's University of Minnesota,2013,"All students, Undergraduate, Other degree/certifcate-seeking, Transfer-ins",197,93,104,-2
174817,Saint Mary's University of Minnesota,2013,"All students, Undergraduate, Other degree/certifcate-seeking, Continuing",1381,628,753,-2
174817,Saint Mary's University of Minnesota,2013,"All students, Undergraduate, Non-degree/certificate-seeking",35,17,18,-2
174817,Saint Mary's University of Minnesota,2013,"All students, Graduate",3596,1085,2511,-2
174844,St Olaf College,2013,All students total,3125,1370,1755,-2
174844,St Olaf College,2013,"All students, Undergraduate total",3125,1370,1755,-2
174844,St Olaf College,2013,"All students, Undergraduate, Degree/certificate-seeking total",3079,1350,1729,-2
174844,St Olaf College,2013,"All students, Undergraduate, Degree/certificate-seeking, First-time",752,319,433,-2
174844,St Olaf College,2013,"All students, Undergraduate, Other degree/certificate-seeking",2327,1031,1296,-2
174844,St Olaf College,2013,"All students, Undergraduate, Other degree/certifcate-seeking, Transfer-ins",19,8,11,-2
174844,St Olaf College,2013,"All students, Undergraduate, Other degree/certifcate-seeking, Continuing",2308,1023,1285,-2
174844,St Olaf College,2013,"All students, Undergraduate, Non-degree/certificate-seeking",46,20,26,-2
174862,Crown College,2013,All students total,1323,638,685,-2
174862,Crown College,2013,"All students, Undergraduate total",1139,533,606,-2
174862,Crown College,2013,"All students, Undergraduate, Degree/certificate-seeking total",1095,521,574,-2
174862,Crown College,2013,"All students, Undergraduate, Degree/certificate-seeking, First-time",210,118,92,-2
174862,Crown College,2013,"All students, Undergraduate, Other degree/certificate-seeking",885,403,482,-2
174862,Crown College,2013,"All students, Undergraduate, Other degree/certifcate-seeking, Transfer-ins",53,26,27,-2
174862,Crown College,2013,"All students, Undergraduate, Other degree/certifcate-seeking, Continuing",832,377,455,-2
174862,Crown College,2013,"All students, Undergraduate, Non-degree/certificate-seeking",44,12,32,-2
174862,Crown College,2013,"All students, Graduate",184,105,79,-2
174899,The College of Saint Scholastica,2013,All students total,4206,1199,3007,-2
174899,The College of Saint Scholastica,2013,"All students, Undergraduate total",2917,896,2021,-2
174899,The College of Saint Scholastica,2013,"All students, Undergraduate, Degree/certificate-seeking total",2858,877,1981,-2
174899,The College of Saint Scholastica,2013,"All students, Undergraduate, Degree/certificate-seeking, First-time",432,137,295,-2
174899,The College of Saint Scholastica,2013,"All students, Undergraduate, Other degree/certificate-seeking",2426,740,1686,-2
174899,The College of Saint Scholastica,2013,"All students, Undergraduate, Other degree/certifcate-seeking, Transfer-ins",449,104,345,-2
174899,The College of Saint Scholastica,2013,"All students, Undergraduate, Other degree/certifcate-seeking, Continuing",1977,636,1341,-2
174899,The College of Saint Scholastica,2013,"All students, Undergraduate, Non-degree/certificate-seeking",59,19,40,-2
174899,The College of Saint Scholastica,2013,"All students, Graduate",1289,303,986,-2
174914,University of St Thomas,2013,All students total,10192,5235,4957,-2
174914,University of St Thomas,2013,"All students, Undergraduate total",6321,3337,2984,-2
174914,University of St Thomas,2013,"All students, Undergraduate, Degree/certificate-seeking total",6246,3310,2936,-2
174914,University of St Thomas,2013,"All students, Undergraduate, Degree/certificate-seeking, First-time",1368,717,651,-2
174914,University of St Thomas,2013,"All students, Undergraduate, Other degree/certificate-seeking",4878,2593,2285,-2
174914,University of St Thomas,2013,"All students, Undergraduate, Other degree/certifcate-seeking, Transfer-ins",271,178,93,-2
174914,University of St Thomas,2013,"All students, Undergraduate, Other degree/certifcate-seeking, Continuing",4607,2415,2192,-2
174914,University of St Thomas,2013,"All students, Undergraduate, Non-degree/certificate-seeking",75,27,48,-2
174914,University of St Thomas,2013,"All students, Graduate",3871,1898,1973,-2
174932,College of Visual Arts,2013,,,,,-2
175005,St Catherine University,2013,All students total,5017,273,4744,-2
175005,St Catherine University,2013,"All students, Undergraduate total",3559,123,3436,-2
175005,St Catherine University,2013,"All students, Undergraduate, Degree/certificate-seeking total",3479,115,3364,-2
175005,St Catherine University,2013,"All students, Undergraduate, Degree/certificate-seeking, First-time",444,8,436,-2
175005,St Catherine University,2013,"All students, Undergraduate, Other degree/certificate-seeking",3035,107,2928,-2
175005,St Catherine University,2013,"All students, Undergraduate, Other degree/certifcate-seeking, Transfer-ins",609,39,570,-2
175005,St Catherine University,2013,"All students, Undergraduate, Other degree/certifcate-seeking, Continuing",2426,68,2358,-2
175005,St Catherine University,2013,"All students, Undergraduate, Non-degree/certificate-seeking",80,8,72,-2
175005,St Catherine University,2013,"All students, Graduate",1458,150,1308,-2
175014,Rasmussen College-Minnesota,2013,All students total,5485,1285,4200,-2
175014,Rasmussen College-Minnesota,2013,"All students, Undergraduate total",5485,1285,4200,-2
175014,Rasmussen College-Minnesota,2013,"All students, Undergraduate, Degree/certificate-seeking total",4742,1268,3474,-2
175014,Rasmussen College-Minnesota,2013,"All students, Undergraduate, Degree/certificate-seeking, First-time",207,54,153,-2
175014,Rasmussen College-Minnesota,2013,"All students, Undergraduate, Other degree/certificate-seeking",4535,1214,3321,-2
175014,Rasmussen College-Minnesota,2013,"All students, Undergraduate, Other degree/certifcate-seeking, Transfer-ins",1010,251,759,-2
175014,Rasmussen College-Minnesota,2013,"All students, Undergraduate, Other degree/certifcate-seeking, Continuing",3525,963,2562,-2
175014,Rasmussen College-Minnesota,2013,"All students, Undergraduate, Non-degree/certificate-seeking",743,17,726,-2
175078,Southwest Minnesota State University,2013,All students total,6917,2819,4098,-2
175078,Southwest Minnesota State University,2013,"All students, Undergraduate total",6467,2658,3809,-2
175078,Southwest Minnesota State University,2013,"All students, Undergraduate, Degree/certificate-seeking total",2426,1000,1426,-2
175078,Southwest Minnesota State University,2013,"All students, Undergraduate, Degree/certificate-seeking, First-time",449,195,254,-2
175078,Southwest Minnesota State University,2013,"All students, Undergraduate, Other degree/certificate-seeking",1977,805,1172,-2
175078,Southwest Minnesota State University,2013,"All students, Undergraduate, Other degree/certifcate-seeking, Transfer-ins",244,96,148,-2
175078,Southwest Minnesota State University,2013,"All students, Undergraduate, Other degree/certifcate-seeking, Continuing",1733,709,1024,-2
175078,Southwest Minnesota State University,2013,"All students, Undergraduate, Non-degree/certificate-seeking",4041,1658,2383,-2
175078,Southwest Minnesota State University,2013,"All students, Graduate",450,161,289,-2
175139,United Theological Seminary of the Twin Cities,2013,All students total,128,38,90,-2
175139,United Theological Seminary of the Twin Cities,2013,"All students, Graduate",128,38,90,-2
175227,Dunwoody College of Technology,2013,All students total,1071,940,131,-2
175227,Dunwoody College of Technology,2013,"All students, Undergraduate total",1071,940,131,-2
175227,Dunwoody College of Technology,2013,"All students, Undergraduate, Degree/certificate-seeking total",1065,935,130,-2
175227,Dunwoody College of Technology,2013,"All students, Undergraduate, Degree/certificate-seeking, First-time",204,191,13,-2
175227,Dunwoody College of Technology,2013,"All students, Undergraduate, Other degree/certificate-seeking",861,744,117,-2
175227,Dunwoody College of Technology,2013,"All students, Undergraduate, Other degree/certifcate-seeking, Transfer-ins",219,191,28,-2
175227,Dunwoody College of Technology,2013,"All students, Undergraduate, Other degree/certifcate-seeking, Continuing",642,553,89,-2
175227,Dunwoody College of Technology,2013,"All students, Undergraduate, Non-degree/certificate-seeking",6,5,1,-2
175272,Winona State University,2013,All students total,8782,3340,5442,-2
175272,Winona State University,2013,"All students, Undergraduate total",8253,3206,5047,-2
175272,Winona State University,2013,"All students, Undergraduate, Degree/certificate-seeking total",8079,3139,4940,-2
175272,Winona State University,2013,"All students, Undergraduate, Degree/certificate-seeking, First-time",1641,583,1058,-2
175272,Winona State University,2013,"All students, Undergraduate, Other degree/certificate-seeking",6438,2556,3882,-2
175272,Winona State University,2013,"All students, Undergraduate, Other degree/certifcate-seeking, Transfer-ins",576,250,326,-2
175272,Winona State University,2013,"All students, Undergraduate, Other degree/certifcate-seeking, Continuing",5862,2306,3556,-2
175272,Winona State University,2013,"All students, Undergraduate, Non-degree/certificate-seeking",174,67,107,-2
175272,Winona State University,2013,"All students, Graduate",529,134,395,-2
175281,William Mitchell College of Law,2013,All students total,813,399,414,-2
175281,William Mitchell College of Law,2013,"All students, Graduate",813,399,414,-2
180814,Bellevue University,2013,All students total,9788,4719,5069,-2
180814,Bellevue University,2013,"All students, Undergraduate total",6202,3075,3127,-2
180814,Bellevue University,2013,"All students, Undergraduate, Degree/certificate-seeking total",6134,3039,3095,-2
180814,Bellevue University,2013,"All students, Undergraduate, Degree/certificate-seeking, First-time",124,62,62,-2
180814,Bellevue University,2013,"All students, Undergraduate, Other degree/certificate-seeking",6010,2977,3033,-2
180814,Bellevue University,2013,"All students, Undergraduate, Other degree/certifcate-seeking, Transfer-ins",2935,1421,1514,-2
180814,Bellevue University,2013,"All students, Undergraduate, Other degree/certifcate-seeking, Continuing",3075,1556,1519,-2
180814,Bellevue University,2013,"All students, Undergraduate, Non-degree/certificate-seeking",68,36,32,-2
180814,Bellevue University,2013,"All students, Graduate",3586,1644,1942,-2
180832,Clarkson College,2013,All students total,1238,160,1078,-2
180832,Clarkson College,2013,"All students, Undergraduate total",780,104,676,-2
180832,Clarkson College,2013,"All students, Undergraduate, Degree/certificate-seeking total",778,103,675,-2
180832,Clarkson College,2013,"All students, Undergraduate, Degree/certificate-seeking, First-time",36,2,34,-2
180832,Clarkson College,2013,"All students, Undergraduate, Other degree/certificate-seeking",742,101,641,-2
180832,Clarkson College,2013,"All students, Undergraduate, Other degree/certifcate-seeking, Transfer-ins",166,29,137,-2
180832,Clarkson College,2013,"All students, Undergraduate, Other degree/certifcate-seeking, Continuing",576,72,504,-2
180832,Clarkson College,2013,"All students, Undergraduate, Non-degree/certificate-seeking",2,1,1,-2
180832,Clarkson College,2013,"All students, Graduate",458,56,402,-2
180878,Bryan College of Health Sciences,2013,All students total,711,80,631,-2
180878,Bryan College of Health Sciences,2013,"All students, Undergraduate total",627,58,569,-2
180878,Bryan College of Health Sciences,2013,"All students, Undergraduate, Degree/certificate-seeking total",593,56,537,-2
180878,Bryan College of Health Sciences,2013,"All students, Undergraduate, Degree/certificate-seeking, First-time",37,5,32,-2
180878,Bryan College of Health Sciences,2013,"All students, Undergraduate, Other degree/certificate-seeking",556,51,505,-2
180878,Bryan College of Health Sciences,2013,"All students, Undergraduate, Other degree/certifcate-seeking, Transfer-ins",92,8,84,-2
180878,Bryan College of Health Sciences,2013,"All students, Undergraduate, Other degree/certifcate-seeking, Continuing",464,43,421,-2
180878,Bryan College of Health Sciences,2013,"All students, Undergraduate, Non-degree/certificate-seeking",34,2,32,-2
180878,Bryan College of Health Sciences,2013,"All students, Graduate",84,22,62,-2
180948,Chadron State College,2013,All students total,3056,1295,1761,-2
180948,Chadron State College,2013,"All students, Undergraduate total",2432,1035,1397,-2
180948,Chadron State College,2013,"All students, Undergraduate, Degree/certificate-seeking total",2131,912,1219,-2
180948,Chadron State College,2013,"All students, Undergraduate, Degree/certificate-seeking, First-time",463,229,234,-2
180948,Chadron State College,2013,"All students, Undergraduate, Other degree/certificate-seeking",1668,683,985,-2
180948,Chadron State College,2013,"All students, Undergraduate, Other degree/certifcate-seeking, Transfer-ins",175,67,108,-2
180948,Chadron State College,2013,"All students, Undergraduate, Other degree/certifcate-seeking, Continuing",1493,616,877,-2
180948,Chadron State College,2013,"All students, Undergraduate, Non-degree/certificate-seeking",301,123,178,-2
180948,Chadron State College,2013,"All students, Graduate",624,260,364,-2
180984,Concordia University-Nebraska,2013,All students total,2206,892,1314,-2
180984,Concordia University-Nebraska,2013,"All students, Undergraduate total",1508,742,766,-2
180984,Concordia University-Nebraska,2013,"All students, Undergraduate, Degree/certificate-seeking total",1185,594,591,-2
180984,Concordia University-Nebraska,2013,"All students, Undergraduate, Degree/certificate-seeking, First-time",282,153,129,-2
180984,Concordia University-Nebraska,2013,"All students, Undergraduate, Other degree/certificate-seeking",903,441,462,-2
180984,Concordia University-Nebraska,2013,"All students, Undergraduate, Other degree/certifcate-seeking, Transfer-ins",61,37,24,-2
180984,Concordia University-Nebraska,2013,"All students, Undergraduate, Other degree/certifcate-seeking, Continuing",842,404,438,-2
180984,Concordia University-Nebraska,2013,"All students, Undergraduate, Non-degree/certificate-seeking",323,148,175,-2
180984,Concordia University-Nebraska,2013,"All students, Graduate",698,150,548,-2
181002,Creighton University,2013,All students total,8019,3465,4554,-2
181002,Creighton University,2013,"All students, Undergraduate total",4076,1664,2412,-2
181002,Creighton University,2013,"All students, Undergraduate, Degree/certificate-seeking total",3943,1586,2357,-2
181002,Creighton University,2013,"All students, Undergraduate, Degree/certificate-seeking, First-time",966,383,583,-2
181002,Creighton University,2013,"All students, Undergraduate, Other degree/certificate-seeking",2977,1203,1774,-2
181002,Creighton University,2013,"All students, Undergraduate, Other degree/certifcate-seeking, Transfer-ins",166,56,110,-2
181002,Creighton University,2013,"All students, Undergraduate, Other degree/certifcate-seeking, Continuing",2811,1147,1664,-2
181002,Creighton University,2013,"All students, Undergraduate, Non-degree/certificate-seeking",133,78,55,-2
181002,Creighton University,2013,"All students, Graduate",3943,1801,2142,-2
181020,Doane College-Crete,2013,All students total,1113,556,557,-2
181020,Doane College-Crete,2013,"All students, Undergraduate total",1113,556,557,-2
181020,Doane College-Crete,2013,"All students, Undergraduate, Degree/certificate-seeking total",1111,556,555,-2
181020,Doane College-Crete,2013,"All students, Undergraduate, Degree/certificate-seeking, First-time",287,150,137,-2
181020,Doane College-Crete,2013,"All students, Undergraduate, Other degree/certificate-seeking",824,406,418,-2
181020,Doane College-Crete,2013,"All students, Undergraduate, Other degree/certifcate-seeking, Transfer-ins",50,36,14,-2
181020,Doane College-Crete,2013,"All students, Undergraduate, Other degree/certifcate-seeking, Continuing",774,370,404,-2
181020,Doane College-Crete,2013,"All students, Undergraduate, Non-degree/certificate-seeking",2,0,2,-2
181093,Grace University,2013,All students total,481,221,260,-2
181093,Grace University,2013,"All students, Undergraduate total",410,196,214,-2
181093,Grace University,2013,"All students, Undergraduate, Degree/certificate-seeking total",410,196,214,-2
181093,Grace University,2013,"All students, Undergraduate, Degree/certificate-seeking, First-time",97,38,59,-2
181093,Grace University,2013,"All students, Undergraduate, Other degree/certificate-seeking",313,158,155,-2
181093,Grace University,2013,"All students, Undergraduate, Other degree/certifcate-seeking, Transfer-ins",63,43,20,-2
181093,Grace University,2013,"All students, Undergraduate, Other degree/certifcate-seeking, Continuing",250,115,135,-2
181093,Grace University,2013,"All students, Graduate",71,25,46,-2
181127,Hastings College,2013,All students total,1144,583,561,-2
181127,Hastings College,2013,"All students, Undergraduate total",1118,571,547,-2
181127,Hastings College,2013,"All students, Undergraduate, Degree/certificate-seeking total",1060,545,515,-2
181127,Hastings College,2013,"All students, Undergraduate, Degree/certificate-seeking, First-time",345,180,165,-2
181127,Hastings College,2013,"All students, Undergraduate, Other degree/certificate-seeking",715,365,350,-2
181127,Hastings College,2013,"All students, Undergraduate, Other degree/certifcate-seeking, Transfer-ins",48,27,21,-2
181127,Hastings College,2013,"All students, Undergraduate, Other degree/certifcate-seeking, Continuing",667,338,329,-2
181127,Hastings College,2013,"All students, Undergraduate, Non-degree/certificate-seeking",58,26,32,-2
181127,Hastings College,2013,"All students, Graduate",26,12,14,-2
181215,University of Nebraska at Kearney,2013,All students total,7052,2838,4214,-2
181215,University of Nebraska at Kearney,2013,"All students, Undergraduate total",5502,2339,3163,-2
181215,University of Nebraska at Kearney,2013,"All students, Undergraduate, Degree/certificate-seeking total",5247,2228,3019,-2
181215,University of Nebraska at Kearney,2013,"All students, Undergraduate, Degree/certificate-seeking, First-time",1022,431,591,-2
181215,University of Nebraska at Kearney,2013,"All students, Undergraduate, Other degree/certificate-seeking",4225,1797,2428,-2
181215,University of Nebraska at Kearney,2013,"All students, Undergraduate, Other degree/certifcate-seeking, Transfer-ins",342,134,208,-2
181215,University of Nebraska at Kearney,2013,"All students, Undergraduate, Other degree/certifcate-seeking, Continuing",3883,1663,2220,-2
181215,University of Nebraska at Kearney,2013,"All students, Undergraduate, Non-degree/certificate-seeking",255,111,144,-2
181215,University of Nebraska at Kearney,2013,"All students, Graduate",1550,499,1051,-2
181242,Kaplan University-Lincoln Campus,2013,All students total,501,122,379,-2
181242,Kaplan University-Lincoln Campus,2013,"All students, Undergraduate total",472,111,361,-2
181242,Kaplan University-Lincoln Campus,2013,"All students, Undergraduate, Degree/certificate-seeking total",471,111,360,-2
181242,Kaplan University-Lincoln Campus,2013,"All students, Undergraduate, Degree/certificate-seeking, First-time",37,7,30,-2
181242,Kaplan University-Lincoln Campus,2013,"All students, Undergraduate, Other degree/certificate-seeking",434,104,330,-2
181242,Kaplan University-Lincoln Campus,2013,"All students, Undergraduate, Other degree/certifcate-seeking, Transfer-ins",155,36,119,-2
181242,Kaplan University-Lincoln Campus,2013,"All students, Undergraduate, Other degree/certifcate-seeking, Continuing",279,68,211,-2
181242,Kaplan University-Lincoln Campus,2013,"All students, Undergraduate, Non-degree/certificate-seeking",1,0,1,-2
181242,Kaplan University-Lincoln Campus,2013,"All students, Graduate",29,11,18,-2
181297,Nebraska Methodist College of Nursing & Allied Health,2013,All students total,943,92,851,-2
181297,Nebraska Methodist College of Nursing & Allied Health,2013,"All students, Undergraduate total",742,67,675,-2
181297,Nebraska Methodist College of Nursing & Allied Health,2013,"All students, Undergraduate, Degree/certificate-seeking total",740,66,674,-2
181297,Nebraska Methodist College of Nursing & Allied Health,2013,"All students, Undergraduate, Degree/certificate-seeking, First-time",44,4,40,-2
181297,Nebraska Methodist College of Nursing & Allied Health,2013,"All students, Undergraduate, Other degree/certificate-seeking",696,62,634,-2
181297,Nebraska Methodist College of Nursing & Allied Health,2013,"All students, Undergraduate, Other degree/certifcate-seeking, Transfer-ins",154,12,142,-2
181297,Nebraska Methodist College of Nursing & Allied Health,2013,"All students, Undergraduate, Other degree/certifcate-seeking, Continuing",542,50,492,-2
181297,Nebraska Methodist College of Nursing & Allied Health,2013,"All students, Undergraduate, Non-degree/certificate-seeking",2,1,1,-2
181297,Nebraska Methodist College of Nursing & Allied Health,2013,"All students, Graduate",201,25,176,-2
181330,Midland University,2013,All students total,1288,647,641,-2
181330,Midland University,2013,"All students, Undergraduate total",1192,601,591,-2
181330,Midland University,2013,"All students, Undergraduate, Degree/certificate-seeking total",1189,599,590,-2
181330,Midland University,2013,"All students, Undergraduate, Degree/certificate-seeking, First-time",367,208,159,-2
181330,Midland University,2013,"All students, Undergraduate, Other degree/certificate-seeking",822,391,431,-2
181330,Midland University,2013,"All students, Undergraduate, Other degree/certifcate-seeking, Transfer-ins",125,70,55,-2
181330,Midland University,2013,"All students, Undergraduate, Other degree/certifcate-seeking, Continuing",697,321,376,-2
181330,Midland University,2013,"All students, Undergraduate, Non-degree/certificate-seeking",3,2,1,-2
181330,Midland University,2013,"All students, Graduate",96,46,50,-2
181376,Nebraska Christian College,2013,All students total,150,82,68,-2
181376,Nebraska Christian College,2013,"All students, Undergraduate total",150,82,68,-2
181376,Nebraska Christian College,2013,"All students, Undergraduate, Degree/certificate-seeking total",150,82,68,-2
181376,Nebraska Christian College,2013,"All students, Undergraduate, Degree/certificate-seeking, First-time",56,34,22,-2
181376,Nebraska Christian College,2013,"All students, Undergraduate, Other degree/certificate-seeking",94,48,46,-2
181376,Nebraska Christian College,2013,"All students, Undergraduate, Other degree/certifcate-seeking, Transfer-ins",15,7,8,-2
181376,Nebraska Christian College,2013,"All students, Undergraduate, Other degree/certifcate-seeking, Continuing",79,41,38,-2
181394,University of Nebraska at Omaha,2013,All students total,15227,7211,8016,-2
181394,University of Nebraska at Omaha,2013,"All students, Undergraduate total",12335,5960,6375,-2
181394,University of Nebraska at Omaha,2013,"All students, Undergraduate, Degree/certificate-seeking total",12153,5859,6294,-2
181394,University of Nebraska at Omaha,2013,"All students, Undergraduate, Degree/certificate-seeking, First-time",1889,896,993,-2
181394,University of Nebraska at Omaha,2013,"All students, Undergraduate, Other degree/certificate-seeking",10264,4963,5301,-2
181394,University of Nebraska at Omaha,2013,"All students, Undergraduate, Other degree/certifcate-seeking, Transfer-ins",1356,636,720,-2
181394,University of Nebraska at Omaha,2013,"All students, Undergraduate, Other degree/certifcate-seeking, Continuing",8908,4327,4581,-2
181394,University of Nebraska at Omaha,2013,"All students, Undergraduate, Non-degree/certificate-seeking",182,101,81,-2
181394,University of Nebraska at Omaha,2013,"All students, Graduate",2892,1251,1641,-2
181400,Kaplan University-Omaha Campus,2013,All students total,795,162,633,-2
181400,Kaplan University-Omaha Campus,2013,"All students, Undergraduate total",728,144,584,-2
181400,Kaplan University-Omaha Campus,2013,"All students, Undergraduate, Degree/certificate-seeking total",728,144,584,-2
181400,Kaplan University-Omaha Campus,2013,"All students, Undergraduate, Degree/certificate-seeking, First-time",93,19,74,-2
181400,Kaplan University-Omaha Campus,2013,"All students, Undergraduate, Other degree/certificate-seeking",635,125,510,-2
181400,Kaplan University-Omaha Campus,2013,"All students, Undergraduate, Other degree/certifcate-seeking, Transfer-ins",195,29,166,-2
181400,Kaplan University-Omaha Campus,2013,"All students, Undergraduate, Other degree/certifcate-seeking, Continuing",440,96,344,-2
181400,Kaplan University-Omaha Campus,2013,"All students, Graduate",67,18,49,-2
181428,University of Nebraska Medical Center,2013,All students total,3681,1326,2355,-2
181428,University of Nebraska Medical Center,2013,"All students, Undergraduate total",835,103,732,-2
181428,University of Nebraska Medical Center,2013,"All students, Undergraduate, Degree/certificate-seeking total",810,100,710,-2
181428,University of Nebraska Medical Center,2013,"All students, Undergraduate, Other degree/certificate-seeking",810,100,710,-2
181428,University of Nebraska Medical Center,2013,"All students, Undergraduate, Other degree/certifcate-seeking, Transfer-ins",408,49,359,-2
181428,University of Nebraska Medical Center,2013,"All students, Undergraduate, Other degree/certifcate-seeking, Continuing",402,51,351,-2
181428,University of Nebraska Medical Center,2013,"All students, Undergraduate, Non-degree/certificate-seeking",25,3,22,-2
181428,University of Nebraska Medical Center,2013,"All students, Graduate",2846,1223,1623,-2
181446,Nebraska Wesleyan University,2013,All students total,2149,771,1378,-2
181446,Nebraska Wesleyan University,2013,"All students, Undergraduate total",1927,729,1198,-2
181446,Nebraska Wesleyan University,2013,"All students, Undergraduate, Degree/certificate-seeking total",1892,715,1177,-2
181446,Nebraska Wesleyan University,2013,"All students, Undergraduate, Degree/certificate-seeking, First-time",379,172,207,-2
181446,Nebraska Wesleyan University,2013,"All students, Undergraduate, Other degree/certificate-seeking",1513,543,970,-2
181446,Nebraska Wesleyan University,2013,"All students, Undergraduate, Other degree/certifcate-seeking, Transfer-ins",98,35,63,-2
181446,Nebraska Wesleyan University,2013,"All students, Undergraduate, Other degree/certifcate-seeking, Continuing",1415,508,907,-2
181446,Nebraska Wesleyan University,2013,"All students, Undergraduate, Non-degree/certificate-seeking",35,14,21,-2
181446,Nebraska Wesleyan University,2013,"All students, Graduate",222,42,180,-2
181464,University of Nebraska-Lincoln,2013,All students total,24445,12892,11553,-2
181464,University of Nebraska-Lincoln,2013,"All students, Undergraduate total",19376,10438,8938,-2
181464,University of Nebraska-Lincoln,2013,"All students, Undergraduate, Degree/certificate-seeking total",19376,10438,8938,-2
181464,University of Nebraska-Lincoln,2013,"All students, Undergraduate, Degree/certificate-seeking, First-time",4420,2259,2161,-2
181464,University of Nebraska-Lincoln,2013,"All students, Undergraduate, Other degree/certificate-seeking",14956,8179,6777,-2
181464,University of Nebraska-Lincoln,2013,"All students, Undergraduate, Other degree/certifcate-seeking, Transfer-ins",995,530,465,-2
181464,University of Nebraska-Lincoln,2013,"All students, Undergraduate, Other degree/certifcate-seeking, Continuing",13961,7649,6312,-2
181464,University of Nebraska-Lincoln,2013,"All students, Graduate",5069,2454,2615,-2
181534,Peru State College,2013,All students total,2422,948,1474,-2
181534,Peru State College,2013,"All students, Undergraduate total",2158,879,1279,-2
181534,Peru State College,2013,"All students, Undergraduate, Degree/certificate-seeking total",1534,648,886,-2
181534,Peru State College,2013,"All students, Undergraduate, Degree/certificate-seeking, First-time",278,118,160,-2
181534,Peru State College,2013,"All students, Undergraduate, Other degree/certificate-seeking",1256,530,726,-2
181534,Peru State College,2013,"All students, Undergraduate, Other degree/certifcate-seeking, Transfer-ins",206,92,114,-2
181534,Peru State College,2013,"All students, Undergraduate, Other degree/certifcate-seeking, Continuing",1050,438,612,-2
181534,Peru State College,2013,"All students, Undergraduate, Non-degree/certificate-seeking",624,231,393,-2
181534,Peru State College,2013,"All students, Graduate",264,69,195,-2
181543,Summit Christian College,2013,All students total,29,14,15,-2
181543,Summit Christian College,2013,"All students, Undergraduate total",29,14,15,-2
181543,Summit Christian College,2013,"All students, Undergraduate, Degree/certificate-seeking total",29,14,15,-2
181543,Summit Christian College,2013,"All students, Undergraduate, Degree/certificate-seeking, First-time",4,3,1,-2
181543,Summit Christian College,2013,"All students, Undergraduate, Other degree/certificate-seeking",25,11,14,-2
181543,Summit Christian College,2013,"All students, Undergraduate, Other degree/certifcate-seeking, Transfer-ins",4,3,1,-2
181543,Summit Christian College,2013,"All students, Undergraduate, Other degree/certifcate-seeking, Continuing",21,8,13,-2
181604,College of Saint Mary,2013,All students total,970,32,938,-2
181604,College of Saint Mary,2013,"All students, Undergraduate total",735,11,724,-2
181604,College of Saint Mary,2013,"All students, Undergraduate, Degree/certificate-seeking total",691,0,691,-2
181604,College of Saint Mary,2013,"All students, Undergraduate, Degree/certificate-seeking, First-time",89,0,89,-2
181604,College of Saint Mary,2013,"All students, Undergraduate, Other degree/certificate-seeking",602,0,602,-2
181604,College of Saint Mary,2013,"All students, Undergraduate, Other degree/certifcate-seeking, Transfer-ins",149,0,149,-2
181604,College of Saint Mary,2013,"All students, Undergraduate, Other degree/certifcate-seeking, Continuing",453,0,453,-2
181604,College of Saint Mary,2013,"All students, Undergraduate, Non-degree/certificate-seeking",44,11,33,-2
181604,College of Saint Mary,2013,"All students, Graduate",235,21,214,-2
181738,Union College,2013,All students total,911,368,543,-2
181738,Union College,2013,"All students, Undergraduate total",821,349,472,-2
181738,Union College,2013,"All students, Undergraduate, Degree/certificate-seeking total",759,327,432,-2
181738,Union College,2013,"All students, Undergraduate, Degree/certificate-seeking, First-time",178,76,102,-2
181738,Union College,2013,"All students, Undergraduate, Other degree/certificate-seeking",581,251,330,-2
181738,Union College,2013,"All students, Undergraduate, Other degree/certifcate-seeking, Transfer-ins",56,20,36,-2
181738,Union College,2013,"All students, Undergraduate, Other degree/certifcate-seeking, Continuing",525,231,294,-2
181738,Union College,2013,"All students, Undergraduate, Non-degree/certificate-seeking",62,22,40,-2
181738,Union College,2013,"All students, Graduate",90,19,71,-2
181747,University of Nebraska-Central Administration System Office,2013,,,,,-2
181783,Wayne State College,2013,All students total,3506,1508,1998,-2
181783,Wayne State College,2013,"All students, Undergraduate total",2991,1277,1714,-2
181783,Wayne State College,2013,"All students, Undergraduate, Degree/certificate-seeking total",2900,1240,1660,-2
181783,Wayne State College,2013,"All students, Undergraduate, Degree/certificate-seeking, First-time",691,293,398,-2
181783,Wayne State College,2013,"All students, Undergraduate, Other degree/certificate-seeking",2209,947,1262,-2
181783,Wayne State College,2013,"All students, Undergraduate, Other degree/certifcate-seeking, Transfer-ins",184,80,104,-2
181783,Wayne State College,2013,"All students, Undergraduate, Other degree/certifcate-seeking, Continuing",2025,867,1158,-2
181783,Wayne State College,2013,"All students, Undergraduate, Non-degree/certificate-seeking",91,37,54,-2
181783,Wayne State College,2013,"All students, Graduate",515,231,284,-2
181853,York College,2013,All students total,470,254,216,-2
181853,York College,2013,"All students, Undergraduate total",459,247,212,-2
181853,York College,2013,"All students, Undergraduate, Degree/certificate-seeking total",456,246,210,-2
181853,York College,2013,"All students, Undergraduate, Degree/certificate-seeking, First-time",94,52,42,-2
181853,York College,2013,"All students, Undergraduate, Other degree/certificate-seeking",362,194,168,-2
181853,York College,2013,"All students, Undergraduate, Other degree/certifcate-seeking, Transfer-ins",59,36,23,-2
181853,York College,2013,"All students, Undergraduate, Other degree/certifcate-seeking, Continuing",303,158,145,-2
181853,York College,2013,"All students, Undergraduate, Non-degree/certificate-seeking",3,1,2,-2
181853,York College,2013,"All students, Graduate",11,7,4,-2
182634,Colby-Sawyer College,2013,All students total,1409,419,990,-2
182634,Colby-Sawyer College,2013,"All students, Undergraduate total",1409,419,990,-2
182634,Colby-Sawyer College,2013,"All students, Undergraduate, Degree/certificate-seeking total",1395,413,982,-2
182634,Colby-Sawyer College,2013,"All students, Undergraduate, Degree/certificate-seeking, First-time",399,120,279,-2
182634,Colby-Sawyer College,2013,"All students, Undergraduate, Other degree/certificate-seeking",996,293,703,-2
182634,Colby-Sawyer College,2013,"All students, Undergraduate, Other degree/certifcate-seeking, Transfer-ins",24,13,11,-2
182634,Colby-Sawyer College,2013,"All students, Undergraduate, Other degree/certifcate-seeking, Continuing",972,280,692,-2
182634,Colby-Sawyer College,2013,"All students, Undergraduate, Non-degree/certificate-seeking",14,6,8,-2
182661,Daniel Webster College,2013,All students total,764,552,212,-2
182661,Daniel Webster College,2013,"All students, Undergraduate total",632,498,134,-2
182661,Daniel Webster College,2013,"All students, Undergraduate, Degree/certificate-seeking total",626,493,133,-2
182661,Daniel Webster College,2013,"All students, Undergraduate, Degree/certificate-seeking, First-time",164,131,33,-2
182661,Daniel Webster College,2013,"All students, Undergraduate, Other degree/certificate-seeking",462,362,100,-2
182661,Daniel Webster College,2013,"All students, Undergraduate, Other degree/certifcate-seeking, Transfer-ins",61,44,17,-2
182661,Daniel Webster College,2013,"All students, Undergraduate, Other degree/certifcate-seeking, Continuing",401,318,83,-2
182661,Daniel Webster College,2013,"All students, Undergraduate, Non-degree/certificate-seeking",6,5,1,-2
182661,Daniel Webster College,2013,"All students, Graduate",132,54,78,-2
182670,Dartmouth College,2013,All students total,6342,3378,2964,-2
182670,Dartmouth College,2013,"All students, Undergraduate total",4276,2179,2097,-2
182670,Dartmouth College,2013,"All students, Undergraduate, Degree/certificate-seeking total",4154,2115,2039,-2
182670,Dartmouth College,2013,"All students, Undergraduate, Degree/certificate-seeking, First-time",1109,545,564,-2
182670,Dartmouth College,2013,"All students, Undergraduate, Other degree/certificate-seeking",3045,1570,1475,-2
182670,Dartmouth College,2013,"All students, Undergraduate, Other degree/certifcate-seeking, Transfer-ins",3,1,2,-2
182670,Dartmouth College,2013,"All students, Undergraduate, Other degree/certifcate-seeking, Continuing",3042,1569,1473,-2
182670,Dartmouth College,2013,"All students, Undergraduate, Non-degree/certificate-seeking",122,64,58,-2
182670,Dartmouth College,2013,"All students, Graduate",2066,1199,867,-2
182795,Franklin Pierce University,2013,All students total,2204,946,1258,-2
182795,Franklin Pierce University,2013,"All students, Undergraduate total",1671,740,931,-2
182795,Franklin Pierce University,2013,"All students, Undergraduate, Degree/certificate-seeking total",1664,738,926,-2
182795,Franklin Pierce University,2013,"All students, Undergraduate, Degree/certificate-seeking, First-time",450,219,231,-2
182795,Franklin Pierce University,2013,"All students, Undergraduate, Other degree/certificate-seeking",1214,519,695,-2
182795,Franklin Pierce University,2013,"All students, Undergraduate, Other degree/certifcate-seeking, Transfer-ins",71,29,42,-2
182795,Franklin Pierce University,2013,"All students, Undergraduate, Other degree/certifcate-seeking, Continuing",1143,490,653,-2
182795,Franklin Pierce University,2013,"All students, Undergraduate, Non-degree/certificate-seeking",7,2,5,-2
182795,Franklin Pierce University,2013,"All students, Graduate",533,206,327,-2
182829,University of New Hampshire-School of Law,2013,All students total,315,185,130,-2
182829,University of New Hampshire-School of Law,2013,"All students, Graduate",315,185,130,-2
182865,Mount Washington College,2013,All students total,2284,705,1579,-2
182865,Mount Washington College,2013,"All students, Undergraduate total",2284,705,1579,-2
182865,Mount Washington College,2013,"All students, Undergraduate, Degree/certificate-seeking total",2273,698,1575,-2
182865,Mount Washington College,2013,"All students, Undergraduate, Degree/certificate-seeking, First-time",126,46,80,-2
182865,Mount Washington College,2013,"All students, Undergraduate, Other degree/certificate-seeking",2147,652,1495,-2
182865,Mount Washington College,2013,"All students, Undergraduate, Other degree/certifcate-seeking, Transfer-ins",402,121,281,-2
182865,Mount Washington College,2013,"All students, Undergraduate, Other degree/certifcate-seeking, Continuing",1745,531,1214,-2
182865,Mount Washington College,2013,"All students, Undergraduate, Non-degree/certificate-seeking",11,7,4,-2
182917,College of St Mary Magdalen,2013,,,,,-2
182980,New England College,2013,All students total,2224,924,1300,-2
182980,New England College,2013,"All students, Undergraduate total",1478,667,811,-2
182980,New England College,2013,"All students, Undergraduate, Degree/certificate-seeking total",1465,661,804,-2
182980,New England College,2013,"All students, Undergraduate, Degree/certificate-seeking, First-time",383,182,201,-2
182980,New England College,2013,"All students, Undergraduate, Other degree/certificate-seeking",1082,479,603,-2
182980,New England College,2013,"All students, Undergraduate, Other degree/certifcate-seeking, Transfer-ins",150,49,101,-2
182980,New England College,2013,"All students, Undergraduate, Other degree/certifcate-seeking, Continuing",932,430,502,-2
182980,New England College,2013,"All students, Undergraduate, Non-degree/certificate-seeking",13,6,7,-2
182980,New England College,2013,"All students, Graduate",746,257,489,-2
183026,Southern New Hampshire University,2013,All students total,28389,11456,16933,-2
183026,Southern New Hampshire University,2013,"All students, Undergraduate total",18083,7237,10846,-2
183026,Southern New Hampshire University,2013,"All students, Undergraduate, Degree/certificate-seeking total",17172,6906,10266,-2
183026,Southern New Hampshire University,2013,"All students, Undergraduate, Degree/certificate-seeking, First-time",1965,819,1146,-2
183026,Southern New Hampshire University,2013,"All students, Undergraduate, Other degree/certificate-seeking",15207,6087,9120,-2
183026,Southern New Hampshire University,2013,"All students, Undergraduate, Other degree/certifcate-seeking, Transfer-ins",2677,1011,1666,-2
183026,Southern New Hampshire University,2013,"All students, Undergraduate, Other degree/certifcate-seeking, Continuing",12530,5076,7454,-2
183026,Southern New Hampshire University,2013,"All students, Undergraduate, Non-degree/certificate-seeking",911,331,580,-2
183026,Southern New Hampshire University,2013,"All students, Graduate",10306,4219,6087,-2
183044,University of New Hampshire-Main Campus,2013,All students total,14913,6788,8125,-2
183044,University of New Hampshire-Main Campus,2013,"All students, Undergraduate total",12516,5782,6734,-2
183044,University of New Hampshire-Main Campus,2013,"All students, Undergraduate, Degree/certificate-seeking total",12288,5654,6634,-2
183044,University of New Hampshire-Main Campus,2013,"All students, Undergraduate, Degree/certificate-seeking, First-time",2869,1308,1561,-2
183044,University of New Hampshire-Main Campus,2013,"All students, Undergraduate, Other degree/certificate-seeking",9419,4346,5073,-2
183044,University of New Hampshire-Main Campus,2013,"All students, Undergraduate, Other degree/certifcate-seeking, Transfer-ins",529,268,261,-2
183044,University of New Hampshire-Main Campus,2013,"All students, Undergraduate, Other degree/certifcate-seeking, Continuing",8890,4078,4812,-2
183044,University of New Hampshire-Main Campus,2013,"All students, Undergraduate, Non-degree/certificate-seeking",228,128,100,-2
183044,University of New Hampshire-Main Campus,2013,"All students, Graduate",2397,1006,1391,-2
183062,Keene State College,2013,All students total,4923,2084,2839,-2
183062,Keene State College,2013,"All students, Undergraduate total",4799,2056,2743,-2
183062,Keene State College,2013,"All students, Undergraduate, Degree/certificate-seeking total",4643,1971,2672,-2
183062,Keene State College,2013,"All students, Undergraduate, Degree/certificate-seeking, First-time",1258,511,747,-2
183062,Keene State College,2013,"All students, Undergraduate, Other degree/certificate-seeking",3385,1460,1925,-2
183062,Keene State College,2013,"All students, Undergraduate, Other degree/certifcate-seeking, Transfer-ins",150,76,74,-2
183062,Keene State College,2013,"All students, Undergraduate, Other degree/certifcate-seeking, Continuing",3235,1384,1851,-2
183062,Keene State College,2013,"All students, Undergraduate, Non-degree/certificate-seeking",156,85,71,-2
183062,Keene State College,2013,"All students, Graduate",124,28,96,-2
183071,University of New Hampshire at Manchester,2013,All students total,926,448,478,-2
183071,University of New Hampshire at Manchester,2013,"All students, Undergraduate total",833,427,406,-2
183071,University of New Hampshire at Manchester,2013,"All students, Undergraduate, Degree/certificate-seeking total",781,391,390,-2
183071,University of New Hampshire at Manchester,2013,"All students, Undergraduate, Degree/certificate-seeking, First-time",94,47,47,-2
183071,University of New Hampshire at Manchester,2013,"All students, Undergraduate, Other degree/certificate-seeking",687,344,343,-2
183071,University of New Hampshire at Manchester,2013,"All students, Undergraduate, Other degree/certifcate-seeking, Transfer-ins",163,84,79,-2
183071,University of New Hampshire at Manchester,2013,"All students, Undergraduate, Other degree/certifcate-seeking, Continuing",524,260,264,-2
183071,University of New Hampshire at Manchester,2013,"All students, Undergraduate, Non-degree/certificate-seeking",52,36,16,-2
183071,University of New Hampshire at Manchester,2013,"All students, Graduate",93,21,72,-2
183080,Plymouth State University,2013,All students total,5236,2500,2736,-2
183080,Plymouth State University,2013,"All students, Undergraduate total",4065,2121,1944,-2
183080,Plymouth State University,2013,"All students, Undergraduate, Degree/certificate-seeking total",3986,2064,1922,-2
183080,Plymouth State University,2013,"All students, Undergraduate, Degree/certificate-seeking, First-time",930,486,444,-2
183080,Plymouth State University,2013,"All students, Undergraduate, Other degree/certificate-seeking",3056,1578,1478,-2
183080,Plymouth State University,2013,"All students, Undergraduate, Other degree/certifcate-seeking, Transfer-ins",231,133,98,-2
183080,Plymouth State University,2013,"All students, Undergraduate, Other degree/certifcate-seeking, Continuing",2825,1445,1380,-2
183080,Plymouth State University,2013,"All students, Undergraduate, Non-degree/certificate-seeking",79,57,22,-2
183080,Plymouth State University,2013,"All students, Graduate",1171,379,792,-2
183211,Rivier University,2013,All students total,2346,441,1905,-2
183211,Rivier University,2013,"All students, Undergraduate total",1591,293,1298,-2
183211,Rivier University,2013,"All students, Undergraduate, Degree/certificate-seeking total",1524,277,1247,-2
183211,Rivier University,2013,"All students, Undergraduate, Degree/certificate-seeking, First-time",223,53,170,-2
183211,Rivier University,2013,"All students, Undergraduate, Other degree/certificate-seeking",1301,224,1077,-2
183211,Rivier University,2013,"All students, Undergraduate, Other degree/certifcate-seeking, Transfer-ins",146,24,122,-2
183211,Rivier University,2013,"All students, Undergraduate, Other degree/certifcate-seeking, Continuing",1155,200,955,-2
183211,Rivier University,2013,"All students, Undergraduate, Non-degree/certificate-seeking",67,16,51,-2
183211,Rivier University,2013,"All students, Graduate",755,148,607,-2
183239,Saint Anselm College,2013,All students total,1923,779,1144,-2
183239,Saint Anselm College,2013,"All students, Undergraduate total",1923,779,1144,-2
183239,Saint Anselm College,2013,"All students, Undergraduate, Degree/certificate-seeking total",1912,770,1142,-2
183239,Saint Anselm College,2013,"All students, Undergraduate, Degree/certificate-seeking, First-time",508,203,305,-2
183239,Saint Anselm College,2013,"All students, Undergraduate, Other degree/certificate-seeking",1404,567,837,-2
183239,Saint Anselm College,2013,"All students, Undergraduate, Other degree/certifcate-seeking, Transfer-ins",20,8,12,-2
183239,Saint Anselm College,2013,"All students, Undergraduate, Other degree/certifcate-seeking, Continuing",1384,559,825,-2
183239,Saint Anselm College,2013,"All students, Undergraduate, Non-degree/certificate-seeking",11,9,2,-2
183257,Granite State College,2013,All students total,2058,598,1460,-2
183257,Granite State College,2013,"All students, Undergraduate total",1723,520,1203,-2
183257,Granite State College,2013,"All students, Undergraduate, Degree/certificate-seeking total",1680,505,1175,-2
183257,Granite State College,2013,"All students, Undergraduate, Degree/certificate-seeking, First-time",98,19,79,-2
183257,Granite State College,2013,"All students, Undergraduate, Other degree/certificate-seeking",1582,486,1096,-2
183257,Granite State College,2013,"All students, Undergraduate, Other degree/certifcate-seeking, Transfer-ins",335,107,228,-2
183257,Granite State College,2013,"All students, Undergraduate, Other degree/certifcate-seeking, Continuing",1247,379,868,-2
183257,Granite State College,2013,"All students, Undergraduate, Non-degree/certificate-seeking",43,15,28,-2
183257,Granite State College,2013,"All students, Graduate",335,78,257,-2
183275,Thomas More College of Liberal Arts,2013,All students total,80,40,40,-2
183275,Thomas More College of Liberal Arts,2013,"All students, Undergraduate total",80,40,40,-2
183275,Thomas More College of Liberal Arts,2013,"All students, Undergraduate, Degree/certificate-seeking total",80,40,40,-2
183275,Thomas More College of Liberal Arts,2013,"All students, Undergraduate, Degree/certificate-seeking, First-time",14,6,8,-2
183275,Thomas More College of Liberal Arts,2013,"All students, Undergraduate, Other degree/certificate-seeking",66,34,32,-2
183275,Thomas More College of Liberal Arts,2013,"All students, Undergraduate, Other degree/certifcate-seeking, Transfer-ins",11,8,3,-2
183275,Thomas More College of Liberal Arts,2013,"All students, Undergraduate, Other degree/certifcate-seeking, Continuing",55,26,29,-2
183327,University System of New Hampshire System Office,2013,,,,,-2
183789,Berkeley College-Woodland Park,2013,All students total,3671,1067,2604,-2
183789,Berkeley College-Woodland Park,2013,"All students, Undergraduate total",3671,1067,2604,-2
183789,Berkeley College-Woodland Park,2013,"All students, Undergraduate, Degree/certificate-seeking total",3667,1067,2600,-2
183789,Berkeley College-Woodland Park,2013,"All students, Undergraduate, Degree/certificate-seeking, First-time",860,270,590,-2
183789,Berkeley College-Woodland Park,2013,"All students, Undergraduate, Other degree/certificate-seeking",2807,797,2010,-2
183789,Berkeley College-Woodland Park,2013,"All students, Undergraduate, Other degree/certifcate-seeking, Transfer-ins",844,170,674,-2
183789,Berkeley College-Woodland Park,2013,"All students, Undergraduate, Other degree/certifcate-seeking, Continuing",1963,627,1336,-2
183789,Berkeley College-Woodland Park,2013,"All students, Undergraduate, Non-degree/certificate-seeking",4,0,4,-2
183804,Beth Medrash Govoha,2013,All students total,6754,6754,0,-2
183804,Beth Medrash Govoha,2013,"All students, Undergraduate total",2766,2766,0,-2
183804,Beth Medrash Govoha,2013,"All students, Undergraduate, Degree/certificate-seeking total",2766,2766,0,-2
183804,Beth Medrash Govoha,2013,"All students, Undergraduate, Other degree/certificate-seeking",2766,2766,0,-2
183804,Beth Medrash Govoha,2013,"All students, Undergraduate, Other degree/certifcate-seeking, Transfer-ins",523,523,0,-2
183804,Beth Medrash Govoha,2013,"All students, Undergraduate, Other degree/certifcate-seeking, Continuing",2243,2243,0,-2
183804,Beth Medrash Govoha,2013,"All students, Graduate",3988,3988,0,-2
183822,Bloomfield College,2013,All students total,1979,688,1291,-2
183822,Bloomfield College,2013,"All students, Undergraduate total",1972,686,1286,-2
183822,Bloomfield College,2013,"All students, Undergraduate, Degree/certificate-seeking total",1906,674,1232,-2
183822,Bloomfield College,2013,"All students, Undergraduate, Degree/certificate-seeking, First-time",425,165,260,-2
183822,Bloomfield College,2013,"All students, Undergraduate, Other degree/certificate-seeking",1481,509,972,-2
183822,Bloomfield College,2013,"All students, Undergraduate, Other degree/certifcate-seeking, Transfer-ins",171,57,114,-2
183822,Bloomfield College,2013,"All students, Undergraduate, Other degree/certifcate-seeking, Continuing",1310,452,858,-2
183822,Bloomfield College,2013,"All students, Undergraduate, Non-degree/certificate-seeking",66,12,54,-2
183822,Bloomfield College,2013,"All students, Graduate",7,2,5,-2
183910,Caldwell College,2013,All students total,2160,602,1558,-2
183910,Caldwell College,2013,"All students, Undergraduate total",1578,489,1089,-2
183910,Caldwell College,2013,"All students, Undergraduate, Degree/certificate-seeking total",1570,488,1082,-2
183910,Caldwell College,2013,"All students, Undergraduate, Degree/certificate-seeking, First-time",373,98,275,-2
183910,Caldwell College,2013,"All students, Undergraduate, Other degree/certificate-seeking",1197,390,807,-2
183910,Caldwell College,2013,"All students, Undergraduate, Other degree/certifcate-seeking, Transfer-ins",94,39,55,-2
183910,Caldwell College,2013,"All students, Undergraduate, Other degree/certifcate-seeking, Continuing",1103,351,752,-2
183910,Caldwell College,2013,"All students, Undergraduate, Non-degree/certificate-seeking",8,1,7,-2
183910,Caldwell College,2013,"All students, Graduate",582,113,469,-2
183974,Centenary College,2013,All students total,2400,883,1517,-2
183974,Centenary College,2013,"All students, Undergraduate total",1708,681,1027,-2
183974,Centenary College,2013,"All students, Undergraduate, Degree/certificate-seeking total",1708,681,1027,-2
183974,Centenary College,2013,"All students, Undergraduate, Degree/certificate-seeking, First-time",217,82,135,-2
183974,Centenary College,2013,"All students, Undergraduate, Other degree/certificate-seeking",1491,599,892,-2
183974,Centenary College,2013,"All students, Undergraduate, Other degree/certifcate-seeking, Transfer-ins",145,62,83,-2
183974,Centenary College,2013,"All students, Undergraduate, Other degree/certifcate-seeking, Continuing",1346,537,809,-2
183974,Centenary College,2013,"All students, Graduate",692,202,490,-2
184153,Cooper Health System Center for Allied Health Education,2013,All students total,53,17,36,-2
184153,Cooper Health System Center for Allied Health Education,2013,"All students, Undergraduate total",41,9,32,-2
184153,Cooper Health System Center for Allied Health Education,2013,"All students, Undergraduate, Degree/certificate-seeking total",41,9,32,-2
184153,Cooper Health System Center for Allied Health Education,2013,"All students, Undergraduate, Other degree/certificate-seeking",41,9,32,-2
184153,Cooper Health System Center for Allied Health Education,2013,"All students, Undergraduate, Other degree/certifcate-seeking, Continuing",41,9,32,-2
184153,Cooper Health System Center for Allied Health Education,2013,"All students, Graduate",12,8,4,-2
184269,DeVry University-New Jersey,2013,,,,,-2
184348,Drew University,2013,All students total,2291,942,1349,-2
184348,Drew University,2013,"All students, Undergraduate total",1493,574,919,-2
184348,Drew University,2013,"All students, Undergraduate, Degree/certificate-seeking total",1453,555,898,-2
184348,Drew University,2013,"All students, Undergraduate, Degree/certificate-seeking, First-time",400,143,257,-2
184348,Drew University,2013,"All students, Undergraduate, Other degree/certificate-seeking",1053,412,641,-2
184348,Drew University,2013,"All students, Undergraduate, Other degree/certifcate-seeking, Transfer-ins",32,13,19,-2
184348,Drew University,2013,"All students, Undergraduate, Other degree/certifcate-seeking, Continuing",1021,399,622,-2
184348,Drew University,2013,"All students, Undergraduate, Non-degree/certificate-seeking",40,19,21,-2
184348,Drew University,2013,"All students, Graduate",798,368,430,-2
184603,Fairleigh Dickinson University-Metropolitan Campus,2013,All students total,8546,3455,5091,-2
184603,Fairleigh Dickinson University-Metropolitan Campus,2013,"All students, Undergraduate total",6108,2512,3596,-2
184603,Fairleigh Dickinson University-Metropolitan Campus,2013,"All students, Undergraduate, Degree/certificate-seeking total",3915,1649,2266,-2
184603,Fairleigh Dickinson University-Metropolitan Campus,2013,"All students, Undergraduate, Degree/certificate-seeking, First-time",651,250,401,-2
184603,Fairleigh Dickinson University-Metropolitan Campus,2013,"All students, Undergraduate, Other degree/certificate-seeking",3264,1399,1865,-2
184603,Fairleigh Dickinson University-Metropolitan Campus,2013,"All students, Undergraduate, Other degree/certifcate-seeking, Transfer-ins",380,179,201,-2
184603,Fairleigh Dickinson University-Metropolitan Campus,2013,"All students, Undergraduate, Other degree/certifcate-seeking, Continuing",2884,1220,1664,-2
184603,Fairleigh Dickinson University-Metropolitan Campus,2013,"All students, Undergraduate, Non-degree/certificate-seeking",2193,863,1330,-2
184603,Fairleigh Dickinson University-Metropolitan Campus,2013,"All students, Graduate",2438,943,1495,-2
184612,Felician College,2013,All students total,1933,501,1432,-2
184612,Felician College,2013,"All students, Undergraduate total",1621,447,1174,-2
184612,Felician College,2013,"All students, Undergraduate, Degree/certificate-seeking total",1618,447,1171,-2
184612,Felician College,2013,"All students, Undergraduate, Degree/certificate-seeking, First-time",153,63,90,-2
184612,Felician College,2013,"All students, Undergraduate, Other degree/certificate-seeking",1465,384,1081,-2
184612,Felician College,2013,"All students, Undergraduate, Other degree/certifcate-seeking, Transfer-ins",227,49,178,-2
184612,Felician College,2013,"All students, Undergraduate, Other degree/certifcate-seeking, Continuing",1238,335,903,-2
184612,Felician College,2013,"All students, Undergraduate, Non-degree/certificate-seeking",3,0,3,-2
184612,Felician College,2013,"All students, Graduate",312,54,258,-2
184694,Fairleigh Dickinson University-College at Florham,2013,All students total,3029,1302,1727,-2
184694,Fairleigh Dickinson University-College at Florham,2013,"All students, Undergraduate total",2274,1026,1248,-2
184694,Fairleigh Dickinson University-College at Florham,2013,"All students, Undergraduate, Degree/certificate-seeking total",2242,1017,1225,-2
184694,Fairleigh Dickinson University-College at Florham,2013,"All students, Undergraduate, Degree/certificate-seeking, First-time",512,227,285,-2
184694,Fairleigh Dickinson University-College at Florham,2013,"All students, Undergraduate, Other degree/certificate-seeking",1730,790,940,-2
184694,Fairleigh Dickinson University-College at Florham,2013,"All students, Undergraduate, Other degree/certifcate-seeking, Transfer-ins",121,59,62,-2
184694,Fairleigh Dickinson University-College at Florham,2013,"All students, Undergraduate, Other degree/certifcate-seeking, Continuing",1609,731,878,-2
184694,Fairleigh Dickinson University-College at Florham,2013,"All students, Undergraduate, Non-degree/certificate-seeking",32,9,23,-2
184694,Fairleigh Dickinson University-College at Florham,2013,"All students, Graduate",755,276,479,-2
184773,Georgian Court University,2013,All students total,2257,420,1837,-2
184773,Georgian Court University,2013,"All students, Undergraduate total",1567,301,1266,-2
184773,Georgian Court University,2013,"All students, Undergraduate, Degree/certificate-seeking total",1398,205,1193,-2
184773,Georgian Court University,2013,"All students, Undergraduate, Degree/certificate-seeking, First-time",275,75,200,-2
184773,Georgian Court University,2013,"All students, Undergraduate, Other degree/certificate-seeking",1123,130,993,-2
184773,Georgian Court University,2013,"All students, Undergraduate, Other degree/certifcate-seeking, Transfer-ins",218,46,172,-2
184773,Georgian Court University,2013,"All students, Undergraduate, Other degree/certifcate-seeking, Continuing",905,84,821,-2
184773,Georgian Court University,2013,"All students, Undergraduate, Non-degree/certificate-seeking",169,96,73,-2
184773,Georgian Court University,2013,"All students, Graduate",690,119,571,-2
184782,Rowan University,2013,All students total,13349,6483,6866,-2
184782,Rowan University,2013,"All students, Undergraduate total",10951,5533,5418,-2
184782,Rowan University,2013,"All students, Undergraduate, Degree/certificate-seeking total",10656,5436,5220,-2
184782,Rowan University,2013,"All students, Undergraduate, Degree/certificate-seeking, First-time",1505,905,600,-2
184782,Rowan University,2013,"All students, Undergraduate, Other degree/certificate-seeking",9151,4531,4620,-2
184782,Rowan University,2013,"All students, Undergraduate, Other degree/certifcate-seeking, Transfer-ins",1364,651,713,-2
184782,Rowan University,2013,"All students, Undergraduate, Other degree/certifcate-seeking, Continuing",7787,3880,3907,-2
184782,Rowan University,2013,"All students, Undergraduate, Non-degree/certificate-seeking",295,97,198,-2
184782,Rowan University,2013,"All students, Graduate",2398,950,1448,-2
185129,New Jersey City University,2013,All students total,8442,3135,5307,-2
185129,New Jersey City University,2013,"All students, Undergraduate total",6437,2564,3873,-2
185129,New Jersey City University,2013,"All students, Undergraduate, Degree/certificate-seeking total",6373,2540,3833,-2
185129,New Jersey City University,2013,"All students, Undergraduate, Degree/certificate-seeking, First-time",650,275,375,-2
185129,New Jersey City University,2013,"All students, Undergraduate, Other degree/certificate-seeking",5723,2265,3458,-2
185129,New Jersey City University,2013,"All students, Undergraduate, Other degree/certifcate-seeking, Transfer-ins",971,358,613,-2
185129,New Jersey City University,2013,"All students, Undergraduate, Other degree/certifcate-seeking, Continuing",4752,1907,2845,-2
185129,New Jersey City University,2013,"All students, Undergraduate, Non-degree/certificate-seeking",64,24,40,-2
185129,New Jersey City University,2013,"All students, Graduate",2005,571,1434,-2
185262,Kean University,2013,All students total,14404,5349,9055,-2
185262,Kean University,2013,"All students, Undergraduate total",12078,4791,7287,-2
185262,Kean University,2013,"All students, Undergraduate, Degree/certificate-seeking total",11975,4749,7226,-2
185262,Kean University,2013,"All students, Undergraduate, Degree/certificate-seeking, First-time",1525,650,875,-2
185262,Kean University,2013,"All students, Undergraduate, Other degree/certificate-seeking",10450,4099,6351,-2
185262,Kean University,2013,"All students, Undergraduate, Other degree/certifcate-seeking, Transfer-ins",1438,524,914,-2
185262,Kean University,2013,"All students, Undergraduate, Other degree/certifcate-seeking, Continuing",9012,3575,5437,-2
185262,Kean University,2013,"All students, Undergraduate, Non-degree/certificate-seeking",103,42,61,-2
185262,Kean University,2013,"All students, Graduate",2326,558,1768,-2
185572,Monmouth University,2013,All students total,6316,2285,4031,-2
185572,Monmouth University,2013,"All students, Undergraduate total",4607,1881,2726,-2
185572,Monmouth University,2013,"All students, Undergraduate, Degree/certificate-seeking total",4557,1859,2698,-2
185572,Monmouth University,2013,"All students, Undergraduate, Degree/certificate-seeking, First-time",906,381,525,-2
185572,Monmouth University,2013,"All students, Undergraduate, Other degree/certificate-seeking",3651,1478,2173,-2
185572,Monmouth University,2013,"All students, Undergraduate, Other degree/certifcate-seeking, Transfer-ins",324,142,182,-2
185572,Monmouth University,2013,"All students, Undergraduate, Other degree/certifcate-seeking, Continuing",3327,1336,1991,-2
185572,Monmouth University,2013,"All students, Undergraduate, Non-degree/certificate-seeking",50,22,28,-2
185572,Monmouth University,2013,"All students, Graduate",1709,404,1305,-2
185590,Montclair State University,2013,All students total,19464,7152,12312,-2
185590,Montclair State University,2013,"All students, Undergraduate total",15431,6022,9409,-2
185590,Montclair State University,2013,"All students, Undergraduate, Degree/certificate-seeking total",15182,5940,9242,-2
185590,Montclair State University,2013,"All students, Undergraduate, Degree/certificate-seeking, First-time",3040,1142,1898,-2
185590,Montclair State University,2013,"All students, Undergraduate, Other degree/certificate-seeking",12142,4798,7344,-2
185590,Montclair State University,2013,"All students, Undergraduate, Other degree/certifcate-seeking, Transfer-ins",1478,588,890,-2
185590,Montclair State University,2013,"All students, Undergraduate, Other degree/certifcate-seeking, Continuing",10664,4210,6454,-2
185590,Montclair State University,2013,"All students, Undergraduate, Non-degree/certificate-seeking",249,82,167,-2
185590,Montclair State University,2013,"All students, Graduate",4033,1130,2903,-2
185758,New Brunswick Theological Seminary,2013,All students total,171,77,94,-2
185758,New Brunswick Theological Seminary,2013,"All students, Graduate",171,77,94,-2
185828,New Jersey Institute of Technology,2013,All students total,10130,7547,2583,-2
185828,New Jersey Institute of Technology,2013,"All students, Undergraduate total",7317,5583,1734,-2
185828,New Jersey Institute of Technology,2013,"All students, Undergraduate, Degree/certificate-seeking total",6449,5105,1344,-2
185828,New Jersey Institute of Technology,2013,"All students, Undergraduate, Degree/certificate-seeking, First-time",1029,809,220,-2
185828,New Jersey Institute of Technology,2013,"All students, Undergraduate, Other degree/certificate-seeking",5420,4296,1124,-2
185828,New Jersey Institute of Technology,2013,"All students, Undergraduate, Other degree/certifcate-seeking, Transfer-ins",629,508,121,-2
185828,New Jersey Institute of Technology,2013,"All students, Undergraduate, Other degree/certifcate-seeking, Continuing",4791,3788,1003,-2
185828,New Jersey Institute of Technology,2013,"All students, Undergraduate, Non-degree/certificate-seeking",868,478,390,-2
185828,New Jersey Institute of Technology,2013,"All students, Graduate",2813,1964,849,-2
186122,Princeton Theological Seminary,2013,All students total,502,295,207,-2
186122,Princeton Theological Seminary,2013,"All students, Graduate",502,295,207,-2
186131,Princeton University,2013,All students total,8014,4397,3617,-2
186131,Princeton University,2013,"All students, Undergraduate total",5323,2722,2601,-2
186131,Princeton University,2013,"All students, Undergraduate, Degree/certificate-seeking total",5234,2667,2567,-2
186131,Princeton University,2013,"All students, Undergraduate, Degree/certificate-seeking, First-time",1284,655,629,-2
186131,Princeton University,2013,"All students, Undergraduate, Other degree/certificate-seeking",3950,2012,1938,-2
186131,Princeton University,2013,"All students, Undergraduate, Other degree/certifcate-seeking, Continuing",3950,2012,1938,-2
186131,Princeton University,2013,"All students, Undergraduate, Non-degree/certificate-seeking",89,55,34,-2
186131,Princeton University,2013,"All students, Graduate",2691,1675,1016,-2
186186,Rabbinical College of America,2013,All students total,239,239,0,-2
186186,Rabbinical College of America,2013,"All students, Undergraduate total",239,239,0,-2
186186,Rabbinical College of America,2013,"All students, Undergraduate, Degree/certificate-seeking total",239,239,0,-2
186186,Rabbinical College of America,2013,"All students, Undergraduate, Degree/certificate-seeking, First-time",19,19,0,-2
186186,Rabbinical College of America,2013,"All students, Undergraduate, Other degree/certificate-seeking",220,220,0,-2
186186,Rabbinical College of America,2013,"All students, Undergraduate, Other degree/certifcate-seeking, Transfer-ins",152,152,0,-2
186186,Rabbinical College of America,2013,"All students, Undergraduate, Other degree/certifcate-seeking, Continuing",68,68,0,-2
186201,Ramapo College of New Jersey,2013,All students total,5852,2576,3276,-2
186201,Ramapo College of New Jersey,2013,"All students, Undergraduate total",5614,2494,3120,-2
186201,Ramapo College of New Jersey,2013,"All students, Undergraduate, Degree/certificate-seeking total",5397,2422,2975,-2
186201,Ramapo College of New Jersey,2013,"All students, Undergraduate, Degree/certificate-seeking, First-time",901,437,464,-2
186201,Ramapo College of New Jersey,2013,"All students, Undergraduate, Other degree/certificate-seeking",4496,1985,2511,-2
186201,Ramapo College of New Jersey,2013,"All students, Undergraduate, Other degree/certifcate-seeking, Transfer-ins",599,291,308,-2
186201,Ramapo College of New Jersey,2013,"All students, Undergraduate, Other degree/certifcate-seeking, Continuing",3897,1694,2203,-2
186201,Ramapo College of New Jersey,2013,"All students, Undergraduate, Non-degree/certificate-seeking",217,72,145,-2
186201,Ramapo College of New Jersey,2013,"All students, Graduate",238,82,156,-2
186283,Rider University,2013,All students total,5410,2171,3239,-2
186283,Rider University,2013,"All students, Undergraduate total",4425,1836,2589,-2
186283,Rider University,2013,"All students, Undergraduate, Degree/certificate-seeking total",4041,1677,2364,-2
186283,Rider University,2013,"All students, Undergraduate, Degree/certificate-seeking, First-time",760,310,450,-2
186283,Rider University,2013,"All students, Undergraduate, Other degree/certificate-seeking",3281,1367,1914,-2
186283,Rider University,2013,"All students, Undergraduate, Other degree/certifcate-seeking, Transfer-ins",307,132,175,-2
186283,Rider University,2013,"All students, Undergraduate, Other degree/certifcate-seeking, Continuing",2974,1235,1739,-2
186283,Rider University,2013,"All students, Undergraduate, Non-degree/certificate-seeking",384,159,225,-2
186283,Rider University,2013,"All students, Graduate",985,335,650,-2
186371,Rutgers University-Camden,2013,All students total,6264,2995,3269,-2
186371,Rutgers University-Camden,2013,"All students, Undergraduate total",4842,2183,2659,-2
186371,Rutgers University-Camden,2013,"All students, Undergraduate, Degree/certificate-seeking total",4777,2160,2617,-2
186371,Rutgers University-Camden,2013,"All students, Undergraduate, Degree/certificate-seeking, First-time",496,254,242,-2
186371,Rutgers University-Camden,2013,"All students, Undergraduate, Other degree/certificate-seeking",4281,1906,2375,-2
186371,Rutgers University-Camden,2013,"All students, Undergraduate, Other degree/certifcate-seeking, Transfer-ins",837,346,491,-2
186371,Rutgers University-Camden,2013,"All students, Undergraduate, Other degree/certifcate-seeking, Continuing",3444,1560,1884,-2
186371,Rutgers University-Camden,2013,"All students, Undergraduate, Non-degree/certificate-seeking",65,23,42,-2
186371,Rutgers University-Camden,2013,"All students, Graduate",1422,812,610,-2
186380,Rutgers University-New Brunswick,2013,All students total,48036,22267,25769,-2
186380,Rutgers University-New Brunswick,2013,"All students, Undergraduate total",33901,16856,17045,-2
186380,Rutgers University-New Brunswick,2013,"All students, Undergraduate, Degree/certificate-seeking total",33427,16649,16778,-2
186380,Rutgers University-New Brunswick,2013,"All students, Undergraduate, Degree/certificate-seeking, First-time",6403,3241,3162,-2
186380,Rutgers University-New Brunswick,2013,"All students, Undergraduate, Other degree/certificate-seeking",27024,13408,13616,-2
186380,Rutgers University-New Brunswick,2013,"All students, Undergraduate, Other degree/certifcate-seeking, Transfer-ins",2581,1227,1354,-2
186380,Rutgers University-New Brunswick,2013,"All students, Undergraduate, Other degree/certifcate-seeking, Continuing",24443,12181,12262,-2
186380,Rutgers University-New Brunswick,2013,"All students, Undergraduate, Non-degree/certificate-seeking",474,207,267,-2
186380,Rutgers University-New Brunswick,2013,"All students, Graduate",14135,5411,8724,-2
186399,Rutgers University-Newark,2013,All students total,11212,5842,5370,-2
186399,Rutgers University-Newark,2013,"All students, Undergraduate total",7217,3577,3640,-2
186399,Rutgers University-Newark,2013,"All students, Undergraduate, Degree/certificate-seeking total",6748,3349,3399,-2
186399,Rutgers University-Newark,2013,"All students, Undergraduate, Degree/certificate-seeking, First-time",988,521,467,-2
186399,Rutgers University-Newark,2013,"All students, Undergraduate, Other degree/certificate-seeking",5760,2828,2932,-2
186399,Rutgers University-Newark,2013,"All students, Undergraduate, Other degree/certifcate-seeking, Transfer-ins",779,381,398,-2
186399,Rutgers University-Newark,2013,"All students, Undergraduate, Other degree/certifcate-seeking, Continuing",4981,2447,2534,-2
186399,Rutgers University-Newark,2013,"All students, Undergraduate, Non-degree/certificate-seeking",469,228,241,-2
186399,Rutgers University-Newark,2013,"All students, Graduate",3995,2265,1730,-2
186432,Saint Peter's University,2013,All students total,3194,1214,1980,-2
186432,Saint Peter's University,2013,"All students, Undergraduate total",2484,977,1507,-2
186432,Saint Peter's University,2013,"All students, Undergraduate, Degree/certificate-seeking total",2369,947,1422,-2
186432,Saint Peter's University,2013,"All students, Undergraduate, Degree/certificate-seeking, First-time",610,274,336,-2
186432,Saint Peter's University,2013,"All students, Undergraduate, Other degree/certificate-seeking",1759,673,1086,-2
186432,Saint Peter's University,2013,"All students, Undergraduate, Other degree/certifcate-seeking, Transfer-ins",127,52,75,-2
186432,Saint Peter's University,2013,"All students, Undergraduate, Other degree/certifcate-seeking, Continuing",1632,621,1011,-2
186432,Saint Peter's University,2013,"All students, Undergraduate, Non-degree/certificate-seeking",115,30,85,-2
186432,Saint Peter's University,2013,"All students, Graduate",710,237,473,-2
186584,Seton Hall University,2013,All students total,9903,4061,5842,-2
186584,Seton Hall University,2013,"All students, Undergraduate total",5839,2405,3434,-2
186584,Seton Hall University,2013,"All students, Undergraduate, Degree/certificate-seeking total",5632,2312,3320,-2
186584,Seton Hall University,2013,"All students, Undergraduate, Degree/certificate-seeking, First-time",1342,589,753,-2
186584,Seton Hall University,2013,"All students, Undergraduate, Other degree/certificate-seeking",4290,1723,2567,-2
186584,Seton Hall University,2013,"All students, Undergraduate, Other degree/certifcate-seeking, Transfer-ins",432,138,294,-2
186584,Seton Hall University,2013,"All students, Undergraduate, Other degree/certifcate-seeking, Continuing",3858,1585,2273,-2
186584,Seton Hall University,2013,"All students, Undergraduate, Non-degree/certificate-seeking",207,93,114,-2
186584,Seton Hall University,2013,"All students, Graduate",4064,1656,2408,-2
186618,College of Saint Elizabeth,2013,All students total,1552,178,1374,-2
186618,College of Saint Elizabeth,2013,"All students, Undergraduate total",987,75,912,-2
186618,College of Saint Elizabeth,2013,"All students, Undergraduate, Degree/certificate-seeking total",947,69,878,-2
186618,College of Saint Elizabeth,2013,"All students, Undergraduate, Degree/certificate-seeking, First-time",124,0,124,-2
186618,College of Saint Elizabeth,2013,"All students, Undergraduate, Other degree/certificate-seeking",823,69,754,-2
186618,College of Saint Elizabeth,2013,"All students, Undergraduate, Other degree/certifcate-seeking, Transfer-ins",99,20,79,-2
186618,College of Saint Elizabeth,2013,"All students, Undergraduate, Other degree/certifcate-seeking, Continuing",724,49,675,-2
186618,College of Saint Elizabeth,2013,"All students, Undergraduate, Non-degree/certificate-seeking",40,6,34,-2
186618,College of Saint Elizabeth,2013,"All students, Graduate",565,103,462,-2
186867,Stevens Institute of Technology,2013,All students total,5784,4261,1523,-2
186867,Stevens Institute of Technology,2013,"All students, Undergraduate total",2691,1933,758,-2
186867,Stevens Institute of Technology,2013,"All students, Undergraduate, Degree/certificate-seeking total",2662,1914,748,-2
186867,Stevens Institute of Technology,2013,"All students, Undergraduate, Degree/certificate-seeking, First-time",622,438,184,-2
186867,Stevens Institute of Technology,2013,"All students, Undergraduate, Other degree/certificate-seeking",2040,1476,564,-2
186867,Stevens Institute of Technology,2013,"All students, Undergraduate, Other degree/certifcate-seeking, Continuing",2040,1476,564,-2
186867,Stevens Institute of Technology,2013,"All students, Undergraduate, Non-degree/certificate-seeking",29,19,10,-2
186867,Stevens Institute of Technology,2013,"All students, Graduate",3093,2328,765,-2
186876,The Richard Stockton College of New Jersey,2013,All students total,8458,3279,5179,-2
186876,The Richard Stockton College of New Jersey,2013,"All students, Undergraduate total",7539,3060,4479,-2
186876,The Richard Stockton College of New Jersey,2013,"All students, Undergraduate, Degree/certificate-seeking total",7491,3037,4454,-2
186876,The Richard Stockton College of New Jersey,2013,"All students, Undergraduate, Degree/certificate-seeking, First-time",1069,427,642,-2
186876,The Richard Stockton College of New Jersey,2013,"All students, Undergraduate, Other degree/certificate-seeking",6422,2610,3812,-2
186876,The Richard Stockton College of New Jersey,2013,"All students, Undergraduate, Other degree/certifcate-seeking, Transfer-ins",1036,405,631,-2
186876,The Richard Stockton College of New Jersey,2013,"All students, Undergraduate, Other degree/certifcate-seeking, Continuing",5386,2205,3181,-2
186876,The Richard Stockton College of New Jersey,2013,"All students, Undergraduate, Non-degree/certificate-seeking",48,23,25,-2
186876,The Richard Stockton College of New Jersey,2013,"All students, Graduate",919,219,700,-2
186900,Talmudical Academy-New Jersey,2013,All students total,68,68,0,-2
186900,Talmudical Academy-New Jersey,2013,"All students, Undergraduate total",68,68,0,-2
186900,Talmudical Academy-New Jersey,2013,"All students, Undergraduate, Degree/certificate-seeking total",68,68,0,-2
186900,Talmudical Academy-New Jersey,2013,"All students, Undergraduate, Degree/certificate-seeking, First-time",18,18,0,-2
186900,Talmudical Academy-New Jersey,2013,"All students, Undergraduate, Other degree/certificate-seeking",50,50,0,-2
186900,Talmudical Academy-New Jersey,2013,"All students, Undergraduate, Other degree/certifcate-seeking, Transfer-ins",32,32,0,-2
186900,Talmudical Academy-New Jersey,2013,"All students, Undergraduate, Other degree/certifcate-seeking, Continuing",18,18,0,-2
187046,Thomas Edison State College,2013,All students total,20877,10816,10061,-2
187046,Thomas Edison State College,2013,"All students, Undergraduate total",19596,10434,9162,-2
187046,Thomas Edison State College,2013,"All students, Undergraduate, Degree/certificate-seeking total",19596,10434,9162,-2
187046,Thomas Edison State College,2013,"All students, Undergraduate, Other degree/certificate-seeking",19596,10434,9162,-2
187046,Thomas Edison State College,2013,"All students, Undergraduate, Other degree/certifcate-seeking, Transfer-ins",7846,4224,3622,-2
187046,Thomas Edison State College,2013,"All students, Undergraduate, Other degree/certifcate-seeking, Continuing",11750,6210,5540,-2
187046,Thomas Edison State College,2013,"All students, Graduate",1281,382,899,-2
187134,The College of New Jersey,2013,All students total,7340,2958,4382,-2
187134,The College of New Jersey,2013,"All students, Undergraduate total",6653,2851,3802,-2
187134,The College of New Jersey,2013,"All students, Undergraduate, Degree/certificate-seeking total",6446,2764,3682,-2
187134,The College of New Jersey,2013,"All students, Undergraduate, Degree/certificate-seeking, First-time",1404,546,858,-2
187134,The College of New Jersey,2013,"All students, Undergraduate, Other degree/certificate-seeking",5042,2218,2824,-2
187134,The College of New Jersey,2013,"All students, Undergraduate, Other degree/certifcate-seeking, Transfer-ins",254,112,142,-2
187134,The College of New Jersey,2013,"All students, Undergraduate, Other degree/certifcate-seeking, Continuing",4788,2106,2682,-2
187134,The College of New Jersey,2013,"All students, Undergraduate, Non-degree/certificate-seeking",207,87,120,-2
187134,The College of New Jersey,2013,"All students, Graduate",687,107,580,-2
187222,University of Medicine and Dentistry of New Jersey,2013,,,,,-2
187444,William Paterson University of New Jersey,2013,All students total,11414,4904,6510,-2
187444,William Paterson University of New Jersey,2013,"All students, Undergraduate total",10027,4562,5465,-2
187444,William Paterson University of New Jersey,2013,"All students, Undergraduate, Degree/certificate-seeking total",9930,4509,5421,-2
187444,William Paterson University of New Jersey,2013,"All students, Undergraduate, Degree/certificate-seeking, First-time",1295,635,660,-2
187444,William Paterson University of New Jersey,2013,"All students, Undergraduate, Other degree/certificate-seeking",8635,3874,4761,-2
187444,William Paterson University of New Jersey,2013,"All students, Undergraduate, Other degree/certifcate-seeking, Transfer-ins",1442,625,817,-2
187444,William Paterson University of New Jersey,2013,"All students, Undergraduate, Other degree/certifcate-seeking, Continuing",7193,3249,3944,-2
187444,William Paterson University of New Jersey,2013,"All students, Undergraduate, Non-degree/certificate-seeking",97,53,44,-2
187444,William Paterson University of New Jersey,2013,"All students, Graduate",1387,342,1045,-2
188340,Vaughn College of Aeronautics and Technology,2013,All students total,1741,1524,217,-2
188340,Vaughn College of Aeronautics and Technology,2013,"All students, Undergraduate total",1724,1511,213,-2
188340,Vaughn College of Aeronautics and Technology,2013,"All students, Undergraduate, Degree/certificate-seeking total",1721,1509,212,-2
188340,Vaughn College of Aeronautics and Technology,2013,"All students, Undergraduate, Degree/certificate-seeking, First-time",302,270,32,-2
188340,Vaughn College of Aeronautics and Technology,2013,"All students, Undergraduate, Other degree/certificate-seeking",1419,1239,180,-2
188340,Vaughn College of Aeronautics and Technology,2013,"All students, Undergraduate, Other degree/certifcate-seeking, Transfer-ins",183,168,15,-2
188340,Vaughn College of Aeronautics and Technology,2013,"All students, Undergraduate, Other degree/certifcate-seeking, Continuing",1236,1071,165,-2
188340,Vaughn College of Aeronautics and Technology,2013,"All students, Undergraduate, Non-degree/certificate-seeking",3,2,1,-2
188340,Vaughn College of Aeronautics and Technology,2013,"All students, Graduate",17,13,4,-2
188429,Adelphi University,2013,All students total,7645,2068,5577,-2
188429,Adelphi University,2013,"All students, Undergraduate total",5040,1539,3501,-2
188429,Adelphi University,2013,"All students, Undergraduate, Degree/certificate-seeking total",5000,1527,3473,-2
188429,Adelphi University,2013,"All students, Undergraduate, Degree/certificate-seeking, First-time",918,300,618,-2
188429,Adelphi University,2013,"All students, Undergraduate, Other degree/certificate-seeking",4082,1227,2855,-2
188429,Adelphi University,2013,"All students, Undergraduate, Other degree/certifcate-seeking, Transfer-ins",510,136,374,-2
188429,Adelphi University,2013,"All students, Undergraduate, Other degree/certifcate-seeking, Continuing",3572,1091,2481,-2
188429,Adelphi University,2013,"All students, Undergraduate, Non-degree/certificate-seeking",40,12,28,-2
188429,Adelphi University,2013,"All students, Graduate",2605,529,2076,-2
188465,Globe Institute of Technology,2013,All students total,557,357,200,-2
188465,Globe Institute of Technology,2013,"All students, Undergraduate total",557,357,200,-2
188465,Globe Institute of Technology,2013,"All students, Undergraduate, Degree/certificate-seeking total",551,355,196,-2
188465,Globe Institute of Technology,2013,"All students, Undergraduate, Degree/certificate-seeking, First-time",223,148,75,-2
188465,Globe Institute of Technology,2013,"All students, Undergraduate, Other degree/certificate-seeking",328,207,121,-2
188465,Globe Institute of Technology,2013,"All students, Undergraduate, Other degree/certifcate-seeking, Transfer-ins",67,51,16,-2
188465,Globe Institute of Technology,2013,"All students, Undergraduate, Other degree/certifcate-seeking, Continuing",261,156,105,-2
188465,Globe Institute of Technology,2013,"All students, Undergraduate, Non-degree/certificate-seeking",6,2,4,-2
188517,Bryant & Stratton College-Albany,2013,All students total,580,128,452,-2
188517,Bryant & Stratton College-Albany,2013,"All students, Undergraduate total",580,128,452,-2
188517,Bryant & Stratton College-Albany,2013,"All students, Undergraduate, Degree/certificate-seeking total",568,124,444,-2
188517,Bryant & Stratton College-Albany,2013,"All students, Undergraduate, Degree/certificate-seeking, First-time",64,20,44,-2
188517,Bryant & Stratton College-Albany,2013,"All students, Undergraduate, Other degree/certificate-seeking",504,104,400,-2
188517,Bryant & Stratton College-Albany,2013,"All students, Undergraduate, Other degree/certifcate-seeking, Transfer-ins",90,27,63,-2
188517,Bryant & Stratton College-Albany,2013,"All students, Undergraduate, Other degree/certifcate-seeking, Continuing",414,77,337,-2
188517,Bryant & Stratton College-Albany,2013,"All students, Undergraduate, Non-degree/certificate-seeking",12,4,8,-2
188526,Albany College of Pharmacy and Health Sciences,2013,All students total,1639,658,981,-2
188526,Albany College of Pharmacy and Health Sciences,2013,"All students, Undergraduate total",1078,427,651,-2
188526,Albany College of Pharmacy and Health Sciences,2013,"All students, Undergraduate, Degree/certificate-seeking total",1075,427,648,-2
188526,Albany College of Pharmacy and Health Sciences,2013,"All students, Undergraduate, Degree/certificate-seeking, First-time",243,88,155,-2
188526,Albany College of Pharmacy and Health Sciences,2013,"All students, Undergraduate, Other degree/certificate-seeking",832,339,493,-2
188526,Albany College of Pharmacy and Health Sciences,2013,"All students, Undergraduate, Other degree/certifcate-seeking, Transfer-ins",125,45,80,-2
188526,Albany College of Pharmacy and Health Sciences,2013,"All students, Undergraduate, Other degree/certifcate-seeking, Continuing",707,294,413,-2
188526,Albany College of Pharmacy and Health Sciences,2013,"All students, Undergraduate, Non-degree/certificate-seeking",3,0,3,-2
188526,Albany College of Pharmacy and Health Sciences,2013,"All students, Graduate",561,231,330,-2
188535,Albany Law School,2013,All students total,594,299,295,-2
188535,Albany Law School,2013,"All students, Graduate",594,299,295,-2
188580,Albany Medical College,2013,All students total,830,381,449,-2
188580,Albany Medical College,2013,"All students, Graduate",830,381,449,-2
188641,Alfred University,2013,All students total,2431,1120,1311,-2
188641,Alfred University,2013,"All students, Undergraduate total",1960,963,997,-2
188641,Alfred University,2013,"All students, Undergraduate, Degree/certificate-seeking total",1905,944,961,-2
188641,Alfred University,2013,"All students, Undergraduate, Degree/certificate-seeking, First-time",535,300,235,-2
188641,Alfred University,2013,"All students, Undergraduate, Other degree/certificate-seeking",1370,644,726,-2
188641,Alfred University,2013,"All students, Undergraduate, Other degree/certifcate-seeking, Transfer-ins",49,25,24,-2
188641,Alfred University,2013,"All students, Undergraduate, Other degree/certifcate-seeking, Continuing",1321,619,702,-2
188641,Alfred University,2013,"All students, Undergraduate, Non-degree/certificate-seeking",55,19,36,-2
188641,Alfred University,2013,"All students, Graduate",471,157,314,-2
188854,American Musical and Dramatic Academy,2013,All students total,1365,447,918,-2
188854,American Musical and Dramatic Academy,2013,"All students, Undergraduate total",1365,447,918,-2
188854,American Musical and Dramatic Academy,2013,"All students, Undergraduate, Degree/certificate-seeking total",1365,447,918,-2
188854,American Musical and Dramatic Academy,2013,"All students, Undergraduate, Degree/certificate-seeking, First-time",462,128,334,-2
188854,American Musical and Dramatic Academy,2013,"All students, Undergraduate, Other degree/certificate-seeking",903,319,584,-2
188854,American Musical and Dramatic Academy,2013,"All students, Undergraduate, Other degree/certifcate-seeking, Transfer-ins",11,3,8,-2
188854,American Musical and Dramatic Academy,2013,"All students, Undergraduate, Other degree/certifcate-seeking, Continuing",892,316,576,-2
189015,Bank Street College of Education,2013,All students total,846,110,736,-2
189015,Bank Street College of Education,2013,"All students, Graduate",846,110,736,-2
189088,Bard College,2013,All students total,2355,1028,1327,-2
189088,Bard College,2013,"All students, Undergraduate total",2014,892,1122,-2
189088,Bard College,2013,"All students, Undergraduate, Degree/certificate-seeking total",1957,866,1091,-2
189088,Bard College,2013,"All students, Undergraduate, Degree/certificate-seeking, First-time",489,229,260,-2
189088,Bard College,2013,"All students, Undergraduate, Other degree/certificate-seeking",1468,637,831,-2
189088,Bard College,2013,"All students, Undergraduate, Other degree/certifcate-seeking, Transfer-ins",65,27,38,-2
189088,Bard College,2013,"All students, Undergraduate, Other degree/certifcate-seeking, Continuing",1403,610,793,-2
189088,Bard College,2013,"All students, Undergraduate, Non-degree/certificate-seeking",57,26,31,-2
189088,Bard College,2013,"All students, Graduate",341,136,205,-2
189097,Barnard College,2013,All students total,2489,0,2489,-2
189097,Barnard College,2013,"All students, Undergraduate total",2489,0,2489,-2
189097,Barnard College,2013,"All students, Undergraduate, Degree/certificate-seeking total",2486,0,2486,-2
189097,Barnard College,2013,"All students, Undergraduate, Degree/certificate-seeking, First-time",580,0,580,-2
189097,Barnard College,2013,"All students, Undergraduate, Other degree/certificate-seeking",1906,0,1906,-2
189097,Barnard College,2013,"All students, Undergraduate, Other degree/certifcate-seeking, Transfer-ins",70,0,70,-2
189097,Barnard College,2013,"All students, Undergraduate, Other degree/certifcate-seeking, Continuing",1836,0,1836,-2
189097,Barnard College,2013,"All students, Undergraduate, Non-degree/certificate-seeking",3,0,3,-2
189228,Berkeley College-New York,2013,All students total,4596,1644,2952,-2
189228,Berkeley College-New York,2013,"All students, Undergraduate total",4596,1644,2952,-2
189228,Berkeley College-New York,2013,"All students, Undergraduate, Degree/certificate-seeking total",4551,1628,2923,-2
189228,Berkeley College-New York,2013,"All students, Undergraduate, Degree/certificate-seeking, First-time",737,306,431,-2
189228,Berkeley College-New York,2013,"All students, Undergraduate, Other degree/certificate-seeking",3814,1322,2492,-2
189228,Berkeley College-New York,2013,"All students, Undergraduate, Other degree/certifcate-seeking, Transfer-ins",502,151,351,-2
189228,Berkeley College-New York,2013,"All students, Undergraduate, Other degree/certifcate-seeking, Continuing",3312,1171,2141,-2
189228,Berkeley College-New York,2013,"All students, Undergraduate, Non-degree/certificate-seeking",45,16,29,-2
189264,Beth Hatalmud Rabbinical College,2013,All students total,47,47,0,-2
189264,Beth Hatalmud Rabbinical College,2013,"All students, Undergraduate total",47,47,0,-2
189264,Beth Hatalmud Rabbinical College,2013,"All students, Undergraduate, Degree/certificate-seeking total",47,47,0,-2
189264,Beth Hatalmud Rabbinical College,2013,"All students, Undergraduate, Degree/certificate-seeking, First-time",9,9,0,-2
189264,Beth Hatalmud Rabbinical College,2013,"All students, Undergraduate, Other degree/certificate-seeking",38,38,0,-2
189264,Beth Hatalmud Rabbinical College,2013,"All students, Undergraduate, Other degree/certifcate-seeking, Transfer-ins",12,12,0,-2
189264,Beth Hatalmud Rabbinical College,2013,"All students, Undergraduate, Other degree/certifcate-seeking, Continuing",26,26,0,-2
189273,Beth Hamedrash Shaarei Yosher Institute,2013,All students total,55,55,0,-2
189273,Beth Hamedrash Shaarei Yosher Institute,2013,"All students, Undergraduate total",49,49,0,-2
189273,Beth Hamedrash Shaarei Yosher Institute,2013,"All students, Undergraduate, Degree/certificate-seeking total",49,49,0,-2
189273,Beth Hamedrash Shaarei Yosher Institute,2013,"All students, Undergraduate, Degree/certificate-seeking, First-time",18,18,0,-2
189273,Beth Hamedrash Shaarei Yosher Institute,2013,"All students, Undergraduate, Other degree/certificate-seeking",31,31,0,-2
189273,Beth Hamedrash Shaarei Yosher Institute,2013,"All students, Undergraduate, Other degree/certifcate-seeking, Transfer-ins",8,8,0,-2
189273,Beth Hamedrash Shaarei Yosher Institute,2013,"All students, Undergraduate, Other degree/certifcate-seeking, Continuing",23,23,0,-2
189273,Beth Hamedrash Shaarei Yosher Institute,2013,"All students, Graduate",6,6,0,-2
189413,Boricua College,2013,All students total,1118,255,863,-2
189413,Boricua College,2013,"All students, Undergraduate total",1050,243,807,-2
189413,Boricua College,2013,"All students, Undergraduate, Degree/certificate-seeking total",1050,243,807,-2
189413,Boricua College,2013,"All students, Undergraduate, Degree/certificate-seeking, First-time",220,53,167,-2
189413,Boricua College,2013,"All students, Undergraduate, Other degree/certificate-seeking",830,190,640,-2
189413,Boricua College,2013,"All students, Undergraduate, Other degree/certifcate-seeking, Transfer-ins",101,21,80,-2
189413,Boricua College,2013,"All students, Undergraduate, Other degree/certifcate-seeking, Continuing",729,169,560,-2
189413,Boricua College,2013,"All students, Graduate",68,12,56,-2
189459,Briarcliffe College,2013,All students total,1886,664,1222,-2
189459,Briarcliffe College,2013,"All students, Undergraduate total",1886,664,1222,-2
189459,Briarcliffe College,2013,"All students, Undergraduate, Degree/certificate-seeking total",1885,664,1221,-2
189459,Briarcliffe College,2013,"All students, Undergraduate, Degree/certificate-seeking, First-time",217,92,125,-2
189459,Briarcliffe College,2013,"All students, Undergraduate, Other degree/certificate-seeking",1668,572,1096,-2
189459,Briarcliffe College,2013,"All students, Undergraduate, Other degree/certifcate-seeking, Transfer-ins",231,32,199,-2
189459,Briarcliffe College,2013,"All students, Undergraduate, Other degree/certifcate-seeking, Continuing",1437,540,897,-2
189459,Briarcliffe College,2013,"All students, Undergraduate, Non-degree/certificate-seeking",1,0,1,-2
189501,Brooklyn Law School,2013,All students total,1135,628,507,-2
189501,Brooklyn Law School,2013,"All students, Graduate",1135,628,507,-2
189556,Bryant & Stratton College-Amherst,2013,All students total,413,91,322,-2
189556,Bryant & Stratton College-Amherst,2013,"All students, Undergraduate total",413,91,322,-2
189556,Bryant & Stratton College-Amherst,2013,"All students, Undergraduate, Degree/certificate-seeking total",400,87,313,-2
189556,Bryant & Stratton College-Amherst,2013,"All students, Undergraduate, Degree/certificate-seeking, First-time",41,12,29,-2
189556,Bryant & Stratton College-Amherst,2013,"All students, Undergraduate, Other degree/certificate-seeking",359,75,284,-2
189556,Bryant & Stratton College-Amherst,2013,"All students, Undergraduate, Other degree/certifcate-seeking, Transfer-ins",77,18,59,-2
189556,Bryant & Stratton College-Amherst,2013,"All students, Undergraduate, Other degree/certifcate-seeking, Continuing",282,57,225,-2
189556,Bryant & Stratton College-Amherst,2013,"All students, Undergraduate, Non-degree/certificate-seeking",13,4,9,-2
189565,Bryant & Stratton College-Syracuse North,2013,All students total,452,112,340,-2
189565,Bryant & Stratton College-Syracuse North,2013,"All students, Undergraduate total",452,112,340,-2
189565,Bryant & Stratton College-Syracuse North,2013,"All students, Undergraduate, Degree/certificate-seeking total",444,109,335,-2
189565,Bryant & Stratton College-Syracuse North,2013,"All students, Undergraduate, Degree/certificate-seeking, First-time",44,14,30,-2
189565,Bryant & Stratton College-Syracuse North,2013,"All students, Undergraduate, Other degree/certificate-seeking",400,95,305,-2
189565,Bryant & Stratton College-Syracuse North,2013,"All students, Undergraduate, Other degree/certifcate-seeking, Transfer-ins",65,16,49,-2
189565,Bryant & Stratton College-Syracuse North,2013,"All students, Undergraduate, Other degree/certifcate-seeking, Continuing",335,79,256,-2
189565,Bryant & Stratton College-Syracuse North,2013,"All students, Undergraduate, Non-degree/certificate-seeking",8,3,5,-2
189583,Bryant & Stratton College-Buffalo,2013,All students total,740,206,534,-2
189583,Bryant & Stratton College-Buffalo,2013,"All students, Undergraduate total",740,206,534,-2
189583,Bryant & Stratton College-Buffalo,2013,"All students, Undergraduate, Degree/certificate-seeking total",716,194,522,-2
189583,Bryant & Stratton College-Buffalo,2013,"All students, Undergraduate, Degree/certificate-seeking, First-time",89,30,59,-2
189583,Bryant & Stratton College-Buffalo,2013,"All students, Undergraduate, Other degree/certificate-seeking",627,164,463,-2
189583,Bryant & Stratton College-Buffalo,2013,"All students, Undergraduate, Other degree/certifcate-seeking, Transfer-ins",116,38,78,-2
189583,Bryant & Stratton College-Buffalo,2013,"All students, Undergraduate, Other degree/certifcate-seeking, Continuing",511,126,385,-2
189583,Bryant & Stratton College-Buffalo,2013,"All students, Undergraduate, Non-degree/certificate-seeking",24,12,12,-2
189592,Bryant & Stratton College-Greece,2013,All students total,389,89,300,-2
189592,Bryant & Stratton College-Greece,2013,"All students, Undergraduate total",389,89,300,-2
189592,Bryant & Stratton College-Greece,2013,"All students, Undergraduate, Degree/certificate-seeking total",381,88,293,-2
189592,Bryant & Stratton College-Greece,2013,"All students, Undergraduate, Degree/certificate-seeking, First-time",51,24,27,-2
189592,Bryant & Stratton College-Greece,2013,"All students, Undergraduate, Other degree/certificate-seeking",330,64,266,-2
189592,Bryant & Stratton College-Greece,2013,"All students, Undergraduate, Other degree/certifcate-seeking, Transfer-ins",80,16,64,-2
189592,Bryant & Stratton College-Greece,2013,"All students, Undergraduate, Other degree/certifcate-seeking, Continuing",250,48,202,-2
189592,Bryant & Stratton College-Greece,2013,"All students, Undergraduate, Non-degree/certificate-seeking",8,1,7,-2
189705,Canisius College,2013,All students total,4537,2078,2459,-2
189705,Canisius College,2013,"All students, Undergraduate total",3084,1533,1551,-2
189705,Canisius College,2013,"All students, Undergraduate, Degree/certificate-seeking total",2858,1347,1511,-2
189705,Canisius College,2013,"All students, Undergraduate, Degree/certificate-seeking, First-time",682,319,363,-2
189705,Canisius College,2013,"All students, Undergraduate, Other degree/certificate-seeking",2176,1028,1148,-2
189705,Canisius College,2013,"All students, Undergraduate, Other degree/certifcate-seeking, Transfer-ins",119,62,57,-2
189705,Canisius College,2013,"All students, Undergraduate, Other degree/certifcate-seeking, Continuing",2057,966,1091,-2
189705,Canisius College,2013,"All students, Undergraduate, Non-degree/certificate-seeking",226,186,40,-2
189705,Canisius College,2013,"All students, Graduate",1453,545,908,-2
189848,Cazenovia College,2013,All students total,1077,297,780,-2
189848,Cazenovia College,2013,"All students, Undergraduate total",1077,297,780,-2
189848,Cazenovia College,2013,"All students, Undergraduate, Degree/certificate-seeking total",1031,283,748,-2
189848,Cazenovia College,2013,"All students, Undergraduate, Degree/certificate-seeking, First-time",345,91,254,-2
189848,Cazenovia College,2013,"All students, Undergraduate, Other degree/certificate-seeking",686,192,494,-2
189848,Cazenovia College,2013,"All students, Undergraduate, Other degree/certifcate-seeking, Transfer-ins",36,14,22,-2
189848,Cazenovia College,2013,"All students, Undergraduate, Other degree/certifcate-seeking, Continuing",650,178,472,-2
189848,Cazenovia College,2013,"All students, Undergraduate, Non-degree/certificate-seeking",46,14,32,-2
189857,Central Yeshiva Tomchei Tmimim Lubavitz,2013,All students total,731,731,0,-2
189857,Central Yeshiva Tomchei Tmimim Lubavitz,2013,"All students, Undergraduate total",650,650,0,-2
189857,Central Yeshiva Tomchei Tmimim Lubavitz,2013,"All students, Undergraduate, Degree/certificate-seeking total",650,650,0,-2
189857,Central Yeshiva Tomchei Tmimim Lubavitz,2013,"All students, Undergraduate, Degree/certificate-seeking, First-time",92,92,0,-2
189857,Central Yeshiva Tomchei Tmimim Lubavitz,2013,"All students, Undergraduate, Other degree/certificate-seeking",558,558,0,-2
189857,Central Yeshiva Tomchei Tmimim Lubavitz,2013,"All students, Undergraduate, Other degree/certifcate-seeking, Transfer-ins",286,286,0,-2
189857,Central Yeshiva Tomchei Tmimim Lubavitz,2013,"All students, Undergraduate, Other degree/certifcate-seeking, Continuing",272,272,0,-2
189857,Central Yeshiva Tomchei Tmimim Lubavitz,2013,"All students, Graduate",81,81,0,-2
189981,Christ the King Seminary,2013,All students total,96,64,32,-2
189981,Christ the King Seminary,2013,"All students, Graduate",96,64,32,-2
190035,CUNY System Office,2013,,,,,-2
190044,Clarkson University,2013,All students total,3726,2616,1110,-2
190044,Clarkson University,2013,"All students, Undergraduate total",3110,2229,881,-2
190044,Clarkson University,2013,"All students, Undergraduate, Degree/certificate-seeking total",3060,2202,858,-2
190044,Clarkson University,2013,"All students, Undergraduate, Degree/certificate-seeking, First-time",757,522,235,-2
190044,Clarkson University,2013,"All students, Undergraduate, Other degree/certificate-seeking",2303,1680,623,-2
190044,Clarkson University,2013,"All students, Undergraduate, Other degree/certifcate-seeking, Transfer-ins",131,107,24,-2
190044,Clarkson University,2013,"All students, Undergraduate, Other degree/certifcate-seeking, Continuing",2172,1573,599,-2
190044,Clarkson University,2013,"All students, Undergraduate, Non-degree/certificate-seeking",50,27,23,-2
190044,Clarkson University,2013,"All students, Graduate",616,387,229,-2
190080,Colgate Rochester Crozer Divinity School,2013,All students total,87,39,48,-2
190080,Colgate Rochester Crozer Divinity School,2013,"All students, Graduate",87,39,48,-2
190099,Colgate University,2013,All students total,2900,1297,1603,-2
190099,Colgate University,2013,"All students, Undergraduate total",2890,1293,1597,-2
190099,Colgate University,2013,"All students, Undergraduate, Degree/certificate-seeking total",2872,1287,1585,-2
190099,Colgate University,2013,"All students, Undergraduate, Degree/certificate-seeking, First-time",759,319,440,-2
190099,Colgate University,2013,"All students, Undergraduate, Other degree/certificate-seeking",2113,968,1145,-2
190099,Colgate University,2013,"All students, Undergraduate, Other degree/certifcate-seeking, Transfer-ins",7,3,4,-2
190099,Colgate University,2013,"All students, Undergraduate, Other degree/certifcate-seeking, Continuing",2106,965,1141,-2
190099,Colgate University,2013,"All students, Undergraduate, Non-degree/certificate-seeking",18,6,12,-2
190099,Colgate University,2013,"All students, Graduate",10,4,6,-2
190114,Metropolitan College of New York,2013,All students total,1255,379,876,-2
190114,Metropolitan College of New York,2013,"All students, Undergraduate total",911,266,645,-2
190114,Metropolitan College of New York,2013,"All students, Undergraduate, Degree/certificate-seeking total",911,266,645,-2
190114,Metropolitan College of New York,2013,"All students, Undergraduate, Degree/certificate-seeking, First-time",115,30,85,-2
190114,Metropolitan College of New York,2013,"All students, Undergraduate, Other degree/certificate-seeking",796,236,560,-2
190114,Metropolitan College of New York,2013,"All students, Undergraduate, Other degree/certifcate-seeking, Transfer-ins",137,29,108,-2
190114,Metropolitan College of New York,2013,"All students, Undergraduate, Other degree/certifcate-seeking, Continuing",659,207,452,-2
190114,Metropolitan College of New York,2013,"All students, Graduate",344,113,231,-2
190150,Columbia University in the City of New York,2013,All students total,26957,13303,13654,-2
190150,Columbia University in the City of New York,2013,"All students, Undergraduate total",7970,4185,3785,-2
190150,Columbia University in the City of New York,2013,"All students, Undergraduate, Degree/certificate-seeking total",7970,4185,3785,-2
190150,Columbia University in the City of New York,2013,"All students, Undergraduate, Degree/certificate-seeking, First-time",1509,737,772,-2
190150,Columbia University in the City of New York,2013,"All students, Undergraduate, Other degree/certificate-seeking",6461,3448,3013,-2
190150,Columbia University in the City of New York,2013,"All students, Undergraduate, Other degree/certifcate-seeking, Transfer-ins",571,364,207,-2
190150,Columbia University in the City of New York,2013,"All students, Undergraduate, Other degree/certifcate-seeking, Continuing",5890,3084,2806,-2
190150,Columbia University in the City of New York,2013,"All students, Graduate",18987,9118,9869,-2
190248,Concordia College-New York,2013,All students total,953,305,648,-2
190248,Concordia College-New York,2013,"All students, Undergraduate total",887,292,595,-2
190248,Concordia College-New York,2013,"All students, Undergraduate, Degree/certificate-seeking total",856,283,573,-2
190248,Concordia College-New York,2013,"All students, Undergraduate, Degree/certificate-seeking, First-time",153,56,97,-2
190248,Concordia College-New York,2013,"All students, Undergraduate, Other degree/certificate-seeking",703,227,476,-2
190248,Concordia College-New York,2013,"All students, Undergraduate, Other degree/certifcate-seeking, Transfer-ins",34,11,23,-2
190248,Concordia College-New York,2013,"All students, Undergraduate, Other degree/certifcate-seeking, Continuing",669,216,453,-2
190248,Concordia College-New York,2013,"All students, Undergraduate, Non-degree/certificate-seeking",31,9,22,-2
190248,Concordia College-New York,2013,"All students, Graduate",66,13,53,-2
190372,Cooper Union for the Advancement of Science and Art,2013,All students total,920,593,327,-2
190372,Cooper Union for the Advancement of Science and Art,2013,"All students, Undergraduate total",868,557,311,-2
190372,Cooper Union for the Advancement of Science and Art,2013,"All students, Undergraduate, Degree/certificate-seeking total",851,547,304,-2
190372,Cooper Union for the Advancement of Science and Art,2013,"All students, Undergraduate, Degree/certificate-seeking, First-time",178,117,61,-2
190372,Cooper Union for the Advancement of Science and Art,2013,"All students, Undergraduate, Other degree/certificate-seeking",673,430,243,-2
190372,Cooper Union for the Advancement of Science and Art,2013,"All students, Undergraduate, Other degree/certifcate-seeking, Transfer-ins",31,15,16,-2
190372,Cooper Union for the Advancement of Science and Art,2013,"All students, Undergraduate, Other degree/certifcate-seeking, Continuing",642,415,227,-2
190372,Cooper Union for the Advancement of Science and Art,2013,"All students, Undergraduate, Non-degree/certificate-seeking",17,10,7,-2
190372,Cooper Union for the Advancement of Science and Art,2013,"All students, Graduate",52,36,16,-2
190415,Cornell University,2013,All students total,21593,11074,10519,-2
190415,Cornell University,2013,"All students, Undergraduate total",14393,7050,7343,-2
190415,Cornell University,2013,"All students, Undergraduate, Degree/certificate-seeking total",14309,7010,7299,-2
190415,Cornell University,2013,"All students, Undergraduate, Degree/certificate-seeking, First-time",3223,1581,1642,-2
190415,Cornell University,2013,"All students, Undergraduate, Other degree/certificate-seeking",11086,5429,5657,-2
190415,Cornell University,2013,"All students, Undergraduate, Other degree/certifcate-seeking, Transfer-ins",542,284,258,-2
190415,Cornell University,2013,"All students, Undergraduate, Other degree/certifcate-seeking, Continuing",10544,5145,5399,-2
190415,Cornell University,2013,"All students, Undergraduate, Non-degree/certificate-seeking",84,40,44,-2
190415,Cornell University,2013,"All students, Graduate",7200,4024,3176,-2
190424,Weill Cornell Medical College,2013,All students total,1043,478,565,-2
190424,Weill Cornell Medical College,2013,"All students, Graduate",1043,478,565,-2
190503,Culinary Institute of America,2013,All students total,2814,1497,1317,-2
190503,Culinary Institute of America,2013,"All students, Undergraduate total",2814,1497,1317,-2
190503,Culinary Institute of America,2013,"All students, Undergraduate, Degree/certificate-seeking total",2814,1497,1317,-2
190503,Culinary Institute of America,2013,"All students, Undergraduate, Degree/certificate-seeking, First-time",490,252,238,-2
190503,Culinary Institute of America,2013,"All students, Undergraduate, Other degree/certificate-seeking",2324,1245,1079,-2
190503,Culinary Institute of America,2013,"All students, Undergraduate, Other degree/certifcate-seeking, Transfer-ins",219,121,98,-2
190503,Culinary Institute of America,2013,"All students, Undergraduate, Other degree/certifcate-seeking, Continuing",2105,1124,981,-2
190512,CUNY Bernard M Baruch College,2013,All students total,17505,8906,8599,-2
190512,CUNY Bernard M Baruch College,2013,"All students, Undergraduate total",14082,7275,6807,-2
190512,CUNY Bernard M Baruch College,2013,"All students, Undergraduate, Degree/certificate-seeking total",13698,7111,6587,-2
190512,CUNY Bernard M Baruch College,2013,"All students, Undergraduate, Degree/certificate-seeking, First-time",1254,708,546,-2
190512,CUNY Bernard M Baruch College,2013,"All students, Undergraduate, Other degree/certificate-seeking",12444,6403,6041,-2
190512,CUNY Bernard M Baruch College,2013,"All students, Undergraduate, Other degree/certifcate-seeking, Transfer-ins",1571,737,834,-2
190512,CUNY Bernard M Baruch College,2013,"All students, Undergraduate, Other degree/certifcate-seeking, Continuing",10873,5666,5207,-2
190512,CUNY Bernard M Baruch College,2013,"All students, Undergraduate, Non-degree/certificate-seeking",384,164,220,-2
190512,CUNY Bernard M Baruch College,2013,"All students, Graduate",3423,1631,1792,-2
190549,CUNY Brooklyn College,2013,All students total,17004,6697,10307,-2
190549,CUNY Brooklyn College,2013,"All students, Undergraduate total",13596,5568,8028,-2
190549,CUNY Brooklyn College,2013,"All students, Undergraduate, Degree/certificate-seeking total",12625,5203,7422,-2
190549,CUNY Brooklyn College,2013,"All students, Undergraduate, Degree/certificate-seeking, First-time",1193,514,679,-2
190549,CUNY Brooklyn College,2013,"All students, Undergraduate, Other degree/certificate-seeking",11432,4689,6743,-2
190549,CUNY Brooklyn College,2013,"All students, Undergraduate, Other degree/certifcate-seeking, Transfer-ins",1946,804,1142,-2
190549,CUNY Brooklyn College,2013,"All students, Undergraduate, Other degree/certifcate-seeking, Continuing",9486,3885,5601,-2
190549,CUNY Brooklyn College,2013,"All students, Undergraduate, Non-degree/certificate-seeking",971,365,606,-2
190549,CUNY Brooklyn College,2013,"All students, Graduate",3408,1129,2279,-2
190558,College of Staten Island CUNY,2013,All students total,14441,6234,8207,-2
190558,College of Staten Island CUNY,2013,"All students, Undergraduate total",13465,6000,7465,-2
190558,College of Staten Island CUNY,2013,"All students, Undergraduate, Degree/certificate-seeking total",12974,5764,7210,-2
190558,College of Staten Island CUNY,2013,"All students, Undergraduate, Degree/certificate-seeking, First-time",2807,1271,1536,-2
190558,College of Staten Island CUNY,2013,"All students, Undergraduate, Other degree/certificate-seeking",10167,4493,5674,-2
190558,College of Staten Island CUNY,2013,"All students, Undergraduate, Other degree/certifcate-seeking, Transfer-ins",562,230,332,-2
190558,College of Staten Island CUNY,2013,"All students, Undergraduate, Other degree/certifcate-seeking, Continuing",9605,4263,5342,-2
190558,College of Staten Island CUNY,2013,"All students, Undergraduate, Non-degree/certificate-seeking",491,236,255,-2
190558,College of Staten Island CUNY,2013,"All students, Graduate",976,234,742,-2
190567,CUNY City College,2013,All students total,15331,7221,8110,-2
190567,CUNY City College,2013,"All students, Undergraduate total",12501,6028,6473,-2
190567,CUNY City College,2013,"All students, Undergraduate, Degree/certificate-seeking total",11820,5725,6095,-2
190567,CUNY City College,2013,"All students, Undergraduate, Degree/certificate-seeking, First-time",1444,717,727,-2
190567,CUNY City College,2013,"All students, Undergraduate, Other degree/certificate-seeking",10376,5008,5368,-2
190567,CUNY City College,2013,"All students, Undergraduate, Other degree/certifcate-seeking, Transfer-ins",1295,600,695,-2
190567,CUNY City College,2013,"All students, Undergraduate, Other degree/certifcate-seeking, Continuing",9081,4408,4673,-2
190567,CUNY City College,2013,"All students, Undergraduate, Non-degree/certificate-seeking",681,303,378,-2
190567,CUNY City College,2013,"All students, Graduate",2830,1193,1637,-2
190576,CUNY Graduate School and University Center,2013,All students total,6736,2608,4128,-2
190576,CUNY Graduate School and University Center,2013,"All students, Undergraduate total",1347,428,919,-2
190576,CUNY Graduate School and University Center,2013,"All students, Undergraduate, Degree/certificate-seeking total",1112,347,765,-2
190576,CUNY Graduate School and University Center,2013,"All students, Undergraduate, Other degree/certificate-seeking",1112,347,765,-2
190576,CUNY Graduate School and University Center,2013,"All students, Undergraduate, Other degree/certifcate-seeking, Transfer-ins",325,100,225,-2
190576,CUNY Graduate School and University Center,2013,"All students, Undergraduate, Other degree/certifcate-seeking, Continuing",787,247,540,-2
190576,CUNY Graduate School and University Center,2013,"All students, Undergraduate, Non-degree/certificate-seeking",235,81,154,-2
190576,CUNY Graduate School and University Center,2013,"All students, Graduate",5389,2180,3209,-2
190594,CUNY Hunter College,2013,All students total,23019,7396,15623,-2
190594,CUNY Hunter College,2013,"All students, Undergraduate total",16689,5890,10799,-2
190594,CUNY Hunter College,2013,"All students, Undergraduate, Degree/certificate-seeking total",15697,5538,10159,-2
190594,CUNY Hunter College,2013,"All students, Undergraduate, Degree/certificate-seeking, First-time",1976,765,1211,-2
190594,CUNY Hunter College,2013,"All students, Undergraduate, Other degree/certificate-seeking",13721,4773,8948,-2
190594,CUNY Hunter College,2013,"All students, Undergraduate, Other degree/certifcate-seeking, Transfer-ins",1885,606,1279,-2
190594,CUNY Hunter College,2013,"All students, Undergraduate, Other degree/certifcate-seeking, Continuing",11836,4167,7669,-2
190594,CUNY Hunter College,2013,"All students, Undergraduate, Non-degree/certificate-seeking",992,352,640,-2
190594,CUNY Hunter College,2013,"All students, Graduate",6330,1506,4824,-2
190600,CUNY John Jay College of Criminal Justice,2013,All students total,15010,6437,8573,-2
190600,CUNY John Jay College of Criminal Justice,2013,"All students, Undergraduate total",13217,5781,7436,-2
190600,CUNY John Jay College of Criminal Justice,2013,"All students, Undergraduate, Degree/certificate-seeking total",12838,5639,7199,-2
190600,CUNY John Jay College of Criminal Justice,2013,"All students, Undergraduate, Degree/certificate-seeking, First-time",1861,892,969,-2
190600,CUNY John Jay College of Criminal Justice,2013,"All students, Undergraduate, Other degree/certificate-seeking",10977,4747,6230,-2
190600,CUNY John Jay College of Criminal Justice,2013,"All students, Undergraduate, Other degree/certifcate-seeking, Transfer-ins",1723,763,960,-2
190600,CUNY John Jay College of Criminal Justice,2013,"All students, Undergraduate, Other degree/certifcate-seeking, Continuing",9254,3984,5270,-2
190600,CUNY John Jay College of Criminal Justice,2013,"All students, Undergraduate, Non-degree/certificate-seeking",379,142,237,-2
190600,CUNY John Jay College of Criminal Justice,2013,"All students, Graduate",1793,656,1137,-2
190637,CUNY Lehman College,2013,All students total,12085,3683,8402,-2
190637,CUNY Lehman College,2013,"All students, Undergraduate total",9886,3133,6753,-2
190637,CUNY Lehman College,2013,"All students, Undergraduate, Degree/certificate-seeking total",9020,2849,6171,-2
190637,CUNY Lehman College,2013,"All students, Undergraduate, Degree/certificate-seeking, First-time",588,220,368,-2
190637,CUNY Lehman College,2013,"All students, Undergraduate, Other degree/certificate-seeking",8432,2629,5803,-2
190637,CUNY Lehman College,2013,"All students, Undergraduate, Other degree/certifcate-seeking, Transfer-ins",1712,497,1215,-2
190637,CUNY Lehman College,2013,"All students, Undergraduate, Other degree/certifcate-seeking, Continuing",6720,2132,4588,-2
190637,CUNY Lehman College,2013,"All students, Undergraduate, Non-degree/certificate-seeking",866,284,582,-2
190637,CUNY Lehman College,2013,"All students, Graduate",2199,550,1649,-2
190646,CUNY Medgar Evers College,2013,All students total,6477,1706,4771,-2
190646,CUNY Medgar Evers College,2013,"All students, Undergraduate total",6477,1706,4771,-2
190646,CUNY Medgar Evers College,2013,"All students, Undergraduate, Degree/certificate-seeking total",6085,1600,4485,-2
190646,CUNY Medgar Evers College,2013,"All students, Undergraduate, Degree/certificate-seeking, First-time",1045,338,707,-2
190646,CUNY Medgar Evers College,2013,"All students, Undergraduate, Other degree/certificate-seeking",5040,1262,3778,-2
190646,CUNY Medgar Evers College,2013,"All students, Undergraduate, Other degree/certifcate-seeking, Transfer-ins",559,133,426,-2
190646,CUNY Medgar Evers College,2013,"All students, Undergraduate, Other degree/certifcate-seeking, Continuing",4481,1129,3352,-2
190646,CUNY Medgar Evers College,2013,"All students, Undergraduate, Non-degree/certificate-seeking",392,106,286,-2
190655,CUNY New York City College of Technology,2013,All students total,16860,9373,7487,-2
190655,CUNY New York City College of Technology,2013,"All students, Undergraduate total",16860,9373,7487,-2
190655,CUNY New York City College of Technology,2013,"All students, Undergraduate, Degree/certificate-seeking total",15917,8919,6998,-2
190655,CUNY New York City College of Technology,2013,"All students, Undergraduate, Degree/certificate-seeking, First-time",3353,2093,1260,-2
190655,CUNY New York City College of Technology,2013,"All students, Undergraduate, Other degree/certificate-seeking",12564,6826,5738,-2
190655,CUNY New York City College of Technology,2013,"All students, Undergraduate, Other degree/certifcate-seeking, Transfer-ins",1275,573,702,-2
190655,CUNY New York City College of Technology,2013,"All students, Undergraduate, Other degree/certifcate-seeking, Continuing",11289,6253,5036,-2
190655,CUNY New York City College of Technology,2013,"All students, Undergraduate, Non-degree/certificate-seeking",943,454,489,-2
190664,CUNY Queens College,2013,All students total,18974,7720,11254,-2
190664,CUNY Queens College,2013,"All students, Undergraduate total",15351,6687,8664,-2
190664,CUNY Queens College,2013,"All students, Undergraduate, Degree/certificate-seeking total",14424,6359,8065,-2
190664,CUNY Queens College,2013,"All students, Undergraduate, Degree/certificate-seeking, First-time",1364,632,732,-2
190664,CUNY Queens College,2013,"All students, Undergraduate, Other degree/certificate-seeking",13060,5727,7333,-2
190664,CUNY Queens College,2013,"All students, Undergraduate, Other degree/certifcate-seeking, Transfer-ins",2177,947,1230,-2
190664,CUNY Queens College,2013,"All students, Undergraduate, Other degree/certifcate-seeking, Continuing",10883,4780,6103,-2
190664,CUNY Queens College,2013,"All students, Undergraduate, Non-degree/certificate-seeking",927,328,599,-2
190664,CUNY Queens College,2013,"All students, Graduate",3623,1033,2590,-2
190682,CUNY School of Law at Queens College,2013,All students total,383,151,232,-2
190682,CUNY School of Law at Queens College,2013,"All students, Graduate",383,151,232,-2
190691,CUNY York College,2013,All students total,8307,2889,5418,-2
190691,CUNY York College,2013,"All students, Undergraduate total",8261,2883,5378,-2
190691,CUNY York College,2013,"All students, Undergraduate, Degree/certificate-seeking total",7361,2526,4835,-2
190691,CUNY York College,2013,"All students, Undergraduate, Degree/certificate-seeking, First-time",994,370,624,-2
190691,CUNY York College,2013,"All students, Undergraduate, Other degree/certificate-seeking",6367,2156,4211,-2
190691,CUNY York College,2013,"All students, Undergraduate, Other degree/certifcate-seeking, Transfer-ins",760,259,501,-2
190691,CUNY York College,2013,"All students, Undergraduate, Other degree/certifcate-seeking, Continuing",5607,1897,3710,-2
190691,CUNY York College,2013,"All students, Undergraduate, Non-degree/certificate-seeking",900,357,543,-2
190691,CUNY York College,2013,"All students, Graduate",46,6,40,-2
190716,D'Youville College,2013,All students total,3150,961,2189,-2
190716,D'Youville College,2013,"All students, Undergraduate total",2023,548,1475,-2
190716,D'Youville College,2013,"All students, Undergraduate, Degree/certificate-seeking total",1855,493,1362,-2
190716,D'Youville College,2013,"All students, Undergraduate, Degree/certificate-seeking, First-time",251,65,186,-2
190716,D'Youville College,2013,"All students, Undergraduate, Other degree/certificate-seeking",1604,428,1176,-2
190716,D'Youville College,2013,"All students, Undergraduate, Other degree/certifcate-seeking, Transfer-ins",220,61,159,-2
190716,D'Youville College,2013,"All students, Undergraduate, Other degree/certifcate-seeking, Continuing",1384,367,1017,-2
190716,D'Youville College,2013,"All students, Undergraduate, Non-degree/certificate-seeking",168,55,113,-2
190716,D'Youville College,2013,"All students, Graduate",1127,413,714,-2
190725,Daemen College,2013,All students total,2871,746,2125,-2
190725,Daemen College,2013,"All students, Undergraduate total",2156,585,1571,-2
190725,Daemen College,2013,"All students, Undergraduate, Degree/certificate-seeking total",1971,534,1437,-2
190725,Daemen College,2013,"All students, Undergraduate, Degree/certificate-seeking, First-time",411,108,303,-2
190725,Daemen College,2013,"All students, Undergraduate, Other degree/certificate-seeking",1560,426,1134,-2
190725,Daemen College,2013,"All students, Undergraduate, Other degree/certifcate-seeking, Transfer-ins",319,106,213,-2
190725,Daemen College,2013,"All students, Undergraduate, Other degree/certifcate-seeking, Continuing",1241,320,921,-2
190725,Daemen College,2013,"All students, Undergraduate, Non-degree/certificate-seeking",185,51,134,-2
190725,Daemen College,2013,"All students, Graduate",715,161,554,-2
190752,Yeshiva of Far Rockaway Derech Ayson Rabbinical Seminary,2013,All students total,57,57,0,-2
190752,Yeshiva of Far Rockaway Derech Ayson Rabbinical Seminary,2013,"All students, Undergraduate total",57,57,0,-2
190752,Yeshiva of Far Rockaway Derech Ayson Rabbinical Seminary,2013,"All students, Undergraduate, Degree/certificate-seeking total",57,57,0,-2
190752,Yeshiva of Far Rockaway Derech Ayson Rabbinical Seminary,2013,"All students, Undergraduate, Degree/certificate-seeking, First-time",12,12,0,-2
190752,Yeshiva of Far Rockaway Derech Ayson Rabbinical Seminary,2013,"All students, Undergraduate, Other degree/certificate-seeking",45,45,0,-2
190752,Yeshiva of Far Rockaway Derech Ayson Rabbinical Seminary,2013,"All students, Undergraduate, Other degree/certifcate-seeking, Transfer-ins",5,5,0,-2
190752,Yeshiva of Far Rockaway Derech Ayson Rabbinical Seminary,2013,"All students, Undergraduate, Other degree/certifcate-seeking, Continuing",40,40,0,-2
190761,Dominican College of Blauvelt,2013,All students total,1998,689,1309,-2
190761,Dominican College of Blauvelt,2013,"All students, Undergraduate total",1527,526,1001,-2
190761,Dominican College of Blauvelt,2013,"All students, Undergraduate, Degree/certificate-seeking total",1505,518,987,-2
190761,Dominican College of Blauvelt,2013,"All students, Undergraduate, Degree/certificate-seeking, First-time",286,132,154,-2
190761,Dominican College of Blauvelt,2013,"All students, Undergraduate, Other degree/certificate-seeking",1219,386,833,-2
190761,Dominican College of Blauvelt,2013,"All students, Undergraduate, Other degree/certifcate-seeking, Transfer-ins",109,33,76,-2
190761,Dominican College of Blauvelt,2013,"All students, Undergraduate, Other degree/certifcate-seeking, Continuing",1110,353,757,-2
190761,Dominican College of Blauvelt,2013,"All students, Undergraduate, Non-degree/certificate-seeking",22,8,14,-2
190761,Dominican College of Blauvelt,2013,"All students, Graduate",471,163,308,-2
190770,Dowling College,2013,All students total,3198,1398,1800,-2
190770,Dowling College,2013,"All students, Undergraduate total",2314,1023,1291,-2
190770,Dowling College,2013,"All students, Undergraduate, Degree/certificate-seeking total",1708,784,924,-2
190770,Dowling College,2013,"All students, Undergraduate, Degree/certificate-seeking, First-time",247,129,118,-2
190770,Dowling College,2013,"All students, Undergraduate, Other degree/certificate-seeking",1461,655,806,-2
190770,Dowling College,2013,"All students, Undergraduate, Other degree/certifcate-seeking, Transfer-ins",139,66,73,-2
190770,Dowling College,2013,"All students, Undergraduate, Other degree/certifcate-seeking, Continuing",1322,589,733,-2
190770,Dowling College,2013,"All students, Undergraduate, Non-degree/certificate-seeking",606,239,367,-2
190770,Dowling College,2013,"All students, Graduate",884,375,509,-2
190983,Elmira College,2013,All students total,1542,432,1110,-2
190983,Elmira College,2013,"All students, Undergraduate total",1408,399,1009,-2
190983,Elmira College,2013,"All students, Undergraduate, Degree/certificate-seeking total",1315,375,940,-2
190983,Elmira College,2013,"All students, Undergraduate, Degree/certificate-seeking, First-time",318,82,236,-2
190983,Elmira College,2013,"All students, Undergraduate, Other degree/certificate-seeking",997,293,704,-2
190983,Elmira College,2013,"All students, Undergraduate, Other degree/certifcate-seeking, Transfer-ins",34,12,22,-2
190983,Elmira College,2013,"All students, Undergraduate, Other degree/certifcate-seeking, Continuing",963,281,682,-2
190983,Elmira College,2013,"All students, Undergraduate, Non-degree/certificate-seeking",93,24,69,-2
190983,Elmira College,2013,"All students, Graduate",134,33,101,-2
191126,Fashion Institute of Technology,2013,All students total,9755,1503,8252,-2
191126,Fashion Institute of Technology,2013,"All students, Undergraduate total",9566,1468,8098,-2
191126,Fashion Institute of Technology,2013,"All students, Undergraduate, Degree/certificate-seeking total",8058,1162,6896,-2
191126,Fashion Institute of Technology,2013,"All students, Undergraduate, Degree/certificate-seeking, First-time",1304,152,1152,-2
191126,Fashion Institute of Technology,2013,"All students, Undergraduate, Other degree/certificate-seeking",6754,1010,5744,-2
191126,Fashion Institute of Technology,2013,"All students, Undergraduate, Other degree/certifcate-seeking, Transfer-ins",1012,154,858,-2
191126,Fashion Institute of Technology,2013,"All students, Undergraduate, Other degree/certifcate-seeking, Continuing",5742,856,4886,-2
191126,Fashion Institute of Technology,2013,"All students, Undergraduate, Non-degree/certificate-seeking",1508,306,1202,-2
191126,Fashion Institute of Technology,2013,"All students, Graduate",189,35,154,-2
191205,Five Towns College,2013,All students total,796,550,246,-2
191205,Five Towns College,2013,"All students, Undergraduate total",760,524,236,-2
191205,Five Towns College,2013,"All students, Undergraduate, Degree/certificate-seeking total",740,515,225,-2
191205,Five Towns College,2013,"All students, Undergraduate, Degree/certificate-seeking, First-time",152,102,50,-2
191205,Five Towns College,2013,"All students, Undergraduate, Other degree/certificate-seeking",588,413,175,-2
191205,Five Towns College,2013,"All students, Undergraduate, Other degree/certifcate-seeking, Transfer-ins",63,47,16,-2
191205,Five Towns College,2013,"All students, Undergraduate, Other degree/certifcate-seeking, Continuing",525,366,159,-2
191205,Five Towns College,2013,"All students, Undergraduate, Non-degree/certificate-seeking",20,9,11,-2
191205,Five Towns College,2013,"All students, Graduate",36,26,10,-2
191241,Fordham University,2013,All students total,15097,6412,8685,-2
191241,Fordham University,2013,"All students, Undergraduate total",8345,3850,4495,-2
191241,Fordham University,2013,"All students, Undergraduate, Degree/certificate-seeking total",8193,3779,4414,-2
191241,Fordham University,2013,"All students, Undergraduate, Degree/certificate-seeking, First-time",1967,886,1081,-2
191241,Fordham University,2013,"All students, Undergraduate, Other degree/certificate-seeking",6226,2893,3333,-2
191241,Fordham University,2013,"All students, Undergraduate, Other degree/certifcate-seeking, Transfer-ins",339,158,181,-2
191241,Fordham University,2013,"All students, Undergraduate, Other degree/certifcate-seeking, Continuing",5887,2735,3152,-2
191241,Fordham University,2013,"All students, Undergraduate, Non-degree/certificate-seeking",152,71,81,-2
191241,Fordham University,2013,"All students, Graduate",6752,2562,4190,-2
191320,The General Theological Seminary,2013,All students total,81,37,44,-2
191320,The General Theological Seminary,2013,"All students, Graduate",81,37,44,-2
191515,Hamilton College,2013,All students total,1926,938,988,-2
191515,Hamilton College,2013,"All students, Undergraduate total",1926,938,988,-2
191515,Hamilton College,2013,"All students, Undergraduate, Degree/certificate-seeking total",1909,930,979,-2
191515,Hamilton College,2013,"All students, Undergraduate, Degree/certificate-seeking, First-time",491,242,249,-2
191515,Hamilton College,2013,"All students, Undergraduate, Other degree/certificate-seeking",1418,688,730,-2
191515,Hamilton College,2013,"All students, Undergraduate, Other degree/certifcate-seeking, Transfer-ins",5,4,1,-2
191515,Hamilton College,2013,"All students, Undergraduate, Other degree/certifcate-seeking, Continuing",1413,684,729,-2
191515,Hamilton College,2013,"All students, Undergraduate, Non-degree/certificate-seeking",17,8,9,-2
191533,Hartwick College,2013,All students total,1618,656,962,-2
191533,Hartwick College,2013,"All students, Undergraduate total",1618,656,962,-2
191533,Hartwick College,2013,"All students, Undergraduate, Degree/certificate-seeking total",1607,654,953,-2
191533,Hartwick College,2013,"All students, Undergraduate, Degree/certificate-seeking, First-time",528,219,309,-2
191533,Hartwick College,2013,"All students, Undergraduate, Other degree/certificate-seeking",1079,435,644,-2
191533,Hartwick College,2013,"All students, Undergraduate, Other degree/certifcate-seeking, Transfer-ins",36,14,22,-2
191533,Hartwick College,2013,"All students, Undergraduate, Other degree/certifcate-seeking, Continuing",1043,421,622,-2
191533,Hartwick College,2013,"All students, Undergraduate, Non-degree/certificate-seeking",11,2,9,-2
191597,Helene Fuld College of Nursing,2013,All students total,396,52,344,-2
191597,Helene Fuld College of Nursing,2013,"All students, Undergraduate total",396,52,344,-2
191597,Helene Fuld College of Nursing,2013,"All students, Undergraduate, Degree/certificate-seeking total",393,52,341,-2
191597,Helene Fuld College of Nursing,2013,"All students, Undergraduate, Degree/certificate-seeking, First-time",7,2,5,-2
191597,Helene Fuld College of Nursing,2013,"All students, Undergraduate, Other degree/certificate-seeking",386,50,336,-2
191597,Helene Fuld College of Nursing,2013,"All students, Undergraduate, Other degree/certifcate-seeking, Continuing",386,50,336,-2
191597,Helene Fuld College of Nursing,2013,"All students, Undergraduate, Non-degree/certificate-seeking",3,0,3,-2
191621,Hilbert College,2013,All students total,1070,479,591,-2
191621,Hilbert College,2013,"All students, Undergraduate total",1020,458,562,-2
191621,Hilbert College,2013,"All students, Undergraduate, Degree/certificate-seeking total",991,449,542,-2
191621,Hilbert College,2013,"All students, Undergraduate, Degree/certificate-seeking, First-time",188,82,106,-2
191621,Hilbert College,2013,"All students, Undergraduate, Other degree/certificate-seeking",803,367,436,-2
191621,Hilbert College,2013,"All students, Undergraduate, Other degree/certifcate-seeking, Transfer-ins",113,51,62,-2
191621,Hilbert College,2013,"All students, Undergraduate, Other degree/certifcate-seeking, Continuing",690,316,374,-2
191621,Hilbert College,2013,"All students, Undergraduate, Non-degree/certificate-seeking",29,9,20,-2
191621,Hilbert College,2013,"All students, Graduate",50,21,29,-2
191630,Hobart William Smith Colleges,2013,All students total,2372,1089,1283,-2
191630,Hobart William Smith Colleges,2013,"All students, Undergraduate total",2368,1089,1279,-2
191630,Hobart William Smith Colleges,2013,"All students, Undergraduate, Degree/certificate-seeking total",2311,1047,1264,-2
191630,Hobart William Smith Colleges,2013,"All students, Undergraduate, Degree/certificate-seeking, First-time",638,294,344,-2
191630,Hobart William Smith Colleges,2013,"All students, Undergraduate, Other degree/certificate-seeking",1673,753,920,-2
191630,Hobart William Smith Colleges,2013,"All students, Undergraduate, Other degree/certifcate-seeking, Transfer-ins",15,7,8,-2
191630,Hobart William Smith Colleges,2013,"All students, Undergraduate, Other degree/certifcate-seeking, Continuing",1658,746,912,-2
191630,Hobart William Smith Colleges,2013,"All students, Undergraduate, Non-degree/certificate-seeking",57,42,15,-2
191630,Hobart William Smith Colleges,2013,"All students, Graduate",4,0,4,-2
191649,Hofstra University,2013,All students total,10928,4843,6085,-2
191649,Hofstra University,2013,"All students, Undergraduate total",6826,3192,3634,-2
191649,Hofstra University,2013,"All students, Undergraduate, Degree/certificate-seeking total",6748,3136,3612,-2
191649,Hofstra University,2013,"All students, Undergraduate, Degree/certificate-seeking, First-time",1616,741,875,-2
191649,Hofstra University,2013,"All students, Undergraduate, Other degree/certificate-seeking",5132,2395,2737,-2
191649,Hofstra University,2013,"All students, Undergraduate, Other degree/certifcate-seeking, Transfer-ins",433,229,204,-2
191649,Hofstra University,2013,"All students, Undergraduate, Other degree/certifcate-seeking, Continuing",4699,2166,2533,-2
191649,Hofstra University,2013,"All students, Undergraduate, Non-degree/certificate-seeking",78,56,22,-2
191649,Hofstra University,2013,"All students, Graduate",4102,1651,2451,-2
191676,Houghton College,2013,All students total,1100,397,703,-2
191676,Houghton College,2013,"All students, Undergraduate total",1081,385,696,-2
191676,Houghton College,2013,"All students, Undergraduate, Degree/certificate-seeking total",1047,371,676,-2
191676,Houghton College,2013,"All students, Undergraduate, Degree/certificate-seeking, First-time",223,81,142,-2
191676,Houghton College,2013,"All students, Undergraduate, Other degree/certificate-seeking",824,290,534,-2
191676,Houghton College,2013,"All students, Undergraduate, Other degree/certifcate-seeking, Transfer-ins",70,31,39,-2
191676,Houghton College,2013,"All students, Undergraduate, Other degree/certifcate-seeking, Continuing",754,259,495,-2
191676,Houghton College,2013,"All students, Undergraduate, Non-degree/certificate-seeking",34,14,20,-2
191676,Houghton College,2013,"All students, Graduate",19,12,7,-2
191931,Iona College,2013,All students total,4241,1897,2344,-2
191931,Iona College,2013,"All students, Undergraduate total",3539,1616,1923,-2
191931,Iona College,2013,"All students, Undergraduate, Degree/certificate-seeking total",3166,1444,1722,-2
191931,Iona College,2013,"All students, Undergraduate, Degree/certificate-seeking, First-time",922,416,506,-2
191931,Iona College,2013,"All students, Undergraduate, Other degree/certificate-seeking",2244,1028,1216,-2
191931,Iona College,2013,"All students, Undergraduate, Other degree/certifcate-seeking, Transfer-ins",117,68,49,-2
191931,Iona College,2013,"All students, Undergraduate, Other degree/certifcate-seeking, Continuing",2127,960,1167,-2
191931,Iona College,2013,"All students, Undergraduate, Non-degree/certificate-seeking",373,172,201,-2
191931,Iona College,2013,"All students, Graduate",702,281,421,-2
191968,Ithaca College,2013,All students total,6723,2865,3858,-2
191968,Ithaca College,2013,"All students, Undergraduate total",6234,2725,3509,-2
191968,Ithaca College,2013,"All students, Undergraduate, Degree/certificate-seeking total",6202,2712,3490,-2
191968,Ithaca College,2013,"All students, Undergraduate, Degree/certificate-seeking, First-time",1789,748,1041,-2
191968,Ithaca College,2013,"All students, Undergraduate, Other degree/certificate-seeking",4413,1964,2449,-2
191968,Ithaca College,2013,"All students, Undergraduate, Other degree/certifcate-seeking, Transfer-ins",140,67,73,-2
191968,Ithaca College,2013,"All students, Undergraduate, Other degree/certifcate-seeking, Continuing",4273,1897,2376,-2
191968,Ithaca College,2013,"All students, Undergraduate, Non-degree/certificate-seeking",32,13,19,-2
191968,Ithaca College,2013,"All students, Graduate",489,140,349,-2
192004,Jamestown Business College,2013,All students total,275,84,191,-2
192004,Jamestown Business College,2013,"All students, Undergraduate total",275,84,191,-2
192004,Jamestown Business College,2013,"All students, Undergraduate, Degree/certificate-seeking total",275,84,191,-2
192004,Jamestown Business College,2013,"All students, Undergraduate, Degree/certificate-seeking, First-time",68,23,45,-2
192004,Jamestown Business College,2013,"All students, Undergraduate, Other degree/certificate-seeking",207,61,146,-2
192004,Jamestown Business College,2013,"All students, Undergraduate, Other degree/certifcate-seeking, Transfer-ins",45,12,33,-2
192004,Jamestown Business College,2013,"All students, Undergraduate, Other degree/certifcate-seeking, Continuing",162,49,113,-2
192040,Jewish Theological Seminary of America,2013,All students total,446,197,249,-2
192040,Jewish Theological Seminary of America,2013,"All students, Undergraduate total",163,73,90,-2
192040,Jewish Theological Seminary of America,2013,"All students, Undergraduate, Degree/certificate-seeking total",161,71,90,-2
192040,Jewish Theological Seminary of America,2013,"All students, Undergraduate, Degree/certificate-seeking, First-time",33,15,18,-2
192040,Jewish Theological Seminary of America,2013,"All students, Undergraduate, Other degree/certificate-seeking",128,56,72,-2
192040,Jewish Theological Seminary of America,2013,"All students, Undergraduate, Other degree/certifcate-seeking, Transfer-ins",2,1,1,-2
192040,Jewish Theological Seminary of America,2013,"All students, Undergraduate, Other degree/certifcate-seeking, Continuing",126,55,71,-2
192040,Jewish Theological Seminary of America,2013,"All students, Undergraduate, Non-degree/certificate-seeking",2,2,0,-2
192040,Jewish Theological Seminary of America,2013,"All students, Graduate",283,124,159,-2
192110,The Juilliard School,2013,All students total,927,515,412,-2
192110,The Juilliard School,2013,"All students, Undergraduate total",581,324,257,-2
192110,The Juilliard School,2013,"All students, Undergraduate, Degree/certificate-seeking total",498,275,223,-2
192110,The Juilliard School,2013,"All students, Undergraduate, Degree/certificate-seeking, First-time",109,58,51,-2
192110,The Juilliard School,2013,"All students, Undergraduate, Other degree/certificate-seeking",389,217,172,-2
192110,The Juilliard School,2013,"All students, Undergraduate, Other degree/certifcate-seeking, Transfer-ins",11,5,6,-2
192110,The Juilliard School,2013,"All students, Undergraduate, Other degree/certifcate-seeking, Continuing",378,212,166,-2
192110,The Juilliard School,2013,"All students, Undergraduate, Non-degree/certificate-seeking",83,49,34,-2
192110,The Juilliard School,2013,"All students, Graduate",346,191,155,-2
192165,Kehilath Yakov Rabbinical Seminary,2013,All students total,120,120,0,-2
192165,Kehilath Yakov Rabbinical Seminary,2013,"All students, Undergraduate total",120,120,0,-2
192165,Kehilath Yakov Rabbinical Seminary,2013,"All students, Undergraduate, Degree/certificate-seeking total",120,120,0,-2
192165,Kehilath Yakov Rabbinical Seminary,2013,"All students, Undergraduate, Degree/certificate-seeking, First-time",44,44,0,-2
192165,Kehilath Yakov Rabbinical Seminary,2013,"All students, Undergraduate, Other degree/certificate-seeking",76,76,0,-2
192165,Kehilath Yakov Rabbinical Seminary,2013,"All students, Undergraduate, Other degree/certifcate-seeking, Continuing",76,76,0,-2
192192,Keuka College,2013,All students total,2036,470,1566,-2
192192,Keuka College,2013,"All students, Undergraduate total",1830,429,1401,-2
192192,Keuka College,2013,"All students, Undergraduate, Degree/certificate-seeking total",1830,429,1401,-2
192192,Keuka College,2013,"All students, Undergraduate, Degree/certificate-seeking, First-time",241,64,177,-2
192192,Keuka College,2013,"All students, Undergraduate, Other degree/certificate-seeking",1589,365,1224,-2
192192,Keuka College,2013,"All students, Undergraduate, Other degree/certifcate-seeking, Transfer-ins",328,56,272,-2
192192,Keuka College,2013,"All students, Undergraduate, Other degree/certifcate-seeking, Continuing",1261,309,952,-2
192192,Keuka College,2013,"All students, Graduate",206,41,165,-2
192271,LIM College,2013,All students total,1647,116,1531,-2
192271,LIM College,2013,"All students, Undergraduate total",1513,106,1407,-2
192271,LIM College,2013,"All students, Undergraduate, Degree/certificate-seeking total",1508,106,1402,-2
192271,LIM College,2013,"All students, Undergraduate, Degree/certificate-seeking, First-time",296,19,277,-2
192271,LIM College,2013,"All students, Undergraduate, Other degree/certificate-seeking",1212,87,1125,-2
192271,LIM College,2013,"All students, Undergraduate, Other degree/certifcate-seeking, Transfer-ins",154,16,138,-2
192271,LIM College,2013,"All students, Undergraduate, Other degree/certifcate-seeking, Continuing",1058,71,987,-2
192271,LIM College,2013,"All students, Undergraduate, Non-degree/certificate-seeking",5,0,5,-2
192271,LIM College,2013,"All students, Graduate",134,10,124,-2
192323,Le Moyne College,2013,All students total,3319,1327,1992,-2
192323,Le Moyne College,2013,"All students, Undergraduate total",2785,1153,1632,-2
192323,Le Moyne College,2013,"All students, Undergraduate, Degree/certificate-seeking total",2619,1112,1507,-2
192323,Le Moyne College,2013,"All students, Undergraduate, Degree/certificate-seeking, First-time",622,257,365,-2
192323,Le Moyne College,2013,"All students, Undergraduate, Other degree/certificate-seeking",1997,855,1142,-2
192323,Le Moyne College,2013,"All students, Undergraduate, Other degree/certifcate-seeking, Transfer-ins",169,79,90,-2
192323,Le Moyne College,2013,"All students, Undergraduate, Other degree/certifcate-seeking, Continuing",1828,776,1052,-2
192323,Le Moyne College,2013,"All students, Undergraduate, Non-degree/certificate-seeking",166,41,125,-2
192323,Le Moyne College,2013,"All students, Graduate",534,174,360,-2
192439,LIU Brooklyn,2013,All students total,8483,2499,5984,-2
192439,LIU Brooklyn,2013,"All students, Undergraduate total",5006,1492,3514,-2
192439,LIU Brooklyn,2013,"All students, Undergraduate, Degree/certificate-seeking total",4905,1464,3441,-2
192439,LIU Brooklyn,2013,"All students, Undergraduate, Degree/certificate-seeking, First-time",877,322,555,-2
192439,LIU Brooklyn,2013,"All students, Undergraduate, Other degree/certificate-seeking",4028,1142,2886,-2
192439,LIU Brooklyn,2013,"All students, Undergraduate, Other degree/certifcate-seeking, Transfer-ins",679,184,495,-2
192439,LIU Brooklyn,2013,"All students, Undergraduate, Other degree/certifcate-seeking, Continuing",3349,958,2391,-2
192439,LIU Brooklyn,2013,"All students, Undergraduate, Non-degree/certificate-seeking",101,28,73,-2
192439,LIU Brooklyn,2013,"All students, Graduate",3477,1007,2470,-2
192448,LIU Post,2013,All students total,10599,4089,6510,-2
192448,LIU Post,2013,"All students, Undergraduate total",7983,3381,4602,-2
192448,LIU Post,2013,"All students, Undergraduate, Degree/certificate-seeking total",4067,1591,2476,-2
192448,LIU Post,2013,"All students, Undergraduate, Degree/certificate-seeking, First-time",659,271,388,-2
192448,LIU Post,2013,"All students, Undergraduate, Other degree/certificate-seeking",3408,1320,2088,-2
192448,LIU Post,2013,"All students, Undergraduate, Other degree/certifcate-seeking, Transfer-ins",437,159,278,-2
192448,LIU Post,2013,"All students, Undergraduate, Other degree/certifcate-seeking, Continuing",2971,1161,1810,-2
192448,LIU Post,2013,"All students, Undergraduate, Non-degree/certificate-seeking",3916,1790,2126,-2
192448,LIU Post,2013,"All students, Graduate",2616,708,1908,-2
192457,LIU-University Center Campus,2013,,,,,-2
192554,LIU Hudson at Rockland,2013,All students total,259,48,211,-2
192554,LIU Hudson at Rockland,2013,"All students, Graduate",259,48,211,-2
192563,LIU Brentwood,2013,All students total,270,39,231,-2
192563,LIU Brentwood,2013,"All students, Undergraduate total",23,9,14,-2
192563,LIU Brentwood,2013,"All students, Undergraduate, Degree/certificate-seeking total",23,9,14,-2
192563,LIU Brentwood,2013,"All students, Undergraduate, Other degree/certificate-seeking",23,9,14,-2
192563,LIU Brentwood,2013,"All students, Undergraduate, Other degree/certifcate-seeking, Transfer-ins",7,3,4,-2
192563,LIU Brentwood,2013,"All students, Undergraduate, Other degree/certifcate-seeking, Continuing",16,6,10,-2
192563,LIU Brentwood,2013,"All students, Graduate",247,30,217,-2
192624,Machzikei Hadath Rabbinical College,2013,All students total,148,148,0,-2
192624,Machzikei Hadath Rabbinical College,2013,"All students, Undergraduate total",148,148,0,-2
192624,Machzikei Hadath Rabbinical College,2013,"All students, Undergraduate, Degree/certificate-seeking total",148,148,0,-2
192624,Machzikei Hadath Rabbinical College,2013,"All students, Undergraduate, Degree/certificate-seeking, First-time",27,27,0,-2
192624,Machzikei Hadath Rabbinical College,2013,"All students, Undergraduate, Other degree/certificate-seeking",121,121,0,-2
192624,Machzikei Hadath Rabbinical College,2013,"All students, Undergraduate, Other degree/certifcate-seeking, Transfer-ins",17,17,0,-2
192624,Machzikei Hadath Rabbinical College,2013,"All students, Undergraduate, Other degree/certifcate-seeking, Continuing",104,104,0,-2
192703,Manhattan College,2013,All students total,3883,2110,1773,-2
192703,Manhattan College,2013,"All students, Undergraduate total",3403,1889,1514,-2
192703,Manhattan College,2013,"All students, Undergraduate, Degree/certificate-seeking total",3403,1889,1514,-2
192703,Manhattan College,2013,"All students, Undergraduate, Degree/certificate-seeking, First-time",757,400,357,-2
192703,Manhattan College,2013,"All students, Undergraduate, Other degree/certificate-seeking",2646,1489,1157,-2
192703,Manhattan College,2013,"All students, Undergraduate, Other degree/certifcate-seeking, Transfer-ins",155,81,74,-2
192703,Manhattan College,2013,"All students, Undergraduate, Other degree/certifcate-seeking, Continuing",2491,1408,1083,-2
192703,Manhattan College,2013,"All students, Graduate",480,221,259,-2
192712,Manhattan School of Music,2013,All students total,885,391,494,-2
192712,Manhattan School of Music,2013,"All students, Undergraduate total",377,158,219,-2
192712,Manhattan School of Music,2013,"All students, Undergraduate, Degree/certificate-seeking total",377,158,219,-2
192712,Manhattan School of Music,2013,"All students, Undergraduate, Degree/certificate-seeking, First-time",81,32,49,-2
192712,Manhattan School of Music,2013,"All students, Undergraduate, Other degree/certificate-seeking",296,126,170,-2
192712,Manhattan School of Music,2013,"All students, Undergraduate, Other degree/certifcate-seeking, Transfer-ins",22,12,10,-2
192712,Manhattan School of Music,2013,"All students, Undergraduate, Other degree/certifcate-seeking, Continuing",274,114,160,-2
192712,Manhattan School of Music,2013,"All students, Graduate",508,233,275,-2
192749,Manhattanville College,2013,All students total,2750,945,1805,-2
192749,Manhattanville College,2013,"All students, Undergraduate total",1719,619,1100,-2
192749,Manhattanville College,2013,"All students, Undergraduate, Degree/certificate-seeking total",1671,602,1069,-2
192749,Manhattanville College,2013,"All students, Undergraduate, Degree/certificate-seeking, First-time",480,168,312,-2
192749,Manhattanville College,2013,"All students, Undergraduate, Other degree/certificate-seeking",1191,434,757,-2
192749,Manhattanville College,2013,"All students, Undergraduate, Other degree/certifcate-seeking, Transfer-ins",59,28,31,-2
192749,Manhattanville College,2013,"All students, Undergraduate, Other degree/certifcate-seeking, Continuing",1132,406,726,-2
192749,Manhattanville College,2013,"All students, Undergraduate, Non-degree/certificate-seeking",48,17,31,-2
192749,Manhattanville College,2013,"All students, Graduate",1031,326,705,-2
192785,Maria College of Albany,2013,All students total,880,95,785,-2
192785,Maria College of Albany,2013,"All students, Undergraduate total",880,95,785,-2
192785,Maria College of Albany,2013,"All students, Undergraduate, Degree/certificate-seeking total",866,93,773,-2
192785,Maria College of Albany,2013,"All students, Undergraduate, Degree/certificate-seeking, First-time",53,10,43,-2
192785,Maria College of Albany,2013,"All students, Undergraduate, Other degree/certificate-seeking",813,83,730,-2
192785,Maria College of Albany,2013,"All students, Undergraduate, Other degree/certifcate-seeking, Transfer-ins",205,26,179,-2
192785,Maria College of Albany,2013,"All students, Undergraduate, Other degree/certifcate-seeking, Continuing",608,57,551,-2
192785,Maria College of Albany,2013,"All students, Undergraduate, Non-degree/certificate-seeking",14,2,12,-2
192819,Marist College,2013,All students total,6365,2663,3702,-2
192819,Marist College,2013,"All students, Undergraduate total",5566,2295,3271,-2
192819,Marist College,2013,"All students, Undergraduate, Degree/certificate-seeking total",5295,2178,3117,-2
192819,Marist College,2013,"All students, Undergraduate, Degree/certificate-seeking, First-time",1149,466,683,-2
192819,Marist College,2013,"All students, Undergraduate, Other degree/certificate-seeking",4146,1712,2434,-2
192819,Marist College,2013,"All students, Undergraduate, Other degree/certifcate-seeking, Transfer-ins",149,65,84,-2
192819,Marist College,2013,"All students, Undergraduate, Other degree/certifcate-seeking, Continuing",3997,1647,2350,-2
192819,Marist College,2013,"All students, Undergraduate, Non-degree/certificate-seeking",271,117,154,-2
192819,Marist College,2013,"All students, Graduate",799,368,431,-2
192864,Marymount Manhattan College,2013,All students total,1833,419,1414,-2
192864,Marymount Manhattan College,2013,"All students, Undergraduate total",1833,419,1414,-2
192864,Marymount Manhattan College,2013,"All students, Undergraduate, Degree/certificate-seeking total",1783,402,1381,-2
192864,Marymount Manhattan College,2013,"All students, Undergraduate, Degree/certificate-seeking, First-time",418,101,317,-2
192864,Marymount Manhattan College,2013,"All students, Undergraduate, Other degree/certificate-seeking",1365,301,1064,-2
192864,Marymount Manhattan College,2013,"All students, Undergraduate, Other degree/certifcate-seeking, Transfer-ins",124,30,94,-2
192864,Marymount Manhattan College,2013,"All students, Undergraduate, Other degree/certifcate-seeking, Continuing",1241,271,970,-2
192864,Marymount Manhattan College,2013,"All students, Undergraduate, Non-degree/certificate-seeking",50,17,33,-2
192925,Medaille College,2013,All students total,2390,730,1660,-2
192925,Medaille College,2013,"All students, Undergraduate total",1727,576,1151,-2
192925,Medaille College,2013,"All students, Undergraduate, Degree/certificate-seeking total",1716,575,1141,-2
192925,Medaille College,2013,"All students, Undergraduate, Degree/certificate-seeking, First-time",443,146,297,-2
192925,Medaille College,2013,"All students, Undergraduate, Other degree/certificate-seeking",1273,429,844,-2
192925,Medaille College,2013,"All students, Undergraduate, Other degree/certifcate-seeking, Transfer-ins",178,48,130,-2
192925,Medaille College,2013,"All students, Undergraduate, Other degree/certifcate-seeking, Continuing",1095,381,714,-2
192925,Medaille College,2013,"All students, Undergraduate, Non-degree/certificate-seeking",11,1,10,-2
192925,Medaille College,2013,"All students, Graduate",663,154,509,-2
193016,Mercy College,2013,All students total,11648,3182,8466,-2
193016,Mercy College,2013,"All students, Undergraduate total",8154,2497,5657,-2
193016,Mercy College,2013,"All students, Undergraduate, Degree/certificate-seeking total",6897,2076,4821,-2
193016,Mercy College,2013,"All students, Undergraduate, Degree/certificate-seeking, First-time",834,244,590,-2
193016,Mercy College,2013,"All students, Undergraduate, Other degree/certificate-seeking",6063,1832,4231,-2
193016,Mercy College,2013,"All students, Undergraduate, Other degree/certifcate-seeking, Transfer-ins",1003,268,735,-2
193016,Mercy College,2013,"All students, Undergraduate, Other degree/certifcate-seeking, Continuing",5060,1564,3496,-2
193016,Mercy College,2013,"All students, Undergraduate, Non-degree/certificate-seeking",1257,421,836,-2
193016,Mercy College,2013,"All students, Graduate",3494,685,2809,-2
193052,Mesivta Torah Vodaath Rabbinical Seminary,2013,All students total,279,279,0,-2
193052,Mesivta Torah Vodaath Rabbinical Seminary,2013,"All students, Undergraduate total",207,207,0,-2
193052,Mesivta Torah Vodaath Rabbinical Seminary,2013,"All students, Undergraduate, Degree/certificate-seeking total",207,207,0,-2
193052,Mesivta Torah Vodaath Rabbinical Seminary,2013,"All students, Undergraduate, Degree/certificate-seeking, First-time",17,17,0,-2
193052,Mesivta Torah Vodaath Rabbinical Seminary,2013,"All students, Undergraduate, Other degree/certificate-seeking",190,190,0,-2
193052,Mesivta Torah Vodaath Rabbinical Seminary,2013,"All students, Undergraduate, Other degree/certifcate-seeking, Transfer-ins",102,102,0,-2
193052,Mesivta Torah Vodaath Rabbinical Seminary,2013,"All students, Undergraduate, Other degree/certifcate-seeking, Continuing",88,88,0,-2
193052,Mesivta Torah Vodaath Rabbinical Seminary,2013,"All students, Graduate",72,72,0,-2
193061,Mesivta of Eastern Parkway-Yeshiva Zichron Meilech,2013,All students total,36,36,0,-2
193061,Mesivta of Eastern Parkway-Yeshiva Zichron Meilech,2013,"All students, Undergraduate total",33,33,0,-2
193061,Mesivta of Eastern Parkway-Yeshiva Zichron Meilech,2013,"All students, Undergraduate, Degree/certificate-seeking total",33,33,0,-2
193061,Mesivta of Eastern Parkway-Yeshiva Zichron Meilech,2013,"All students, Undergraduate, Degree/certificate-seeking, First-time",4,4,0,-2
193061,Mesivta of Eastern Parkway-Yeshiva Zichron Meilech,2013,"All students, Undergraduate, Other degree/certificate-seeking",29,29,0,-2
193061,Mesivta of Eastern Parkway-Yeshiva Zichron Meilech,2013,"All students, Undergraduate, Other degree/certifcate-seeking, Transfer-ins",1,1,0,-2
193061,Mesivta of Eastern Parkway-Yeshiva Zichron Meilech,2013,"All students, Undergraduate, Other degree/certifcate-seeking, Continuing",28,28,0,-2
193061,Mesivta of Eastern Parkway-Yeshiva Zichron Meilech,2013,"All students, Graduate",3,3,0,-2
193070,Mesivtha Tifereth Jerusalem of America,2013,All students total,80,80,0,-2
193070,Mesivtha Tifereth Jerusalem of America,2013,"All students, Undergraduate total",50,50,0,-2
193070,Mesivtha Tifereth Jerusalem of America,2013,"All students, Undergraduate, Degree/certificate-seeking total",50,50,0,-2
193070,Mesivtha Tifereth Jerusalem of America,2013,"All students, Undergraduate, Degree/certificate-seeking, First-time",12,12,0,-2
193070,Mesivtha Tifereth Jerusalem of America,2013,"All students, Undergraduate, Other degree/certificate-seeking",38,38,0,-2
193070,Mesivtha Tifereth Jerusalem of America,2013,"All students, Undergraduate, Other degree/certifcate-seeking, Continuing",38,38,0,-2
193070,Mesivtha Tifereth Jerusalem of America,2013,"All students, Graduate",30,30,0,-2
193247,Mirrer Yeshiva Cent Institute,2013,All students total,224,224,0,-2
193247,Mirrer Yeshiva Cent Institute,2013,"All students, Undergraduate total",160,160,0,-2
193247,Mirrer Yeshiva Cent Institute,2013,"All students, Undergraduate, Degree/certificate-seeking total",160,160,0,-2
193247,Mirrer Yeshiva Cent Institute,2013,"All students, Undergraduate, Degree/certificate-seeking, First-time",34,34,0,-2
193247,Mirrer Yeshiva Cent Institute,2013,"All students, Undergraduate, Other degree/certificate-seeking",126,126,0,-2
193247,Mirrer Yeshiva Cent Institute,2013,"All students, Undergraduate, Other degree/certifcate-seeking, Transfer-ins",12,12,0,-2
193247,Mirrer Yeshiva Cent Institute,2013,"All students, Undergraduate, Other degree/certifcate-seeking, Continuing",114,114,0,-2
193247,Mirrer Yeshiva Cent Institute,2013,"All students, Graduate",64,64,0,-2
193292,Molloy College,2013,All students total,4455,1108,3347,-2
193292,Molloy College,2013,"All students, Undergraduate total",3375,880,2495,-2
193292,Molloy College,2013,"All students, Undergraduate, Degree/certificate-seeking total",3322,867,2455,-2
193292,Molloy College,2013,"All students, Undergraduate, Degree/certificate-seeking, First-time",501,165,336,-2
193292,Molloy College,2013,"All students, Undergraduate, Other degree/certificate-seeking",2821,702,2119,-2
193292,Molloy College,2013,"All students, Undergraduate, Other degree/certifcate-seeking, Transfer-ins",384,93,291,-2
193292,Molloy College,2013,"All students, Undergraduate, Other degree/certifcate-seeking, Continuing",2437,609,1828,-2
193292,Molloy College,2013,"All students, Undergraduate, Non-degree/certificate-seeking",53,13,40,-2
193292,Molloy College,2013,"All students, Graduate",1080,228,852,-2
193308,Monroe College,2013,All students total,7215,2585,4630,-2
193308,Monroe College,2013,"All students, Undergraduate total",6794,2456,4338,-2
193308,Monroe College,2013,"All students, Undergraduate, Degree/certificate-seeking total",6426,2314,4112,-2
193308,Monroe College,2013,"All students, Undergraduate, Degree/certificate-seeking, First-time",1208,534,674,-2
193308,Monroe College,2013,"All students, Undergraduate, Other degree/certificate-seeking",5218,1780,3438,-2
193308,Monroe College,2013,"All students, Undergraduate, Other degree/certifcate-seeking, Transfer-ins",2391,777,1614,-2
193308,Monroe College,2013,"All students, Undergraduate, Other degree/certifcate-seeking, Continuing",2827,1003,1824,-2
193308,Monroe College,2013,"All students, Undergraduate, Non-degree/certificate-seeking",368,142,226,-2
193308,Monroe College,2013,"All students, Graduate",421,129,292,-2
193353,Mount Saint Mary College,2013,All students total,2556,754,1802,-2
193353,Mount Saint Mary College,2013,"All students, Undergraduate total",2203,659,1544,-2
193353,Mount Saint Mary College,2013,"All students, Undergraduate, Degree/certificate-seeking total",2155,623,1532,-2
193353,Mount Saint Mary College,2013,"All students, Undergraduate, Degree/certificate-seeking, First-time",449,130,319,-2
193353,Mount Saint Mary College,2013,"All students, Undergraduate, Other degree/certificate-seeking",1706,493,1213,-2
193353,Mount Saint Mary College,2013,"All students, Undergraduate, Other degree/certifcate-seeking, Transfer-ins",199,53,146,-2
193353,Mount Saint Mary College,2013,"All students, Undergraduate, Other degree/certifcate-seeking, Continuing",1507,440,1067,-2
193353,Mount Saint Mary College,2013,"All students, Undergraduate, Non-degree/certificate-seeking",48,36,12,-2
193353,Mount Saint Mary College,2013,"All students, Graduate",353,95,258,-2
193399,College of Mount Saint Vincent,2013,All students total,1938,520,1418,-2
193399,College of Mount Saint Vincent,2013,"All students, Undergraduate total",1669,466,1203,-2
193399,College of Mount Saint Vincent,2013,"All students, Undergraduate, Degree/certificate-seeking total",1635,461,1174,-2
193399,College of Mount Saint Vincent,2013,"All students, Undergraduate, Degree/certificate-seeking, First-time",386,114,272,-2
193399,College of Mount Saint Vincent,2013,"All students, Undergraduate, Other degree/certificate-seeking",1249,347,902,-2
193399,College of Mount Saint Vincent,2013,"All students, Undergraduate, Other degree/certifcate-seeking, Transfer-ins",98,32,66,-2
193399,College of Mount Saint Vincent,2013,"All students, Undergraduate, Other degree/certifcate-seeking, Continuing",1151,315,836,-2
193399,College of Mount Saint Vincent,2013,"All students, Undergraduate, Non-degree/certificate-seeking",34,5,29,-2
193399,College of Mount Saint Vincent,2013,"All students, Graduate",269,54,215,-2
193405,Icahn School of Medicine at Mount Sinai,2013,All students total,1090,512,578,-2
193405,Icahn School of Medicine at Mount Sinai,2013,"All students, Graduate",1090,512,578,-2
193584,Nazareth College,2013,All students total,2823,716,2107,-2
193584,Nazareth College,2013,"All students, Undergraduate total",2034,548,1486,-2
193584,Nazareth College,2013,"All students, Undergraduate, Degree/certificate-seeking total",1995,530,1465,-2
193584,Nazareth College,2013,"All students, Undergraduate, Degree/certificate-seeking, First-time",423,112,311,-2
193584,Nazareth College,2013,"All students, Undergraduate, Other degree/certificate-seeking",1572,418,1154,-2
193584,Nazareth College,2013,"All students, Undergraduate, Other degree/certifcate-seeking, Transfer-ins",168,49,119,-2
193584,Nazareth College,2013,"All students, Undergraduate, Other degree/certifcate-seeking, Continuing",1404,369,1035,-2
193584,Nazareth College,2013,"All students, Undergraduate, Non-degree/certificate-seeking",39,18,21,-2
193584,Nazareth College,2013,"All students, Graduate",789,168,621,-2
193645,The College of New Rochelle,2013,All students total,3966,419,3547,-2
193645,The College of New Rochelle,2013,"All students, Undergraduate total",3225,335,2890,-2
193645,The College of New Rochelle,2013,"All students, Undergraduate, Degree/certificate-seeking total",3207,333,2874,-2
193645,The College of New Rochelle,2013,"All students, Undergraduate, Degree/certificate-seeking, First-time",492,64,428,-2
193645,The College of New Rochelle,2013,"All students, Undergraduate, Other degree/certificate-seeking",2715,269,2446,-2
193645,The College of New Rochelle,2013,"All students, Undergraduate, Other degree/certifcate-seeking, Transfer-ins",236,25,211,-2
193645,The College of New Rochelle,2013,"All students, Undergraduate, Other degree/certifcate-seeking, Continuing",2479,244,2235,-2
193645,The College of New Rochelle,2013,"All students, Undergraduate, Non-degree/certificate-seeking",18,2,16,-2
193645,The College of New Rochelle,2013,"All students, Graduate",741,84,657,-2
193654,The New School,2013,All students total,10301,3172,7129,-2
193654,The New School,2013,"All students, Undergraduate total",6777,1890,4887,-2
193654,The New School,2013,"All students, Undergraduate, Degree/certificate-seeking total",6581,1820,4761,-2
193654,The New School,2013,"All students, Undergraduate, Degree/certificate-seeking, First-time",1038,295,743,-2
193654,The New School,2013,"All students, Undergraduate, Other degree/certificate-seeking",5543,1525,4018,-2
193654,The New School,2013,"All students, Undergraduate, Other degree/certifcate-seeking, Transfer-ins",965,246,719,-2
193654,The New School,2013,"All students, Undergraduate, Other degree/certifcate-seeking, Continuing",4578,1279,3299,-2
193654,The New School,2013,"All students, Undergraduate, Non-degree/certificate-seeking",196,70,126,-2
193654,The New School,2013,"All students, Graduate",3524,1282,2242,-2
193751,New York Chiropractic College,2013,All students total,923,480,443,-2
193751,New York Chiropractic College,2013,"All students, Graduate",923,480,443,-2
193821,New York Law School,2013,All students total,1261,624,637,-2
193821,New York Law School,2013,"All students, Graduate",1261,624,637,-2
193830,New York Medical College,2013,All students total,1427,611,816,-2
193830,New York Medical College,2013,"All students, Graduate",1427,611,816,-2
193894,New York Theological Seminary,2013,All students total,396,200,196,-2
193894,New York Theological Seminary,2013,"All students, Graduate",396,200,196,-2
193900,New York University,2013,All students total,44599,18619,25980,-2
193900,New York University,2013,"All students, Undergraduate total",22615,9066,13549,-2
193900,New York University,2013,"All students, Undergraduate, Degree/certificate-seeking total",22172,8889,13283,-2
193900,New York University,2013,"All students, Undergraduate, Degree/certificate-seeking, First-time",5207,2083,3124,-2
193900,New York University,2013,"All students, Undergraduate, Other degree/certificate-seeking",16965,6806,10159,-2
193900,New York University,2013,"All students, Undergraduate, Other degree/certifcate-seeking, Transfer-ins",891,276,615,-2
193900,New York University,2013,"All students, Undergraduate, Other degree/certifcate-seeking, Continuing",16074,6530,9544,-2
193900,New York University,2013,"All students, Undergraduate, Non-degree/certificate-seeking",443,177,266,-2
193900,New York University,2013,"All students, Graduate",21984,9553,12431,-2
193973,Niagara University,2013,All students total,4056,1588,2468,-2
193973,Niagara University,2013,"All students, Undergraduate total",2896,1211,1685,-2
193973,Niagara University,2013,"All students, Undergraduate, Degree/certificate-seeking total",2841,1181,1660,-2
193973,Niagara University,2013,"All students, Undergraduate, Degree/certificate-seeking, First-time",700,294,406,-2
193973,Niagara University,2013,"All students, Undergraduate, Other degree/certificate-seeking",2141,887,1254,-2
193973,Niagara University,2013,"All students, Undergraduate, Other degree/certifcate-seeking, Transfer-ins",610,258,352,-2
193973,Niagara University,2013,"All students, Undergraduate, Other degree/certifcate-seeking, Continuing",1531,629,902,-2
193973,Niagara University,2013,"All students, Undergraduate, Non-degree/certificate-seeking",55,30,25,-2
193973,Niagara University,2013,"All students, Graduate",1160,377,783,-2
194073,New York College of Podiatric Medicine,2013,All students total,382,206,176,-2
194073,New York College of Podiatric Medicine,2013,"All students, Graduate",382,206,176,-2
194091,New York Institute of Technology,2013,All students total,7545,4320,3225,-2
194091,New York Institute of Technology,2013,"All students, Undergraduate total",4456,2793,1663,-2
194091,New York Institute of Technology,2013,"All students, Undergraduate, Degree/certificate-seeking total",4307,2708,1599,-2
194091,New York Institute of Technology,2013,"All students, Undergraduate, Degree/certificate-seeking, First-time",838,551,287,-2
194091,New York Institute of Technology,2013,"All students, Undergraduate, Other degree/certificate-seeking",3469,2157,1312,-2
194091,New York Institute of Technology,2013,"All students, Undergraduate, Other degree/certifcate-seeking, Transfer-ins",396,216,180,-2
194091,New York Institute of Technology,2013,"All students, Undergraduate, Other degree/certifcate-seeking, Continuing",3073,1941,1132,-2
194091,New York Institute of Technology,2013,"All students, Undergraduate, Non-degree/certificate-seeking",149,85,64,-2
194091,New York Institute of Technology,2013,"All students, Graduate",3089,1527,1562,-2
194116,New York School of Interior Design,2013,All students total,589,82,507,-2
194116,New York School of Interior Design,2013,"All students, Undergraduate total",451,55,396,-2
194116,New York School of Interior Design,2013,"All students, Undergraduate, Degree/certificate-seeking total",394,49,345,-2
194116,New York School of Interior Design,2013,"All students, Undergraduate, Degree/certificate-seeking, First-time",32,2,30,-2
194116,New York School of Interior Design,2013,"All students, Undergraduate, Other degree/certificate-seeking",362,47,315,-2
194116,New York School of Interior Design,2013,"All students, Undergraduate, Other degree/certifcate-seeking, Transfer-ins",67,10,57,-2
194116,New York School of Interior Design,2013,"All students, Undergraduate, Other degree/certifcate-seeking, Continuing",295,37,258,-2
194116,New York School of Interior Design,2013,"All students, Undergraduate, Non-degree/certificate-seeking",57,6,51,-2
194116,New York School of Interior Design,2013,"All students, Graduate",138,27,111,-2
194161,Nyack College,2013,All students total,3082,1272,1810,-2
194161,Nyack College,2013,"All students, Undergraduate total",1831,721,1110,-2
194161,Nyack College,2013,"All students, Undergraduate, Degree/certificate-seeking total",1818,720,1098,-2
194161,Nyack College,2013,"All students, Undergraduate, Degree/certificate-seeking, First-time",265,118,147,-2
194161,Nyack College,2013,"All students, Undergraduate, Other degree/certificate-seeking",1553,602,951,-2
194161,Nyack College,2013,"All students, Undergraduate, Other degree/certifcate-seeking, Transfer-ins",226,87,139,-2
194161,Nyack College,2013,"All students, Undergraduate, Other degree/certifcate-seeking, Continuing",1327,515,812,-2
194161,Nyack College,2013,"All students, Undergraduate, Non-degree/certificate-seeking",13,1,12,-2
194161,Nyack College,2013,"All students, Graduate",1251,551,700,-2
194189,Ohr Hameir Theological Seminary,2013,All students total,94,94,0,-2
194189,Ohr Hameir Theological Seminary,2013,"All students, Undergraduate total",94,94,0,-2
194189,Ohr Hameir Theological Seminary,2013,"All students, Undergraduate, Degree/certificate-seeking total",94,94,0,-2
194189,Ohr Hameir Theological Seminary,2013,"All students, Undergraduate, Degree/certificate-seeking, First-time",1,1,0,-2
194189,Ohr Hameir Theological Seminary,2013,"All students, Undergraduate, Other degree/certificate-seeking",93,93,0,-2
194189,Ohr Hameir Theological Seminary,2013,"All students, Undergraduate, Other degree/certifcate-seeking, Transfer-ins",2,2,0,-2
194189,Ohr Hameir Theological Seminary,2013,"All students, Undergraduate, Other degree/certifcate-seeking, Continuing",91,91,0,-2
194310,Pace University-New York,2013,All students total,12624,4986,7638,-2
194310,Pace University-New York,2013,"All students, Undergraduate total",8289,3398,4891,-2
194310,Pace University-New York,2013,"All students, Undergraduate, Degree/certificate-seeking total",7883,3221,4662,-2
194310,Pace University-New York,2013,"All students, Undergraduate, Degree/certificate-seeking, First-time",1804,675,1129,-2
194310,Pace University-New York,2013,"All students, Undergraduate, Other degree/certificate-seeking",6079,2546,3533,-2
194310,Pace University-New York,2013,"All students, Undergraduate, Other degree/certifcate-seeking, Transfer-ins",530,229,301,-2
194310,Pace University-New York,2013,"All students, Undergraduate, Other degree/certifcate-seeking, Continuing",5549,2317,3232,-2
194310,Pace University-New York,2013,"All students, Undergraduate, Non-degree/certificate-seeking",406,177,229,-2
194310,Pace University-New York,2013,"All students, Graduate",4335,1588,2747,-2
194392,Paul Smiths College of Arts and Science,2013,All students total,981,646,335,-2
194392,Paul Smiths College of Arts and Science,2013,"All students, Undergraduate total",981,646,335,-2
194392,Paul Smiths College of Arts and Science,2013,"All students, Undergraduate, Degree/certificate-seeking total",978,644,334,-2
194392,Paul Smiths College of Arts and Science,2013,"All students, Undergraduate, Degree/certificate-seeking, First-time",240,157,83,-2
194392,Paul Smiths College of Arts and Science,2013,"All students, Undergraduate, Other degree/certificate-seeking",738,487,251,-2
194392,Paul Smiths College of Arts and Science,2013,"All students, Undergraduate, Other degree/certifcate-seeking, Transfer-ins",57,33,24,-2
194392,Paul Smiths College of Arts and Science,2013,"All students, Undergraduate, Other degree/certifcate-seeking, Continuing",681,454,227,-2
194392,Paul Smiths College of Arts and Science,2013,"All students, Undergraduate, Non-degree/certificate-seeking",3,2,1,-2
194499,Plaza College,2013,All students total,726,145,581,-2
194499,Plaza College,2013,"All students, Undergraduate total",726,145,581,-2
194499,Plaza College,2013,"All students, Undergraduate, Degree/certificate-seeking total",726,145,581,-2
194499,Plaza College,2013,"All students, Undergraduate, Degree/certificate-seeking, First-time",228,45,183,-2
194499,Plaza College,2013,"All students, Undergraduate, Other degree/certificate-seeking",498,100,398,-2
194499,Plaza College,2013,"All students, Undergraduate, Other degree/certifcate-seeking, Transfer-ins",68,13,55,-2
194499,Plaza College,2013,"All students, Undergraduate, Other degree/certifcate-seeking, Continuing",430,87,343,-2
194541,Polytechnic Institute of New York University,2013,All students total,4890,3603,1287,-2
194541,Polytechnic Institute of New York University,2013,"All students, Undergraduate total",2155,1642,513,-2
194541,Polytechnic Institute of New York University,2013,"All students, Undergraduate, Degree/certificate-seeking total",2078,1595,483,-2
194541,Polytechnic Institute of New York University,2013,"All students, Undergraduate, Degree/certificate-seeking, First-time",451,334,117,-2
194541,Polytechnic Institute of New York University,2013,"All students, Undergraduate, Other degree/certificate-seeking",1627,1261,366,-2
194541,Polytechnic Institute of New York University,2013,"All students, Undergraduate, Other degree/certifcate-seeking, Transfer-ins",131,101,30,-2
194541,Polytechnic Institute of New York University,2013,"All students, Undergraduate, Other degree/certifcate-seeking, Continuing",1496,1160,336,-2
194541,Polytechnic Institute of New York University,2013,"All students, Undergraduate, Non-degree/certificate-seeking",77,47,30,-2
194541,Polytechnic Institute of New York University,2013,"All students, Graduate",2735,1961,774,-2
194569,Davis College,2013,All students total,395,211,184,-2
194569,Davis College,2013,"All students, Undergraduate total",395,211,184,-2
194569,Davis College,2013,"All students, Undergraduate, Degree/certificate-seeking total",247,146,101,-2
194569,Davis College,2013,"All students, Undergraduate, Degree/certificate-seeking, First-time",39,17,22,-2
194569,Davis College,2013,"All students, Undergraduate, Other degree/certificate-seeking",208,129,79,-2
194569,Davis College,2013,"All students, Undergraduate, Other degree/certifcate-seeking, Transfer-ins",30,16,14,-2
194569,Davis College,2013,"All students, Undergraduate, Other degree/certifcate-seeking, Continuing",178,113,65,-2
194569,Davis College,2013,"All students, Undergraduate, Non-degree/certificate-seeking",148,65,83,-2
194578,Pratt Institute-Main,2013,All students total,4793,1522,3271,-2
194578,Pratt Institute-Main,2013,"All students, Undergraduate total",3311,1100,2211,-2
194578,Pratt Institute-Main,2013,"All students, Undergraduate, Degree/certificate-seeking total",3247,1077,2170,-2
194578,Pratt Institute-Main,2013,"All students, Undergraduate, Degree/certificate-seeking, First-time",716,205,511,-2
194578,Pratt Institute-Main,2013,"All students, Undergraduate, Other degree/certificate-seeking",2531,872,1659,-2
194578,Pratt Institute-Main,2013,"All students, Undergraduate, Other degree/certifcate-seeking, Transfer-ins",164,55,109,-2
194578,Pratt Institute-Main,2013,"All students, Undergraduate, Other degree/certifcate-seeking, Continuing",2367,817,1550,-2
194578,Pratt Institute-Main,2013,"All students, Undergraduate, Non-degree/certificate-seeking",64,23,41,-2
194578,Pratt Institute-Main,2013,"All students, Graduate",1482,422,1060,-2
194657,Rabbinical Academy Mesivta Rabbi Chaim Berlin,2013,All students total,258,258,0,-2
194657,Rabbinical Academy Mesivta Rabbi Chaim Berlin,2013,"All students, Undergraduate total",166,166,0,-2
194657,Rabbinical Academy Mesivta Rabbi Chaim Berlin,2013,"All students, Undergraduate, Degree/certificate-seeking total",164,164,0,-2
194657,Rabbinical Academy Mesivta Rabbi Chaim Berlin,2013,"All students, Undergraduate, Degree/certificate-seeking, First-time",44,44,0,-2
194657,Rabbinical Academy Mesivta Rabbi Chaim Berlin,2013,"All students, Undergraduate, Other degree/certificate-seeking",120,120,0,-2
194657,Rabbinical Academy Mesivta Rabbi Chaim Berlin,2013,"All students, Undergraduate, Other degree/certifcate-seeking, Transfer-ins",8,8,0,-2
194657,Rabbinical Academy Mesivta Rabbi Chaim Berlin,2013,"All students, Undergraduate, Other degree/certifcate-seeking, Continuing",112,112,0,-2
194657,Rabbinical Academy Mesivta Rabbi Chaim Berlin,2013,"All students, Undergraduate, Non-degree/certificate-seeking",2,2,0,-2
194657,Rabbinical Academy Mesivta Rabbi Chaim Berlin,2013,"All students, Graduate",92,92,0,-2
194666,Rabbinical College Bobover Yeshiva Bnei Zion,2013,All students total,316,316,0,-2
194666,Rabbinical College Bobover Yeshiva Bnei Zion,2013,"All students, Undergraduate total",263,263,0,-2
194666,Rabbinical College Bobover Yeshiva Bnei Zion,2013,"All students, Undergraduate, Degree/certificate-seeking total",263,263,0,-2
194666,Rabbinical College Bobover Yeshiva Bnei Zion,2013,"All students, Undergraduate, Degree/certificate-seeking, First-time",36,36,0,-2
194666,Rabbinical College Bobover Yeshiva Bnei Zion,2013,"All students, Undergraduate, Other degree/certificate-seeking",227,227,0,-2
194666,Rabbinical College Bobover Yeshiva Bnei Zion,2013,"All students, Undergraduate, Other degree/certifcate-seeking, Transfer-ins",25,25,0,-2
194666,Rabbinical College Bobover Yeshiva Bnei Zion,2013,"All students, Undergraduate, Other degree/certifcate-seeking, Continuing",202,202,0,-2
194666,Rabbinical College Bobover Yeshiva Bnei Zion,2013,"All students, Graduate",53,53,0,-2
194675,Rabbinical College of Ch'san Sofer New York,2013,All students total,43,43,0,-2
194675,Rabbinical College of Ch'san Sofer New York,2013,"All students, Undergraduate total",30,30,0,-2
194675,Rabbinical College of Ch'san Sofer New York,2013,"All students, Undergraduate, Degree/certificate-seeking total",30,30,0,-2
194675,Rabbinical College of Ch'san Sofer New York,2013,"All students, Undergraduate, Degree/certificate-seeking, First-time",6,6,0,-2
194675,Rabbinical College of Ch'san Sofer New York,2013,"All students, Undergraduate, Other degree/certificate-seeking",24,24,0,-2
194675,Rabbinical College of Ch'san Sofer New York,2013,"All students, Undergraduate, Other degree/certifcate-seeking, Continuing",24,24,0,-2
194675,Rabbinical College of Ch'san Sofer New York,2013,"All students, Graduate",13,13,0,-2
194693,Rabbinical College Beth Shraga,2013,All students total,47,47,0,-2
194693,Rabbinical College Beth Shraga,2013,"All students, Undergraduate total",47,47,0,-2
194693,Rabbinical College Beth Shraga,2013,"All students, Undergraduate, Degree/certificate-seeking total",47,47,0,-2
194693,Rabbinical College Beth Shraga,2013,"All students, Undergraduate, Degree/certificate-seeking, First-time",14,14,0,-2
194693,Rabbinical College Beth Shraga,2013,"All students, Undergraduate, Other degree/certificate-seeking",33,33,0,-2
194693,Rabbinical College Beth Shraga,2013,"All students, Undergraduate, Other degree/certifcate-seeking, Continuing",33,33,0,-2
194718,Rabbinical Seminary M'kor Chaim,2013,All students total,34,34,0,-2
194718,Rabbinical Seminary M'kor Chaim,2013,"All students, Undergraduate total",30,30,0,-2
194718,Rabbinical Seminary M'kor Chaim,2013,"All students, Undergraduate, Degree/certificate-seeking total",30,30,0,-2
194718,Rabbinical Seminary M'kor Chaim,2013,"All students, Undergraduate, Degree/certificate-seeking, First-time",7,7,0,-2
194718,Rabbinical Seminary M'kor Chaim,2013,"All students, Undergraduate, Other degree/certificate-seeking",23,23,0,-2
194718,Rabbinical Seminary M'kor Chaim,2013,"All students, Undergraduate, Other degree/certifcate-seeking, Transfer-ins",5,5,0,-2
194718,Rabbinical Seminary M'kor Chaim,2013,"All students, Undergraduate, Other degree/certifcate-seeking, Continuing",18,18,0,-2
194718,Rabbinical Seminary M'kor Chaim,2013,"All students, Graduate",4,4,0,-2
194736,Rabbinical College of Long Island,2013,All students total,96,96,0,-2
194736,Rabbinical College of Long Island,2013,"All students, Undergraduate total",96,96,0,-2
194736,Rabbinical College of Long Island,2013,"All students, Undergraduate, Degree/certificate-seeking total",96,96,0,-2
194736,Rabbinical College of Long Island,2013,"All students, Undergraduate, Other degree/certificate-seeking",96,96,0,-2
194736,Rabbinical College of Long Island,2013,"All students, Undergraduate, Other degree/certifcate-seeking, Transfer-ins",4,4,0,-2
194736,Rabbinical College of Long Island,2013,"All students, Undergraduate, Other degree/certifcate-seeking, Continuing",92,92,0,-2
194763,Rabbinical Seminary of America,2013,All students total,491,491,0,-2
194763,Rabbinical Seminary of America,2013,"All students, Undergraduate total",269,269,0,-2
194763,Rabbinical Seminary of America,2013,"All students, Undergraduate, Degree/certificate-seeking total",269,269,0,-2
194763,Rabbinical Seminary of America,2013,"All students, Undergraduate, Degree/certificate-seeking, First-time",107,107,0,-2
194763,Rabbinical Seminary of America,2013,"All students, Undergraduate, Other degree/certificate-seeking",162,162,0,-2
194763,Rabbinical Seminary of America,2013,"All students, Undergraduate, Other degree/certifcate-seeking, Continuing",162,162,0,-2
194763,Rabbinical Seminary of America,2013,"All students, Graduate",222,222,0,-2
194824,Rensselaer Polytechnic Institute,2013,All students total,6714,4728,1986,-2
194824,Rensselaer Polytechnic Institute,2013,"All students, Undergraduate total",5452,3840,1612,-2
194824,Rensselaer Polytechnic Institute,2013,"All students, Undergraduate, Degree/certificate-seeking total",5379,3787,1592,-2
194824,Rensselaer Polytechnic Institute,2013,"All students, Undergraduate, Degree/certificate-seeking, First-time",1411,975,436,-2
194824,Rensselaer Polytechnic Institute,2013,"All students, Undergraduate, Other degree/certificate-seeking",3968,2812,1156,-2
194824,Rensselaer Polytechnic Institute,2013,"All students, Undergraduate, Other degree/certifcate-seeking, Transfer-ins",126,88,38,-2
194824,Rensselaer Polytechnic Institute,2013,"All students, Undergraduate, Other degree/certifcate-seeking, Continuing",3842,2724,1118,-2
194824,Rensselaer Polytechnic Institute,2013,"All students, Undergraduate, Non-degree/certificate-seeking",73,53,20,-2
194824,Rensselaer Polytechnic Institute,2013,"All students, Graduate",1262,888,374,-2
194958,Roberts Wesleyan College,2013,All students total,1735,485,1250,-2
194958,Roberts Wesleyan College,2013,"All students, Undergraduate total",1315,394,921,-2
194958,Roberts Wesleyan College,2013,"All students, Undergraduate, Degree/certificate-seeking total",1302,390,912,-2
194958,Roberts Wesleyan College,2013,"All students, Undergraduate, Degree/certificate-seeking, First-time",206,71,135,-2
194958,Roberts Wesleyan College,2013,"All students, Undergraduate, Other degree/certificate-seeking",1096,319,777,-2
194958,Roberts Wesleyan College,2013,"All students, Undergraduate, Other degree/certifcate-seeking, Transfer-ins",97,31,66,-2
194958,Roberts Wesleyan College,2013,"All students, Undergraduate, Other degree/certifcate-seeking, Continuing",999,288,711,-2
194958,Roberts Wesleyan College,2013,"All students, Undergraduate, Non-degree/certificate-seeking",13,4,9,-2
194958,Roberts Wesleyan College,2013,"All students, Graduate",420,91,329,-2
195003,Rochester Institute of Technology,2013,All students total,16583,11235,5348,-2
195003,Rochester Institute of Technology,2013,"All students, Undergraduate total",13880,9485,4395,-2
195003,Rochester Institute of Technology,2013,"All students, Undergraduate, Degree/certificate-seeking total",12587,8484,4103,-2
195003,Rochester Institute of Technology,2013,"All students, Undergraduate, Degree/certificate-seeking, First-time",2784,1891,893,-2
195003,Rochester Institute of Technology,2013,"All students, Undergraduate, Other degree/certificate-seeking",9803,6593,3210,-2
195003,Rochester Institute of Technology,2013,"All students, Undergraduate, Other degree/certifcate-seeking, Transfer-ins",597,350,247,-2
195003,Rochester Institute of Technology,2013,"All students, Undergraduate, Other degree/certifcate-seeking, Continuing",9206,6243,2963,-2
195003,Rochester Institute of Technology,2013,"All students, Undergraduate, Non-degree/certificate-seeking",1293,1001,292,-2
195003,Rochester Institute of Technology,2013,"All students, Graduate",2703,1750,953,-2
195030,University of Rochester,2013,All students total,11020,5342,5678,-2
195030,University of Rochester,2013,"All students, Undergraduate total",6177,2961,3216,-2
195030,University of Rochester,2013,"All students, Undergraduate, Degree/certificate-seeking total",6047,2924,3123,-2
195030,University of Rochester,2013,"All students, Undergraduate, Degree/certificate-seeking, First-time",1472,738,734,-2
195030,University of Rochester,2013,"All students, Undergraduate, Other degree/certificate-seeking",4575,2186,2389,-2
195030,University of Rochester,2013,"All students, Undergraduate, Other degree/certifcate-seeking, Transfer-ins",107,45,62,-2
195030,University of Rochester,2013,"All students, Undergraduate, Other degree/certifcate-seeking, Continuing",4468,2141,2327,-2
195030,University of Rochester,2013,"All students, Undergraduate, Non-degree/certificate-seeking",130,37,93,-2
195030,University of Rochester,2013,"All students, Graduate",4843,2381,2462,-2
195049,Rockefeller University,2013,All students total,201,117,84,-2
195049,Rockefeller University,2013,"All students, Graduate",201,117,84,-2
195128,The Sage Colleges,2013,All students total,2832,549,2283,-2
195128,The Sage Colleges,2013,"All students, Undergraduate total",1699,359,1340,-2
195128,The Sage Colleges,2013,"All students, Undergraduate, Degree/certificate-seeking total",1661,345,1316,-2
195128,The Sage Colleges,2013,"All students, Undergraduate, Degree/certificate-seeking, First-time",297,49,248,-2
195128,The Sage Colleges,2013,"All students, Undergraduate, Other degree/certificate-seeking",1364,296,1068,-2
195128,The Sage Colleges,2013,"All students, Undergraduate, Other degree/certifcate-seeking, Transfer-ins",210,53,157,-2
195128,The Sage Colleges,2013,"All students, Undergraduate, Other degree/certifcate-seeking, Continuing",1154,243,911,-2
195128,The Sage Colleges,2013,"All students, Undergraduate, Non-degree/certificate-seeking",38,14,24,-2
195128,The Sage Colleges,2013,"All students, Graduate",1133,190,943,-2
195155,St Bernard's School of Theology and Ministry,2013,All students total,98,35,63,-2
195155,St Bernard's School of Theology and Ministry,2013,"All students, Graduate",98,35,63,-2
195164,St Bonaventure University,2013,All students total,2244,1057,1187,-2
195164,St Bonaventure University,2013,"All students, Undergraduate total",1826,901,925,-2
195164,St Bonaventure University,2013,"All students, Undergraduate, Degree/certificate-seeking total",1787,884,903,-2
195164,St Bonaventure University,2013,"All students, Undergraduate, Degree/certificate-seeking, First-time",438,230,208,-2
195164,St Bonaventure University,2013,"All students, Undergraduate, Other degree/certificate-seeking",1349,654,695,-2
195164,St Bonaventure University,2013,"All students, Undergraduate, Other degree/certifcate-seeking, Transfer-ins",71,39,32,-2
195164,St Bonaventure University,2013,"All students, Undergraduate, Other degree/certifcate-seeking, Continuing",1278,615,663,-2
195164,St Bonaventure University,2013,"All students, Undergraduate, Non-degree/certificate-seeking",39,17,22,-2
195164,St Bonaventure University,2013,"All students, Graduate",418,156,262,-2
195173,St Francis College,2013,All students total,2819,1248,1571,-2
195173,St Francis College,2013,"All students, Undergraduate total",2764,1217,1547,-2
195173,St Francis College,2013,"All students, Undergraduate, Degree/certificate-seeking total",2725,1202,1523,-2
195173,St Francis College,2013,"All students, Undergraduate, Degree/certificate-seeking, First-time",568,247,321,-2
195173,St Francis College,2013,"All students, Undergraduate, Other degree/certificate-seeking",2157,955,1202,-2
195173,St Francis College,2013,"All students, Undergraduate, Other degree/certifcate-seeking, Transfer-ins",170,75,95,-2
195173,St Francis College,2013,"All students, Undergraduate, Other degree/certifcate-seeking, Continuing",1987,880,1107,-2
195173,St Francis College,2013,"All students, Undergraduate, Non-degree/certificate-seeking",39,15,24,-2
195173,St Francis College,2013,"All students, Graduate",55,31,24,-2
195216,St Lawrence University,2013,All students total,2506,1114,1392,-2
195216,St Lawrence University,2013,"All students, Undergraduate total",2414,1088,1326,-2
195216,St Lawrence University,2013,"All students, Undergraduate, Degree/certificate-seeking total",2391,1079,1312,-2
195216,St Lawrence University,2013,"All students, Undergraduate, Degree/certificate-seeking, First-time",629,284,345,-2
195216,St Lawrence University,2013,"All students, Undergraduate, Other degree/certificate-seeking",1762,795,967,-2
195216,St Lawrence University,2013,"All students, Undergraduate, Other degree/certifcate-seeking, Transfer-ins",25,15,10,-2
195216,St Lawrence University,2013,"All students, Undergraduate, Other degree/certifcate-seeking, Continuing",1737,780,957,-2
195216,St Lawrence University,2013,"All students, Undergraduate, Non-degree/certificate-seeking",23,9,14,-2
195216,St Lawrence University,2013,"All students, Graduate",92,26,66,-2
195234,The College of Saint Rose,2013,All students total,4542,1420,3122,-2
195234,The College of Saint Rose,2013,"All students, Undergraduate total",2891,969,1922,-2
195234,The College of Saint Rose,2013,"All students, Undergraduate, Degree/certificate-seeking total",2792,934,1858,-2
195234,The College of Saint Rose,2013,"All students, Undergraduate, Degree/certificate-seeking, First-time",621,213,408,-2
195234,The College of Saint Rose,2013,"All students, Undergraduate, Other degree/certificate-seeking",2171,721,1450,-2
195234,The College of Saint Rose,2013,"All students, Undergraduate, Other degree/certifcate-seeking, Transfer-ins",222,64,158,-2
195234,The College of Saint Rose,2013,"All students, Undergraduate, Other degree/certifcate-seeking, Continuing",1949,657,1292,-2
195234,The College of Saint Rose,2013,"All students, Undergraduate, Non-degree/certificate-seeking",99,35,64,-2
195234,The College of Saint Rose,2013,"All students, Graduate",1651,451,1200,-2
195243,St Thomas Aquinas College,2013,All students total,1972,898,1074,-2
195243,St Thomas Aquinas College,2013,"All students, Undergraduate total",1801,844,957,-2
195243,St Thomas Aquinas College,2013,"All students, Undergraduate, Degree/certificate-seeking total",1279,597,682,-2
195243,St Thomas Aquinas College,2013,"All students, Undergraduate, Degree/certificate-seeking, First-time",337,156,181,-2
195243,St Thomas Aquinas College,2013,"All students, Undergraduate, Other degree/certificate-seeking",942,441,501,-2
195243,St Thomas Aquinas College,2013,"All students, Undergraduate, Other degree/certifcate-seeking, Transfer-ins",93,52,41,-2
195243,St Thomas Aquinas College,2013,"All students, Undergraduate, Other degree/certifcate-seeking, Continuing",849,389,460,-2
195243,St Thomas Aquinas College,2013,"All students, Undergraduate, Non-degree/certificate-seeking",522,247,275,-2
195243,St Thomas Aquinas College,2013,"All students, Graduate",171,54,117,-2
195304,Sarah Lawrence College,2013,All students total,1782,462,1320,-2
195304,Sarah Lawrence College,2013,"All students, Undergraduate total",1471,409,1062,-2
195304,Sarah Lawrence College,2013,"All students, Undergraduate, Degree/certificate-seeking total",1402,395,1007,-2
195304,Sarah Lawrence College,2013,"All students, Undergraduate, Degree/certificate-seeking, First-time",427,117,310,-2
195304,Sarah Lawrence College,2013,"All students, Undergraduate, Other degree/certificate-seeking",975,278,697,-2
195304,Sarah Lawrence College,2013,"All students, Undergraduate, Other degree/certifcate-seeking, Transfer-ins",37,15,22,-2
195304,Sarah Lawrence College,2013,"All students, Undergraduate, Other degree/certifcate-seeking, Continuing",938,263,675,-2
195304,Sarah Lawrence College,2013,"All students, Undergraduate, Non-degree/certificate-seeking",69,14,55,-2
195304,Sarah Lawrence College,2013,"All students, Graduate",311,53,258,-2
195438,Sh'or Yoshuv Rabbinical College,2013,All students total,248,248,0,-2
195438,Sh'or Yoshuv Rabbinical College,2013,"All students, Undergraduate total",190,190,0,-2
195438,Sh'or Yoshuv Rabbinical College,2013,"All students, Undergraduate, Degree/certificate-seeking total",190,190,0,-2
195438,Sh'or Yoshuv Rabbinical College,2013,"All students, Undergraduate, Degree/certificate-seeking, First-time",16,16,0,-2
195438,Sh'or Yoshuv Rabbinical College,2013,"All students, Undergraduate, Other degree/certificate-seeking",174,174,0,-2
195438,Sh'or Yoshuv Rabbinical College,2013,"All students, Undergraduate, Other degree/certifcate-seeking, Transfer-ins",11,11,0,-2
195438,Sh'or Yoshuv Rabbinical College,2013,"All students, Undergraduate, Other degree/certifcate-seeking, Continuing",163,163,0,-2
195438,Sh'or Yoshuv Rabbinical College,2013,"All students, Graduate",58,58,0,-2
195474,Siena College,2013,All students total,3207,1518,1689,-2
195474,Siena College,2013,"All students, Undergraduate total",3151,1482,1669,-2
195474,Siena College,2013,"All students, Undergraduate, Degree/certificate-seeking total",3102,1456,1646,-2
195474,Siena College,2013,"All students, Undergraduate, Degree/certificate-seeking, First-time",766,348,418,-2
195474,Siena College,2013,"All students, Undergraduate, Other degree/certificate-seeking",2336,1108,1228,-2
195474,Siena College,2013,"All students, Undergraduate, Other degree/certifcate-seeking, Transfer-ins",132,67,65,-2
195474,Siena College,2013,"All students, Undergraduate, Other degree/certifcate-seeking, Continuing",2204,1041,1163,-2
195474,Siena College,2013,"All students, Undergraduate, Non-degree/certificate-seeking",49,26,23,-2
195474,Siena College,2013,"All students, Graduate",56,36,20,-2
195526,Skidmore College,2013,All students total,2702,1057,1645,-2
195526,Skidmore College,2013,"All students, Undergraduate total",2684,1052,1632,-2
195526,Skidmore College,2013,"All students, Undergraduate, Degree/certificate-seeking total",2646,1039,1607,-2
195526,Skidmore College,2013,"All students, Undergraduate, Degree/certificate-seeking, First-time",660,261,399,-2
195526,Skidmore College,2013,"All students, Undergraduate, Other degree/certificate-seeking",1986,778,1208,-2
195526,Skidmore College,2013,"All students, Undergraduate, Other degree/certifcate-seeking, Transfer-ins",32,14,18,-2
195526,Skidmore College,2013,"All students, Undergraduate, Other degree/certifcate-seeking, Continuing",1954,764,1190,-2
195526,Skidmore College,2013,"All students, Undergraduate, Non-degree/certificate-seeking",38,13,25,-2
195526,Skidmore College,2013,"All students, Graduate",18,5,13,-2
195544,Saint Joseph's College-New York,2013,All students total,5354,1621,3733,-2
195544,Saint Joseph's College-New York,2013,"All students, Undergraduate total",4529,1425,3104,-2
195544,Saint Joseph's College-New York,2013,"All students, Undergraduate, Degree/certificate-seeking total",4408,1373,3035,-2
195544,Saint Joseph's College-New York,2013,"All students, Undergraduate, Degree/certificate-seeking, First-time",547,190,357,-2
195544,Saint Joseph's College-New York,2013,"All students, Undergraduate, Other degree/certificate-seeking",3861,1183,2678,-2
195544,Saint Joseph's College-New York,2013,"All students, Undergraduate, Other degree/certifcate-seeking, Transfer-ins",499,180,319,-2
195544,Saint Joseph's College-New York,2013,"All students, Undergraduate, Other degree/certifcate-seeking, Continuing",3362,1003,2359,-2
195544,Saint Joseph's College-New York,2013,"All students, Undergraduate, Non-degree/certificate-seeking",121,52,69,-2
195544,Saint Joseph's College-New York,2013,"All students, Graduate",825,196,629,-2
195580,Saint Vladimirs Orthodox Theological Seminary,2013,All students total,81,69,12,-2
195580,Saint Vladimirs Orthodox Theological Seminary,2013,"All students, Graduate",81,69,12,-2
195720,Saint John Fisher College,2013,All students total,3987,1541,2446,-2
195720,Saint John Fisher College,2013,"All students, Undergraduate total",2959,1186,1773,-2
195720,Saint John Fisher College,2013,"All students, Undergraduate, Degree/certificate-seeking total",2948,1181,1767,-2
195720,Saint John Fisher College,2013,"All students, Undergraduate, Degree/certificate-seeking, First-time",521,210,311,-2
195720,Saint John Fisher College,2013,"All students, Undergraduate, Other degree/certificate-seeking",2427,971,1456,-2
195720,Saint John Fisher College,2013,"All students, Undergraduate, Other degree/certifcate-seeking, Transfer-ins",279,119,160,-2
195720,Saint John Fisher College,2013,"All students, Undergraduate, Other degree/certifcate-seeking, Continuing",2148,852,1296,-2
195720,Saint John Fisher College,2013,"All students, Undergraduate, Non-degree/certificate-seeking",11,5,6,-2
195720,Saint John Fisher College,2013,"All students, Graduate",1028,355,673,-2
195809,St John's University-New York,2013,All students total,20729,9055,11674,-2
195809,St John's University-New York,2013,"All students, Undergraduate total",15773,7170,8603,-2
195809,St John's University-New York,2013,"All students, Undergraduate, Degree/certificate-seeking total",11147,5287,5860,-2
195809,St John's University-New York,2013,"All students, Undergraduate, Degree/certificate-seeking, First-time",2794,1286,1508,-2
195809,St John's University-New York,2013,"All students, Undergraduate, Other degree/certificate-seeking",8353,4001,4352,-2
195809,St John's University-New York,2013,"All students, Undergraduate, Other degree/certifcate-seeking, Transfer-ins",576,276,300,-2
195809,St John's University-New York,2013,"All students, Undergraduate, Other degree/certifcate-seeking, Continuing",7777,3725,4052,-2
195809,St John's University-New York,2013,"All students, Undergraduate, Non-degree/certificate-seeking",4626,1883,2743,-2
195809,St John's University-New York,2013,"All students, Graduate",4956,1885,3071,-2
195827,SUNY-System Office,2013,,,,,-2
196006,SUNY College of Technology at Alfred,2013,All students total,3555,2137,1418,-2
196006,SUNY College of Technology at Alfred,2013,"All students, Undergraduate total",3555,2137,1418,-2
196006,SUNY College of Technology at Alfred,2013,"All students, Undergraduate, Degree/certificate-seeking total",3494,2121,1373,-2
196006,SUNY College of Technology at Alfred,2013,"All students, Undergraduate, Degree/certificate-seeking, First-time",1101,725,376,-2
196006,SUNY College of Technology at Alfred,2013,"All students, Undergraduate, Other degree/certificate-seeking",2393,1396,997,-2
196006,SUNY College of Technology at Alfred,2013,"All students, Undergraduate, Other degree/certifcate-seeking, Transfer-ins",329,143,186,-2
196006,SUNY College of Technology at Alfred,2013,"All students, Undergraduate, Other degree/certifcate-seeking, Continuing",2064,1253,811,-2
196006,SUNY College of Technology at Alfred,2013,"All students, Undergraduate, Non-degree/certificate-seeking",61,16,45,-2
196015,SUNY College of Technology at Canton,2013,All students total,3512,1561,1951,-2
196015,SUNY College of Technology at Canton,2013,"All students, Undergraduate total",3512,1561,1951,-2
196015,SUNY College of Technology at Canton,2013,"All students, Undergraduate, Degree/certificate-seeking total",3354,1491,1863,-2
196015,SUNY College of Technology at Canton,2013,"All students, Undergraduate, Degree/certificate-seeking, First-time",780,394,386,-2
196015,SUNY College of Technology at Canton,2013,"All students, Undergraduate, Other degree/certificate-seeking",2574,1097,1477,-2
196015,SUNY College of Technology at Canton,2013,"All students, Undergraduate, Other degree/certifcate-seeking, Transfer-ins",285,101,184,-2
196015,SUNY College of Technology at Canton,2013,"All students, Undergraduate, Other degree/certifcate-seeking, Continuing",2289,996,1293,-2
196015,SUNY College of Technology at Canton,2013,"All students, Undergraduate, Non-degree/certificate-seeking",158,70,88,-2
196024,SUNY College of Technology at Delhi,2013,All students total,3308,1562,1746,-2
196024,SUNY College of Technology at Delhi,2013,"All students, Undergraduate total",3308,1562,1746,-2
196024,SUNY College of Technology at Delhi,2013,"All students, Undergraduate, Degree/certificate-seeking total",3206,1512,1694,-2
196024,SUNY College of Technology at Delhi,2013,"All students, Undergraduate, Degree/certificate-seeking, First-time",921,551,370,-2
196024,SUNY College of Technology at Delhi,2013,"All students, Undergraduate, Other degree/certificate-seeking",2285,961,1324,-2
196024,SUNY College of Technology at Delhi,2013,"All students, Undergraduate, Other degree/certifcate-seeking, Transfer-ins",313,105,208,-2
196024,SUNY College of Technology at Delhi,2013,"All students, Undergraduate, Other degree/certifcate-seeking, Continuing",1972,856,1116,-2
196024,SUNY College of Technology at Delhi,2013,"All students, Undergraduate, Non-degree/certificate-seeking",102,50,52,-2
196033,SUNY College of Agriculture and Technology at Cobleskill,2013,All students total,2453,1174,1279,-2
196033,SUNY College of Agriculture and Technology at Cobleskill,2013,"All students, Undergraduate total",2453,1174,1279,-2
196033,SUNY College of Agriculture and Technology at Cobleskill,2013,"All students, Undergraduate, Degree/certificate-seeking total",2411,1160,1251,-2
196033,SUNY College of Agriculture and Technology at Cobleskill,2013,"All students, Undergraduate, Degree/certificate-seeking, First-time",775,376,399,-2
196033,SUNY College of Agriculture and Technology at Cobleskill,2013,"All students, Undergraduate, Other degree/certificate-seeking",1636,784,852,-2
196033,SUNY College of Agriculture and Technology at Cobleskill,2013,"All students, Undergraduate, Other degree/certifcate-seeking, Transfer-ins",193,101,92,-2
196033,SUNY College of Agriculture and Technology at Cobleskill,2013,"All students, Undergraduate, Other degree/certifcate-seeking, Continuing",1443,683,760,-2
196033,SUNY College of Agriculture and Technology at Cobleskill,2013,"All students, Undergraduate, Non-degree/certificate-seeking",42,14,28,-2
196042,Farmingdale State College,2013,All students total,8162,4696,3466,-2
196042,Farmingdale State College,2013,"All students, Undergraduate total",8162,4696,3466,-2
196042,Farmingdale State College,2013,"All students, Undergraduate, Degree/certificate-seeking total",7455,4359,3096,-2
196042,Farmingdale State College,2013,"All students, Undergraduate, Degree/certificate-seeking, First-time",1119,645,474,-2
196042,Farmingdale State College,2013,"All students, Undergraduate, Other degree/certificate-seeking",6336,3714,2622,-2
196042,Farmingdale State College,2013,"All students, Undergraduate, Other degree/certifcate-seeking, Transfer-ins",947,538,409,-2
196042,Farmingdale State College,2013,"All students, Undergraduate, Other degree/certifcate-seeking, Continuing",5389,3176,2213,-2
196042,Farmingdale State College,2013,"All students, Undergraduate, Non-degree/certificate-seeking",707,337,370,-2
196051,Morrisville State College,2013,All students total,3028,1587,1441,-2
196051,Morrisville State College,2013,"All students, Undergraduate total",3028,1587,1441,-2
196051,Morrisville State College,2013,"All students, Undergraduate, Degree/certificate-seeking total",2849,1449,1400,-2
196051,Morrisville State College,2013,"All students, Undergraduate, Degree/certificate-seeking, First-time",851,468,383,-2
196051,Morrisville State College,2013,"All students, Undergraduate, Other degree/certificate-seeking",1998,981,1017,-2
196051,Morrisville State College,2013,"All students, Undergraduate, Other degree/certifcate-seeking, Transfer-ins",201,96,105,-2
196051,Morrisville State College,2013,"All students, Undergraduate, Other degree/certifcate-seeking, Continuing",1797,885,912,-2
196051,Morrisville State College,2013,"All students, Undergraduate, Non-degree/certificate-seeking",179,138,41,-2
196060,SUNY at Albany,2013,All students total,17338,8400,8938,-2
196060,SUNY at Albany,2013,"All students, Undergraduate total",12822,6645,6177,-2
196060,SUNY at Albany,2013,"All students, Undergraduate, Degree/certificate-seeking total",12542,6499,6043,-2
196060,SUNY at Albany,2013,"All students, Undergraduate, Degree/certificate-seeking, First-time",2566,1375,1191,-2
196060,SUNY at Albany,2013,"All students, Undergraduate, Other degree/certificate-seeking",9976,5124,4852,-2
196060,SUNY at Albany,2013,"All students, Undergraduate, Other degree/certifcate-seeking, Transfer-ins",1387,716,671,-2
196060,SUNY at Albany,2013,"All students, Undergraduate, Other degree/certifcate-seeking, Continuing",8589,4408,4181,-2
196060,SUNY at Albany,2013,"All students, Undergraduate, Non-degree/certificate-seeking",280,146,134,-2
196060,SUNY at Albany,2013,"All students, Graduate",4516,1755,2761,-2
196079,SUNY at Binghamton,2013,All students total,16077,8474,7603,-2
196079,SUNY at Binghamton,2013,"All students, Undergraduate total",12997,6926,6071,-2
196079,SUNY at Binghamton,2013,"All students, Undergraduate, Degree/certificate-seeking total",12940,6900,6040,-2
196079,SUNY at Binghamton,2013,"All students, Undergraduate, Degree/certificate-seeking, First-time",2633,1401,1232,-2
196079,SUNY at Binghamton,2013,"All students, Undergraduate, Other degree/certificate-seeking",10307,5499,4808,-2
196079,SUNY at Binghamton,2013,"All students, Undergraduate, Other degree/certifcate-seeking, Transfer-ins",1185,604,581,-2
196079,SUNY at Binghamton,2013,"All students, Undergraduate, Other degree/certifcate-seeking, Continuing",9122,4895,4227,-2
196079,SUNY at Binghamton,2013,"All students, Undergraduate, Non-degree/certificate-seeking",57,26,31,-2
196079,SUNY at Binghamton,2013,"All students, Graduate",3080,1548,1532,-2
196088,University at Buffalo,2013,All students total,29850,15804,14046,-2
196088,University at Buffalo,2013,"All students, Undergraduate total",19831,10773,9058,-2
196088,University at Buffalo,2013,"All students, Undergraduate, Degree/certificate-seeking total",19365,10577,8788,-2
196088,University at Buffalo,2013,"All students, Undergraduate, Degree/certificate-seeking, First-time",3653,1996,1657,-2
196088,University at Buffalo,2013,"All students, Undergraduate, Other degree/certificate-seeking",15712,8581,7131,-2
196088,University at Buffalo,2013,"All students, Undergraduate, Other degree/certifcate-seeking, Transfer-ins",1924,1051,873,-2
196088,University at Buffalo,2013,"All students, Undergraduate, Other degree/certifcate-seeking, Continuing",13788,7530,6258,-2
196088,University at Buffalo,2013,"All students, Undergraduate, Non-degree/certificate-seeking",466,196,270,-2
196088,University at Buffalo,2013,"All students, Graduate",10019,5031,4988,-2
196097,Stony Brook University,2013,All students total,24143,12210,11933,-2
196097,Stony Brook University,2013,"All students, Undergraduate total",15992,8603,7389,-2
196097,Stony Brook University,2013,"All students, Undergraduate, Degree/certificate-seeking total",15724,8483,7241,-2
196097,Stony Brook University,2013,"All students, Undergraduate, Degree/certificate-seeking, First-time",2709,1592,1117,-2
196097,Stony Brook University,2013,"All students, Undergraduate, Other degree/certificate-seeking",13015,6891,6124,-2
196097,Stony Brook University,2013,"All students, Undergraduate, Other degree/certifcate-seeking, Transfer-ins",1527,708,819,-2
196097,Stony Brook University,2013,"All students, Undergraduate, Other degree/certifcate-seeking, Continuing",11488,6183,5305,-2
196097,Stony Brook University,2013,"All students, Undergraduate, Non-degree/certificate-seeking",268,120,148,-2
196097,Stony Brook University,2013,"All students, Graduate",8151,3607,4544,-2
196103,SUNY College of Environmental Science and Forestry,2013,All students total,2229,1225,1004,-2
196103,SUNY College of Environmental Science and Forestry,2013,"All students, Undergraduate total",1702,966,736,-2
196103,SUNY College of Environmental Science and Forestry,2013,"All students, Undergraduate, Degree/certificate-seeking total",1694,962,732,-2
196103,SUNY College of Environmental Science and Forestry,2013,"All students, Undergraduate, Degree/certificate-seeking, First-time",288,148,140,-2
196103,SUNY College of Environmental Science and Forestry,2013,"All students, Undergraduate, Other degree/certificate-seeking",1406,814,592,-2
196103,SUNY College of Environmental Science and Forestry,2013,"All students, Undergraduate, Other degree/certifcate-seeking, Transfer-ins",226,160,66,-2
196103,SUNY College of Environmental Science and Forestry,2013,"All students, Undergraduate, Other degree/certifcate-seeking, Continuing",1180,654,526,-2
196103,SUNY College of Environmental Science and Forestry,2013,"All students, Undergraduate, Non-degree/certificate-seeking",8,4,4,-2
196103,SUNY College of Environmental Science and Forestry,2013,"All students, Graduate",527,259,268,-2
196112,SUNY Institute of Technology at Utica-Rome,2013,All students total,2480,1346,1134,-2
196112,SUNY Institute of Technology at Utica-Rome,2013,"All students, Undergraduate total",1804,1059,745,-2
196112,SUNY Institute of Technology at Utica-Rome,2013,"All students, Undergraduate, Degree/certificate-seeking total",1714,1036,678,-2
196112,SUNY Institute of Technology at Utica-Rome,2013,"All students, Undergraduate, Degree/certificate-seeking, First-time",275,217,58,-2
196112,SUNY Institute of Technology at Utica-Rome,2013,"All students, Undergraduate, Other degree/certificate-seeking",1439,819,620,-2
196112,SUNY Institute of Technology at Utica-Rome,2013,"All students, Undergraduate, Other degree/certifcate-seeking, Transfer-ins",355,189,166,-2
196112,SUNY Institute of Technology at Utica-Rome,2013,"All students, Undergraduate, Other degree/certifcate-seeking, Continuing",1084,630,454,-2
196112,SUNY Institute of Technology at Utica-Rome,2013,"All students, Undergraduate, Non-degree/certificate-seeking",90,23,67,-2
196112,SUNY Institute of Technology at Utica-Rome,2013,"All students, Graduate",676,287,389,-2
196121,SUNY College at Brockport,2013,All students total,8128,3542,4586,-2
196121,SUNY College at Brockport,2013,"All students, Undergraduate total",7090,3201,3889,-2
196121,SUNY College at Brockport,2013,"All students, Undergraduate, Degree/certificate-seeking total",7040,3179,3861,-2
196121,SUNY College at Brockport,2013,"All students, Undergraduate, Degree/certificate-seeking, First-time",1080,479,601,-2
196121,SUNY College at Brockport,2013,"All students, Undergraduate, Other degree/certificate-seeking",5960,2700,3260,-2
196121,SUNY College at Brockport,2013,"All students, Undergraduate, Other degree/certifcate-seeking, Transfer-ins",976,443,533,-2
196121,SUNY College at Brockport,2013,"All students, Undergraduate, Other degree/certifcate-seeking, Continuing",4984,2257,2727,-2
196121,SUNY College at Brockport,2013,"All students, Undergraduate, Non-degree/certificate-seeking",50,22,28,-2
196121,SUNY College at Brockport,2013,"All students, Graduate",1038,341,697,-2
196130,Buffalo State SUNY,2013,All students total,11091,4578,6513,-2
196130,Buffalo State SUNY,2013,"All students, Undergraduate total",9355,4058,5297,-2
196130,Buffalo State SUNY,2013,"All students, Undergraduate, Degree/certificate-seeking total",9190,3969,5221,-2
196130,Buffalo State SUNY,2013,"All students, Undergraduate, Degree/certificate-seeking, First-time",1324,597,727,-2
196130,Buffalo State SUNY,2013,"All students, Undergraduate, Other degree/certificate-seeking",7866,3372,4494,-2
196130,Buffalo State SUNY,2013,"All students, Undergraduate, Other degree/certifcate-seeking, Transfer-ins",1060,474,586,-2
196130,Buffalo State SUNY,2013,"All students, Undergraduate, Other degree/certifcate-seeking, Continuing",6806,2898,3908,-2
196130,Buffalo State SUNY,2013,"All students, Undergraduate, Non-degree/certificate-seeking",165,89,76,-2
196130,Buffalo State SUNY,2013,"All students, Graduate",1736,520,1216,-2
196149,SUNY College at Cortland,2013,All students total,7110,3070,4040,-2
196149,SUNY College at Cortland,2013,"All students, Undergraduate total",6400,2797,3603,-2
196149,SUNY College at Cortland,2013,"All students, Undergraduate, Degree/certificate-seeking total",6394,2793,3601,-2
196149,SUNY College at Cortland,2013,"All students, Undergraduate, Degree/certificate-seeking, First-time",1207,484,723,-2
196149,SUNY College at Cortland,2013,"All students, Undergraduate, Other degree/certificate-seeking",5187,2309,2878,-2
196149,SUNY College at Cortland,2013,"All students, Undergraduate, Other degree/certifcate-seeking, Transfer-ins",654,335,319,-2
196149,SUNY College at Cortland,2013,"All students, Undergraduate, Other degree/certifcate-seeking, Continuing",4533,1974,2559,-2
196149,SUNY College at Cortland,2013,"All students, Undergraduate, Non-degree/certificate-seeking",6,4,2,-2
196149,SUNY College at Cortland,2013,"All students, Graduate",710,273,437,-2
196158,SUNY at Fredonia,2013,All students total,5391,2348,3043,-2
196158,SUNY at Fredonia,2013,"All students, Undergraduate total",5092,2280,2812,-2
196158,SUNY at Fredonia,2013,"All students, Undergraduate, Degree/certificate-seeking total",5049,2260,2789,-2
196158,SUNY at Fredonia,2013,"All students, Undergraduate, Degree/certificate-seeking, First-time",1099,451,648,-2
196158,SUNY at Fredonia,2013,"All students, Undergraduate, Other degree/certificate-seeking",3950,1809,2141,-2
196158,SUNY at Fredonia,2013,"All students, Undergraduate, Other degree/certifcate-seeking, Transfer-ins",431,242,189,-2
196158,SUNY at Fredonia,2013,"All students, Undergraduate, Other degree/certifcate-seeking, Continuing",3519,1567,1952,-2
196158,SUNY at Fredonia,2013,"All students, Undergraduate, Non-degree/certificate-seeking",43,20,23,-2
196158,SUNY at Fredonia,2013,"All students, Graduate",299,68,231,-2
196167,SUNY College at Geneseo,2013,All students total,5644,2357,3287,-2
196167,SUNY College at Geneseo,2013,"All students, Undergraduate total",5504,2325,3179,-2
196167,SUNY College at Geneseo,2013,"All students, Undergraduate, Degree/certificate-seeking total",5463,2316,3147,-2
196167,SUNY College at Geneseo,2013,"All students, Undergraduate, Degree/certificate-seeking, First-time",1132,460,672,-2
196167,SUNY College at Geneseo,2013,"All students, Undergraduate, Other degree/certificate-seeking",4331,1856,2475,-2
196167,SUNY College at Geneseo,2013,"All students, Undergraduate, Other degree/certifcate-seeking, Transfer-ins",325,176,149,-2
196167,SUNY College at Geneseo,2013,"All students, Undergraduate, Other degree/certifcate-seeking, Continuing",4006,1680,2326,-2
196167,SUNY College at Geneseo,2013,"All students, Undergraduate, Non-degree/certificate-seeking",41,9,32,-2
196167,SUNY College at Geneseo,2013,"All students, Graduate",140,32,108,-2
196176,State University of New York at New Paltz,2013,All students total,7578,2753,4825,-2
196176,State University of New York at New Paltz,2013,"All students, Undergraduate total",6570,2457,4113,-2
196176,State University of New York at New Paltz,2013,"All students, Undergraduate, Degree/certificate-seeking total",6397,2399,3998,-2
196176,State University of New York at New Paltz,2013,"All students, Undergraduate, Degree/certificate-seeking, First-time",1104,387,717,-2
196176,State University of New York at New Paltz,2013,"All students, Undergraduate, Other degree/certificate-seeking",5293,2012,3281,-2
196176,State University of New York at New Paltz,2013,"All students, Undergraduate, Other degree/certifcate-seeking, Transfer-ins",655,256,399,-2
196176,State University of New York at New Paltz,2013,"All students, Undergraduate, Other degree/certifcate-seeking, Continuing",4638,1756,2882,-2
196176,State University of New York at New Paltz,2013,"All students, Undergraduate, Non-degree/certificate-seeking",173,58,115,-2
196176,State University of New York at New Paltz,2013,"All students, Graduate",1008,296,712,-2
196185,SUNY Oneonta,2013,All students total,6034,2356,3678,-2
196185,SUNY Oneonta,2013,"All students, Undergraduate total",5800,2304,3496,-2
196185,SUNY Oneonta,2013,"All students, Undergraduate, Degree/certificate-seeking total",5759,2286,3473,-2
196185,SUNY Oneonta,2013,"All students, Undergraduate, Degree/certificate-seeking, First-time",1119,355,764,-2
196185,SUNY Oneonta,2013,"All students, Undergraduate, Other degree/certificate-seeking",4640,1931,2709,-2
196185,SUNY Oneonta,2013,"All students, Undergraduate, Other degree/certifcate-seeking, Transfer-ins",508,245,263,-2
196185,SUNY Oneonta,2013,"All students, Undergraduate, Other degree/certifcate-seeking, Continuing",4132,1686,2446,-2
196185,SUNY Oneonta,2013,"All students, Undergraduate, Non-degree/certificate-seeking",41,18,23,-2
196185,SUNY Oneonta,2013,"All students, Graduate",234,52,182,-2
196194,SUNY College at Oswego,2013,All students total,8117,3873,4244,-2
196194,SUNY College at Oswego,2013,"All students, Undergraduate total",7328,3553,3775,-2
196194,SUNY College at Oswego,2013,"All students, Undergraduate, Degree/certificate-seeking total",7245,3511,3734,-2
196194,SUNY College at Oswego,2013,"All students, Undergraduate, Degree/certificate-seeking, First-time",1506,660,846,-2
196194,SUNY College at Oswego,2013,"All students, Undergraduate, Other degree/certificate-seeking",5739,2851,2888,-2
196194,SUNY College at Oswego,2013,"All students, Undergraduate, Other degree/certifcate-seeking, Transfer-ins",795,450,345,-2
196194,SUNY College at Oswego,2013,"All students, Undergraduate, Other degree/certifcate-seeking, Continuing",4944,2401,2543,-2
196194,SUNY College at Oswego,2013,"All students, Undergraduate, Non-degree/certificate-seeking",83,42,41,-2
196194,SUNY College at Oswego,2013,"All students, Graduate",789,320,469,-2
196200,SUNY College at Potsdam,2013,All students total,4042,1661,2381,-2
196200,SUNY College at Potsdam,2013,"All students, Undergraduate total",3707,1579,2128,-2
196200,SUNY College at Potsdam,2013,"All students, Undergraduate, Degree/certificate-seeking total",3683,1568,2115,-2
196200,SUNY College at Potsdam,2013,"All students, Undergraduate, Degree/certificate-seeking, First-time",821,334,487,-2
196200,SUNY College at Potsdam,2013,"All students, Undergraduate, Other degree/certificate-seeking",2862,1234,1628,-2
196200,SUNY College at Potsdam,2013,"All students, Undergraduate, Other degree/certifcate-seeking, Transfer-ins",254,118,136,-2
196200,SUNY College at Potsdam,2013,"All students, Undergraduate, Other degree/certifcate-seeking, Continuing",2608,1116,1492,-2
196200,SUNY College at Potsdam,2013,"All students, Undergraduate, Non-degree/certificate-seeking",24,11,13,-2
196200,SUNY College at Potsdam,2013,"All students, Graduate",335,82,253,-2
196219,SUNY at Purchase College,2013,All students total,4353,1937,2416,-2
196219,SUNY at Purchase College,2013,"All students, Undergraduate total",4239,1884,2355,-2
196219,SUNY at Purchase College,2013,"All students, Undergraduate, Degree/certificate-seeking total",4017,1756,2261,-2
196219,SUNY at Purchase College,2013,"All students, Undergraduate, Degree/certificate-seeking, First-time",775,322,453,-2
196219,SUNY at Purchase College,2013,"All students, Undergraduate, Other degree/certificate-seeking",3242,1434,1808,-2
196219,SUNY at Purchase College,2013,"All students, Undergraduate, Other degree/certifcate-seeking, Transfer-ins",426,201,225,-2
196219,SUNY at Purchase College,2013,"All students, Undergraduate, Other degree/certifcate-seeking, Continuing",2816,1233,1583,-2
196219,SUNY at Purchase College,2013,"All students, Undergraduate, Non-degree/certificate-seeking",222,128,94,-2
196219,SUNY at Purchase College,2013,"All students, Graduate",114,53,61,-2
196228,SUNY College of Optometry,2013,All students total,343,95,248,-2
196228,SUNY College of Optometry,2013,"All students, Graduate",343,95,248,-2
196237,SUNY College at Old Westbury,2013,All students total,4367,1850,2517,-2
196237,SUNY College at Old Westbury,2013,"All students, Undergraduate total",4161,1764,2397,-2
196237,SUNY College at Old Westbury,2013,"All students, Undergraduate, Degree/certificate-seeking total",4045,1708,2337,-2
196237,SUNY College at Old Westbury,2013,"All students, Undergraduate, Degree/certificate-seeking, First-time",415,169,246,-2
196237,SUNY College at Old Westbury,2013,"All students, Undergraduate, Other degree/certificate-seeking",3630,1539,2091,-2
196237,SUNY College at Old Westbury,2013,"All students, Undergraduate, Other degree/certifcate-seeking, Transfer-ins",706,299,407,-2
196237,SUNY College at Old Westbury,2013,"All students, Undergraduate, Other degree/certifcate-seeking, Continuing",2924,1240,1684,-2
196237,SUNY College at Old Westbury,2013,"All students, Undergraduate, Non-degree/certificate-seeking",116,56,60,-2
196237,SUNY College at Old Westbury,2013,"All students, Graduate",206,86,120,-2
196246,SUNY College at Plattsburgh,2013,All students total,6051,2577,3474,-2
196246,SUNY College at Plattsburgh,2013,"All students, Undergraduate total",5639,2470,3169,-2
196246,SUNY College at Plattsburgh,2013,"All students, Undergraduate, Degree/certificate-seeking total",5494,2401,3093,-2
196246,SUNY College at Plattsburgh,2013,"All students, Undergraduate, Degree/certificate-seeking, First-time",954,388,566,-2
196246,SUNY College at Plattsburgh,2013,"All students, Undergraduate, Other degree/certificate-seeking",4540,2013,2527,-2
196246,SUNY College at Plattsburgh,2013,"All students, Undergraduate, Other degree/certifcate-seeking, Transfer-ins",612,274,338,-2
196246,SUNY College at Plattsburgh,2013,"All students, Undergraduate, Other degree/certifcate-seeking, Continuing",3928,1739,2189,-2
196246,SUNY College at Plattsburgh,2013,"All students, Undergraduate, Non-degree/certificate-seeking",145,69,76,-2
196246,SUNY College at Plattsburgh,2013,"All students, Graduate",412,107,305,-2
196255,SUNY Downstate Medical Center,2013,All students total,1865,703,1162,-2
196255,SUNY Downstate Medical Center,2013,"All students, Undergraduate total",358,71,287,-2
196255,SUNY Downstate Medical Center,2013,"All students, Undergraduate, Degree/certificate-seeking total",346,68,278,-2
196255,SUNY Downstate Medical Center,2013,"All students, Undergraduate, Other degree/certificate-seeking",346,68,278,-2
196255,SUNY Downstate Medical Center,2013,"All students, Undergraduate, Other degree/certifcate-seeking, Transfer-ins",80,9,71,-2
196255,SUNY Downstate Medical Center,2013,"All students, Undergraduate, Other degree/certifcate-seeking, Continuing",266,59,207,-2
196255,SUNY Downstate Medical Center,2013,"All students, Undergraduate, Non-degree/certificate-seeking",12,3,9,-2
196255,SUNY Downstate Medical Center,2013,"All students, Graduate",1507,632,875,-2
196264,SUNY Empire State College,2013,All students total,11823,4455,7368,-2
196264,SUNY Empire State College,2013,"All students, Undergraduate total",10827,4108,6719,-2
196264,SUNY Empire State College,2013,"All students, Undergraduate, Degree/certificate-seeking total",9793,3702,6091,-2
196264,SUNY Empire State College,2013,"All students, Undergraduate, Degree/certificate-seeking, First-time",373,195,178,-2
196264,SUNY Empire State College,2013,"All students, Undergraduate, Other degree/certificate-seeking",9420,3507,5913,-2
196264,SUNY Empire State College,2013,"All students, Undergraduate, Other degree/certifcate-seeking, Transfer-ins",1342,446,896,-2
196264,SUNY Empire State College,2013,"All students, Undergraduate, Other degree/certifcate-seeking, Continuing",8078,3061,5017,-2
196264,SUNY Empire State College,2013,"All students, Undergraduate, Non-degree/certificate-seeking",1034,406,628,-2
196264,SUNY Empire State College,2013,"All students, Graduate",996,347,649,-2
196291,SUNY Maritime College,2013,All students total,1755,1548,207,-2
196291,SUNY Maritime College,2013,"All students, Undergraduate total",1601,1430,171,-2
196291,SUNY Maritime College,2013,"All students, Undergraduate, Degree/certificate-seeking total",1565,1403,162,-2
196291,SUNY Maritime College,2013,"All students, Undergraduate, Degree/certificate-seeking, First-time",330,291,39,-2
196291,SUNY Maritime College,2013,"All students, Undergraduate, Other degree/certificate-seeking",1235,1112,123,-2
196291,SUNY Maritime College,2013,"All students, Undergraduate, Other degree/certifcate-seeking, Transfer-ins",91,83,8,-2
196291,SUNY Maritime College,2013,"All students, Undergraduate, Other degree/certifcate-seeking, Continuing",1144,1029,115,-2
196291,SUNY Maritime College,2013,"All students, Undergraduate, Non-degree/certificate-seeking",36,27,9,-2
196291,SUNY Maritime College,2013,"All students, Graduate",154,118,36,-2
196307,Upstate Medical University,2013,All students total,1617,615,1002,-2
196307,Upstate Medical University,2013,"All students, Undergraduate total",286,77,209,-2
196307,Upstate Medical University,2013,"All students, Undergraduate, Degree/certificate-seeking total",284,76,208,-2
196307,Upstate Medical University,2013,"All students, Undergraduate, Other degree/certificate-seeking",284,76,208,-2
196307,Upstate Medical University,2013,"All students, Undergraduate, Other degree/certifcate-seeking, Transfer-ins",105,26,79,-2
196307,Upstate Medical University,2013,"All students, Undergraduate, Other degree/certifcate-seeking, Continuing",179,50,129,-2
196307,Upstate Medical University,2013,"All students, Undergraduate, Non-degree/certificate-seeking",2,1,1,-2
196307,Upstate Medical University,2013,"All students, Graduate",1331,538,793,-2
196413,Syracuse University,2013,All students total,21267,9789,11478,-2
196413,Syracuse University,2013,"All students, Undergraduate total",15097,6755,8342,-2
196413,Syracuse University,2013,"All students, Undergraduate, Degree/certificate-seeking total",14738,6618,8120,-2
196413,Syracuse University,2013,"All students, Undergraduate, Degree/certificate-seeking, First-time",3487,1552,1935,-2
196413,Syracuse University,2013,"All students, Undergraduate, Other degree/certificate-seeking",11251,5066,6185,-2
196413,Syracuse University,2013,"All students, Undergraduate, Other degree/certifcate-seeking, Transfer-ins",422,215,207,-2
196413,Syracuse University,2013,"All students, Undergraduate, Other degree/certifcate-seeking, Continuing",10829,4851,5978,-2
196413,Syracuse University,2013,"All students, Undergraduate, Non-degree/certificate-seeking",359,137,222,-2
196413,Syracuse University,2013,"All students, Graduate",6170,3034,3136,-2
196431,Talmudical Seminary Oholei Torah,2013,All students total,321,321,0,-2
196431,Talmudical Seminary Oholei Torah,2013,"All students, Undergraduate total",321,321,0,-2
196431,Talmudical Seminary Oholei Torah,2013,"All students, Undergraduate, Degree/certificate-seeking total",321,321,0,-2
196431,Talmudical Seminary Oholei Torah,2013,"All students, Undergraduate, Degree/certificate-seeking, First-time",49,49,0,-2
196431,Talmudical Seminary Oholei Torah,2013,"All students, Undergraduate, Other degree/certificate-seeking",272,272,0,-2
196431,Talmudical Seminary Oholei Torah,2013,"All students, Undergraduate, Other degree/certifcate-seeking, Transfer-ins",150,150,0,-2
196431,Talmudical Seminary Oholei Torah,2013,"All students, Undergraduate, Other degree/certifcate-seeking, Continuing",122,122,0,-2
196440,Talmudical Institute of Upstate New York,2013,All students total,24,24,0,-2
196440,Talmudical Institute of Upstate New York,2013,"All students, Undergraduate total",17,17,0,-2
196440,Talmudical Institute of Upstate New York,2013,"All students, Undergraduate, Degree/certificate-seeking total",17,17,0,-2
196440,Talmudical Institute of Upstate New York,2013,"All students, Undergraduate, Degree/certificate-seeking, First-time",7,7,0,-2
196440,Talmudical Institute of Upstate New York,2013,"All students, Undergraduate, Other degree/certificate-seeking",10,10,0,-2
196440,Talmudical Institute of Upstate New York,2013,"All students, Undergraduate, Other degree/certifcate-seeking, Transfer-ins",1,1,0,-2
196440,Talmudical Institute of Upstate New York,2013,"All students, Undergraduate, Other degree/certifcate-seeking, Continuing",9,9,0,-2
196440,Talmudical Institute of Upstate New York,2013,"All students, Graduate",7,7,0,-2
196468,Teachers College at Columbia University,2013,All students total,5149,1232,3917,-2
196468,Teachers College at Columbia University,2013,"All students, Graduate",5149,1232,3917,-2
196583,Torah Temimah Talmudical Seminary,2013,All students total,180,180,0,-2
196583,Torah Temimah Talmudical Seminary,2013,"All students, Undergraduate total",180,180,0,-2
196583,Torah Temimah Talmudical Seminary,2013,"All students, Undergraduate, Degree/certificate-seeking total",180,180,0,-2
196583,Torah Temimah Talmudical Seminary,2013,"All students, Undergraduate, Degree/certificate-seeking, First-time",53,53,0,-2
196583,Torah Temimah Talmudical Seminary,2013,"All students, Undergraduate, Other degree/certificate-seeking",127,127,0,-2
196583,Torah Temimah Talmudical Seminary,2013,"All students, Undergraduate, Other degree/certifcate-seeking, Transfer-ins",11,11,0,-2
196583,Torah Temimah Talmudical Seminary,2013,"All students, Undergraduate, Other degree/certifcate-seeking, Continuing",116,116,0,-2
196592,Touro College,2013,All students total,13868,4106,9762,-2
196592,Touro College,2013,"All students, Undergraduate total",6827,2103,4724,-2
196592,Touro College,2013,"All students, Undergraduate, Degree/certificate-seeking total",6196,1990,4206,-2
196592,Touro College,2013,"All students, Undergraduate, Degree/certificate-seeking, First-time",764,164,600,-2
196592,Touro College,2013,"All students, Undergraduate, Other degree/certificate-seeking",5432,1826,3606,-2
196592,Touro College,2013,"All students, Undergraduate, Other degree/certifcate-seeking, Transfer-ins",725,296,429,-2
196592,Touro College,2013,"All students, Undergraduate, Other degree/certifcate-seeking, Continuing",4707,1530,3177,-2
196592,Touro College,2013,"All students, Undergraduate, Non-degree/certificate-seeking",631,113,518,-2
196592,Touro College,2013,"All students, Graduate",7041,2003,5038,-2
196653,Trocaire College,2013,All students total,1492,209,1283,-2
196653,Trocaire College,2013,"All students, Undergraduate total",1492,209,1283,-2
196653,Trocaire College,2013,"All students, Undergraduate, Degree/certificate-seeking total",1384,179,1205,-2
196653,Trocaire College,2013,"All students, Undergraduate, Degree/certificate-seeking, First-time",149,19,130,-2
196653,Trocaire College,2013,"All students, Undergraduate, Other degree/certificate-seeking",1235,160,1075,-2
196653,Trocaire College,2013,"All students, Undergraduate, Other degree/certifcate-seeking, Transfer-ins",294,43,251,-2
196653,Trocaire College,2013,"All students, Undergraduate, Other degree/certifcate-seeking, Continuing",941,117,824,-2
196653,Trocaire College,2013,"All students, Undergraduate, Non-degree/certificate-seeking",108,30,78,-2
196680,Excelsior College,2013,All students total,39897,17374,22523,-2
196680,Excelsior College,2013,"All students, Undergraduate total",37440,16214,21226,-2
196680,Excelsior College,2013,"All students, Undergraduate, Degree/certificate-seeking total",37440,16214,21226,-2
196680,Excelsior College,2013,"All students, Undergraduate, Other degree/certificate-seeking",37440,16214,21226,-2
196680,Excelsior College,2013,"All students, Undergraduate, Other degree/certifcate-seeking, Transfer-ins",2976,1564,1412,-2
196680,Excelsior College,2013,"All students, Undergraduate, Other degree/certifcate-seeking, Continuing",34464,14650,19814,-2
196680,Excelsior College,2013,"All students, Graduate",2457,1160,1297,-2
196866,Union College,2013,All students total,2246,1210,1036,-2
196866,Union College,2013,"All students, Undergraduate total",2246,1210,1036,-2
196866,Union College,2013,"All students, Undergraduate, Degree/certificate-seeking total",2206,1187,1019,-2
196866,Union College,2013,"All students, Undergraduate, Degree/certificate-seeking, First-time",559,291,268,-2
196866,Union College,2013,"All students, Undergraduate, Other degree/certificate-seeking",1647,896,751,-2
196866,Union College,2013,"All students, Undergraduate, Other degree/certifcate-seeking, Transfer-ins",23,15,8,-2
196866,Union College,2013,"All students, Undergraduate, Other degree/certifcate-seeking, Continuing",1624,881,743,-2
196866,Union College,2013,"All students, Undergraduate, Non-degree/certificate-seeking",40,23,17,-2
196884,Union Theological Seminary in the City of New York,2013,All students total,253,113,140,-2
196884,Union Theological Seminary in the City of New York,2013,"All students, Graduate",253,113,140,-2
197018,United Talmudical Seminary,2013,All students total,2071,2071,0,-2
197018,United Talmudical Seminary,2013,"All students, Undergraduate total",1814,1814,0,-2
197018,United Talmudical Seminary,2013,"All students, Undergraduate, Degree/certificate-seeking total",1814,1814,0,-2
197018,United Talmudical Seminary,2013,"All students, Undergraduate, Degree/certificate-seeking, First-time",512,512,0,-2
197018,United Talmudical Seminary,2013,"All students, Undergraduate, Other degree/certificate-seeking",1302,1302,0,-2
197018,United Talmudical Seminary,2013,"All students, Undergraduate, Other degree/certifcate-seeking, Transfer-ins",82,82,0,-2
197018,United Talmudical Seminary,2013,"All students, Undergraduate, Other degree/certifcate-seeking, Continuing",1220,1220,0,-2
197018,United Talmudical Seminary,2013,"All students, Graduate",257,257,0,-2
197027,United States Merchant Marine Academy,2013,All students total,985,842,143,-2
197027,United States Merchant Marine Academy,2013,"All students, Undergraduate total",958,819,139,-2
197027,United States Merchant Marine Academy,2013,"All students, Undergraduate, Degree/certificate-seeking total",958,819,139,-2
197027,United States Merchant Marine Academy,2013,"All students, Undergraduate, Degree/certificate-seeking, First-time",218,178,40,-2
197027,United States Merchant Marine Academy,2013,"All students, Undergraduate, Other degree/certificate-seeking",740,641,99,-2
197027,United States Merchant Marine Academy,2013,"All students, Undergraduate, Other degree/certifcate-seeking, Transfer-ins",19,18,1,-2
197027,United States Merchant Marine Academy,2013,"All students, Undergraduate, Other degree/certifcate-seeking, Continuing",721,623,98,-2
197027,United States Merchant Marine Academy,2013,"All students, Graduate",27,23,4,-2
197036,United States Military Academy,2013,All students total,4591,3829,762,-2
197036,United States Military Academy,2013,"All students, Undergraduate total",4591,3829,762,-2
197036,United States Military Academy,2013,"All students, Undergraduate, Degree/certificate-seeking total",4591,3829,762,-2
197036,United States Military Academy,2013,"All students, Undergraduate, Degree/certificate-seeking, First-time",1176,991,185,-2
197036,United States Military Academy,2013,"All students, Undergraduate, Other degree/certificate-seeking",3415,2838,577,-2
197036,United States Military Academy,2013,"All students, Undergraduate, Other degree/certifcate-seeking, Continuing",3415,2838,577,-2
197045,Utica College,2013,All students total,4028,1595,2433,-2
197045,Utica College,2013,"All students, Undergraduate total",2881,1129,1752,-2
197045,Utica College,2013,"All students, Undergraduate, Degree/certificate-seeking total",2831,1113,1718,-2
197045,Utica College,2013,"All students, Undergraduate, Degree/certificate-seeking, First-time",488,248,240,-2
197045,Utica College,2013,"All students, Undergraduate, Other degree/certificate-seeking",2343,865,1478,-2
197045,Utica College,2013,"All students, Undergraduate, Other degree/certifcate-seeking, Transfer-ins",374,116,258,-2
197045,Utica College,2013,"All students, Undergraduate, Other degree/certifcate-seeking, Continuing",1969,749,1220,-2
197045,Utica College,2013,"All students, Undergraduate, Non-degree/certificate-seeking",50,16,34,-2
197045,Utica College,2013,"All students, Graduate",1147,466,681,-2
197133,Vassar College,2013,All students total,2477,1099,1378,-2
197133,Vassar College,2013,"All students, Undergraduate total",2477,1099,1378,-2
197133,Vassar College,2013,"All students, Undergraduate, Degree/certificate-seeking total",2436,1073,1363,-2
197133,Vassar College,2013,"All students, Undergraduate, Degree/certificate-seeking, First-time",665,285,380,-2
197133,Vassar College,2013,"All students, Undergraduate, Other degree/certificate-seeking",1771,788,983,-2
197133,Vassar College,2013,"All students, Undergraduate, Other degree/certifcate-seeking, Transfer-ins",9,6,3,-2
197133,Vassar College,2013,"All students, Undergraduate, Other degree/certifcate-seeking, Continuing",1762,782,980,-2
197133,Vassar College,2013,"All students, Undergraduate, Non-degree/certificate-seeking",41,26,15,-2
197142,Villa Maria College,2013,All students total,465,156,309,-2
197142,Villa Maria College,2013,"All students, Undergraduate total",465,156,309,-2
197142,Villa Maria College,2013,"All students, Undergraduate, Degree/certificate-seeking total",456,154,302,-2
197142,Villa Maria College,2013,"All students, Undergraduate, Degree/certificate-seeking, First-time",124,32,92,-2
197142,Villa Maria College,2013,"All students, Undergraduate, Other degree/certificate-seeking",332,122,210,-2
197142,Villa Maria College,2013,"All students, Undergraduate, Other degree/certifcate-seeking, Transfer-ins",78,27,51,-2
197142,Villa Maria College,2013,"All students, Undergraduate, Other degree/certifcate-seeking, Continuing",254,95,159,-2
197142,Villa Maria College,2013,"All students, Undergraduate, Non-degree/certificate-seeking",9,2,7,-2
197151,School of Visual Arts,2013,All students total,4338,1690,2648,-2
197151,School of Visual Arts,2013,"All students, Undergraduate total",3636,1436,2200,-2
197151,School of Visual Arts,2013,"All students, Undergraduate, Degree/certificate-seeking total",3469,1368,2101,-2
197151,School of Visual Arts,2013,"All students, Undergraduate, Degree/certificate-seeking, First-time",656,245,411,-2
197151,School of Visual Arts,2013,"All students, Undergraduate, Other degree/certificate-seeking",2813,1123,1690,-2
197151,School of Visual Arts,2013,"All students, Undergraduate, Other degree/certifcate-seeking, Transfer-ins",277,119,158,-2
197151,School of Visual Arts,2013,"All students, Undergraduate, Other degree/certifcate-seeking, Continuing",2536,1004,1532,-2
197151,School of Visual Arts,2013,"All students, Undergraduate, Non-degree/certificate-seeking",167,68,99,-2
197151,School of Visual Arts,2013,"All students, Graduate",702,254,448,-2
197197,Wagner College,2013,All students total,2245,768,1477,-2
197197,Wagner College,2013,"All students, Undergraduate total",1842,644,1198,-2
197197,Wagner College,2013,"All students, Undergraduate, Degree/certificate-seeking total",1830,639,1191,-2
197197,Wagner College,2013,"All students, Undergraduate, Degree/certificate-seeking, First-time",430,163,267,-2
197197,Wagner College,2013,"All students, Undergraduate, Other degree/certificate-seeking",1400,476,924,-2
197197,Wagner College,2013,"All students, Undergraduate, Other degree/certifcate-seeking, Transfer-ins",102,26,76,-2
197197,Wagner College,2013,"All students, Undergraduate, Other degree/certifcate-seeking, Continuing",1298,450,848,-2
197197,Wagner College,2013,"All students, Undergraduate, Non-degree/certificate-seeking",12,5,7,-2
197197,Wagner College,2013,"All students, Graduate",403,124,279,-2
197221,Webb Institute,2013,All students total,82,65,17,-2
197221,Webb Institute,2013,"All students, Undergraduate total",82,65,17,-2
197221,Webb Institute,2013,"All students, Undergraduate, Degree/certificate-seeking total",82,65,17,-2
197221,Webb Institute,2013,"All students, Undergraduate, Degree/certificate-seeking, First-time",26,22,4,-2
197221,Webb Institute,2013,"All students, Undergraduate, Other degree/certificate-seeking",56,43,13,-2
197221,Webb Institute,2013,"All students, Undergraduate, Other degree/certifcate-seeking, Continuing",56,43,13,-2
197230,Wells College,2013,All students total,534,180,354,-2
197230,Wells College,2013,"All students, Undergraduate total",534,180,354,-2
197230,Wells College,2013,"All students, Undergraduate, Degree/certificate-seeking total",526,178,348,-2
197230,Wells College,2013,"All students, Undergraduate, Degree/certificate-seeking, First-time",161,55,106,-2
197230,Wells College,2013,"All students, Undergraduate, Other degree/certificate-seeking",365,123,242,-2
197230,Wells College,2013,"All students, Undergraduate, Other degree/certifcate-seeking, Transfer-ins",51,30,21,-2
197230,Wells College,2013,"All students, Undergraduate, Other degree/certifcate-seeking, Continuing",314,93,221,-2
197230,Wells College,2013,"All students, Undergraduate, Non-degree/certificate-seeking",8,2,6,-2
197285,The College of Westchester,2013,All students total,1197,465,732,-2
197285,The College of Westchester,2013,"All students, Undergraduate total",1197,465,732,-2
197285,The College of Westchester,2013,"All students, Undergraduate, Degree/certificate-seeking total",1083,433,650,-2
197285,The College of Westchester,2013,"All students, Undergraduate, Degree/certificate-seeking, First-time",239,118,121,-2
197285,The College of Westchester,2013,"All students, Undergraduate, Other degree/certificate-seeking",844,315,529,-2
197285,The College of Westchester,2013,"All students, Undergraduate, Other degree/certifcate-seeking, Transfer-ins",124,45,79,-2
197285,The College of Westchester,2013,"All students, Undergraduate, Other degree/certifcate-seeking, Continuing",720,270,450,-2
197285,The College of Westchester,2013,"All students, Undergraduate, Non-degree/certificate-seeking",114,32,82,-2
197601,Yeshiva Karlin Stolin,2013,All students total,119,119,0,-2
197601,Yeshiva Karlin Stolin,2013,"All students, Undergraduate total",119,119,0,-2
197601,Yeshiva Karlin Stolin,2013,"All students, Undergraduate, Degree/certificate-seeking total",119,119,0,-2
197601,Yeshiva Karlin Stolin,2013,"All students, Undergraduate, Degree/certificate-seeking, First-time",20,20,0,-2
197601,Yeshiva Karlin Stolin,2013,"All students, Undergraduate, Other degree/certificate-seeking",99,99,0,-2
197601,Yeshiva Karlin Stolin,2013,"All students, Undergraduate, Other degree/certifcate-seeking, Transfer-ins",3,3,0,-2
197601,Yeshiva Karlin Stolin,2013,"All students, Undergraduate, Other degree/certifcate-seeking, Continuing",96,96,0,-2
197610,Yeshivat Mikdash Melech,2013,All students total,164,164,0,-2
197610,Yeshivat Mikdash Melech,2013,"All students, Undergraduate total",152,152,0,-2
197610,Yeshivat Mikdash Melech,2013,"All students, Undergraduate, Degree/certificate-seeking total",152,152,0,-2
197610,Yeshivat Mikdash Melech,2013,"All students, Undergraduate, Degree/certificate-seeking, First-time",64,64,0,-2
197610,Yeshivat Mikdash Melech,2013,"All students, Undergraduate, Other degree/certificate-seeking",88,88,0,-2
197610,Yeshivat Mikdash Melech,2013,"All students, Undergraduate, Other degree/certifcate-seeking, Transfer-ins",7,7,0,-2
197610,Yeshivat Mikdash Melech,2013,"All students, Undergraduate, Other degree/certifcate-seeking, Continuing",81,81,0,-2
197610,Yeshivat Mikdash Melech,2013,"All students, Graduate",12,12,0,-2
197647,Yeshiva Derech Chaim,2013,All students total,153,153,0,-2
197647,Yeshiva Derech Chaim,2013,"All students, Undergraduate total",104,104,0,-2
197647,Yeshiva Derech Chaim,2013,"All students, Undergraduate, Degree/certificate-seeking total",104,104,0,-2
197647,Yeshiva Derech Chaim,2013,"All students, Undergraduate, Degree/certificate-seeking, First-time",27,27,0,-2
197647,Yeshiva Derech Chaim,2013,"All students, Undergraduate, Other degree/certificate-seeking",77,77,0,-2
197647,Yeshiva Derech Chaim,2013,"All students, Undergraduate, Other degree/certifcate-seeking, Transfer-ins",7,7,0,-2
197647,Yeshiva Derech Chaim,2013,"All students, Undergraduate, Other degree/certifcate-seeking, Continuing",70,70,0,-2
197647,Yeshiva Derech Chaim,2013,"All students, Graduate",49,49,0,-2
197674,Yeshiva of Nitra Rabbinical College,2013,All students total,250,250,0,-2
197674,Yeshiva of Nitra Rabbinical College,2013,"All students, Undergraduate total",220,220,0,-2
197674,Yeshiva of Nitra Rabbinical College,2013,"All students, Undergraduate, Degree/certificate-seeking total",220,220,0,-2
197674,Yeshiva of Nitra Rabbinical College,2013,"All students, Undergraduate, Degree/certificate-seeking, First-time",69,69,0,-2
197674,Yeshiva of Nitra Rabbinical College,2013,"All students, Undergraduate, Other degree/certificate-seeking",151,151,0,-2
197674,Yeshiva of Nitra Rabbinical College,2013,"All students, Undergraduate, Other degree/certifcate-seeking, Transfer-ins",4,4,0,-2
197674,Yeshiva of Nitra Rabbinical College,2013,"All students, Undergraduate, Other degree/certifcate-seeking, Continuing",147,147,0,-2
197674,Yeshiva of Nitra Rabbinical College,2013,"All students, Graduate",30,30,0,-2
197692,Yeshiva Shaar Hatorah,2013,All students total,95,95,0,-2
197692,Yeshiva Shaar Hatorah,2013,"All students, Undergraduate total",75,75,0,-2
197692,Yeshiva Shaar Hatorah,2013,"All students, Undergraduate, Degree/certificate-seeking total",75,75,0,-2
197692,Yeshiva Shaar Hatorah,2013,"All students, Undergraduate, Degree/certificate-seeking, First-time",24,24,0,-2
197692,Yeshiva Shaar Hatorah,2013,"All students, Undergraduate, Other degree/certificate-seeking",51,51,0,-2
197692,Yeshiva Shaar Hatorah,2013,"All students, Undergraduate, Other degree/certifcate-seeking, Continuing",51,51,0,-2
197692,Yeshiva Shaar Hatorah,2013,"All students, Graduate",20,20,0,-2
197708,Yeshiva University,2013,All students total,6747,3212,3535,-2
197708,Yeshiva University,2013,"All students, Undergraduate total",2887,1517,1370,-2
197708,Yeshiva University,2013,"All students, Undergraduate, Degree/certificate-seeking total",2887,1517,1370,-2
197708,Yeshiva University,2013,"All students, Undergraduate, Degree/certificate-seeking, First-time",862,467,395,-2
197708,Yeshiva University,2013,"All students, Undergraduate, Other degree/certificate-seeking",2025,1050,975,-2
197708,Yeshiva University,2013,"All students, Undergraduate, Other degree/certifcate-seeking, Transfer-ins",28,16,12,-2
197708,Yeshiva University,2013,"All students, Undergraduate, Other degree/certifcate-seeking, Continuing",1997,1034,963,-2
197708,Yeshiva University,2013,"All students, Graduate",3860,1695,2165,-2
197735,Yeshivath Viznitz,2013,All students total,604,604,0,-2
197735,Yeshivath Viznitz,2013,"All students, Undergraduate total",470,470,0,-2
197735,Yeshivath Viznitz,2013,"All students, Undergraduate, Degree/certificate-seeking total",470,470,0,-2
197735,Yeshivath Viznitz,2013,"All students, Undergraduate, Degree/certificate-seeking, First-time",111,111,0,-2
197735,Yeshivath Viznitz,2013,"All students, Undergraduate, Other degree/certificate-seeking",359,359,0,-2
197735,Yeshivath Viznitz,2013,"All students, Undergraduate, Other degree/certifcate-seeking, Transfer-ins",3,3,0,-2
197735,Yeshivath Viznitz,2013,"All students, Undergraduate, Other degree/certifcate-seeking, Continuing",356,356,0,-2
197735,Yeshivath Viznitz,2013,"All students, Graduate",134,134,0,-2
197744,Yeshivath Zichron Moshe,2013,All students total,198,198,0,-2
197744,Yeshivath Zichron Moshe,2013,"All students, Undergraduate total",164,164,0,-2
197744,Yeshivath Zichron Moshe,2013,"All students, Undergraduate, Degree/certificate-seeking total",164,164,0,-2
197744,Yeshivath Zichron Moshe,2013,"All students, Undergraduate, Degree/certificate-seeking, First-time",12,12,0,-2
197744,Yeshivath Zichron Moshe,2013,"All students, Undergraduate, Other degree/certificate-seeking",152,152,0,-2
197744,Yeshivath Zichron Moshe,2013,"All students, Undergraduate, Other degree/certifcate-seeking, Transfer-ins",44,44,0,-2
197744,Yeshivath Zichron Moshe,2013,"All students, Undergraduate, Other degree/certifcate-seeking, Continuing",108,108,0,-2
197744,Yeshivath Zichron Moshe,2013,"All students, Graduate",34,34,0,-2
200013,Rasmussen College-North Dakota,2013,All students total,964,271,693,-2
200013,Rasmussen College-North Dakota,2013,"All students, Undergraduate total",964,271,693,-2
200013,Rasmussen College-North Dakota,2013,"All students, Undergraduate, Degree/certificate-seeking total",923,248,675,-2
200013,Rasmussen College-North Dakota,2013,"All students, Undergraduate, Degree/certificate-seeking, First-time",60,22,38,-2
200013,Rasmussen College-North Dakota,2013,"All students, Undergraduate, Other degree/certificate-seeking",863,226,637,-2
200013,Rasmussen College-North Dakota,2013,"All students, Undergraduate, Other degree/certifcate-seeking, Transfer-ins",162,38,124,-2
200013,Rasmussen College-North Dakota,2013,"All students, Undergraduate, Other degree/certifcate-seeking, Continuing",701,188,513,-2
200013,Rasmussen College-North Dakota,2013,"All students, Undergraduate, Non-degree/certificate-seeking",41,23,18,-2
200022,Bismarck State College,2013,All students total,4062,2282,1780,-2
200022,Bismarck State College,2013,"All students, Undergraduate total",4062,2282,1780,-2
200022,Bismarck State College,2013,"All students, Undergraduate, Degree/certificate-seeking total",3233,1885,1348,-2
200022,Bismarck State College,2013,"All students, Undergraduate, Degree/certificate-seeking, First-time",907,520,387,-2
200022,Bismarck State College,2013,"All students, Undergraduate, Other degree/certificate-seeking",2326,1365,961,-2
200022,Bismarck State College,2013,"All students, Undergraduate, Other degree/certifcate-seeking, Transfer-ins",281,181,100,-2
200022,Bismarck State College,2013,"All students, Undergraduate, Other degree/certifcate-seeking, Continuing",2045,1184,861,-2
200022,Bismarck State College,2013,"All students, Undergraduate, Non-degree/certificate-seeking",829,397,432,-2
200059,Dickinson State University,2013,All students total,1449,571,878,-2
200059,Dickinson State University,2013,"All students, Undergraduate total",1449,571,878,-2
200059,Dickinson State University,2013,"All students, Undergraduate, Degree/certificate-seeking total",1257,497,760,-2
200059,Dickinson State University,2013,"All students, Undergraduate, Degree/certificate-seeking, First-time",165,89,76,-2
200059,Dickinson State University,2013,"All students, Undergraduate, Other degree/certificate-seeking",1092,408,684,-2
200059,Dickinson State University,2013,"All students, Undergraduate, Other degree/certifcate-seeking, Transfer-ins",127,44,83,-2
200059,Dickinson State University,2013,"All students, Undergraduate, Other degree/certifcate-seeking, Continuing",965,364,601,-2
200059,Dickinson State University,2013,"All students, Undergraduate, Non-degree/certificate-seeking",192,74,118,-2
200086,Fort Berthold Community College,2013,All students total,203,67,136,-2
200086,Fort Berthold Community College,2013,"All students, Undergraduate total",203,67,136,-2
200086,Fort Berthold Community College,2013,"All students, Undergraduate, Degree/certificate-seeking total",181,64,117,-2
200086,Fort Berthold Community College,2013,"All students, Undergraduate, Degree/certificate-seeking, First-time",41,16,25,-2
200086,Fort Berthold Community College,2013,"All students, Undergraduate, Other degree/certificate-seeking",140,48,92,-2
200086,Fort Berthold Community College,2013,"All students, Undergraduate, Other degree/certifcate-seeking, Transfer-ins",23,12,11,-2
200086,Fort Berthold Community College,2013,"All students, Undergraduate, Other degree/certifcate-seeking, Continuing",117,36,81,-2
200086,Fort Berthold Community College,2013,"All students, Undergraduate, Non-degree/certificate-seeking",22,3,19,-2
200156,University of Jamestown,2013,All students total,997,466,531,-2
200156,University of Jamestown,2013,"All students, Undergraduate total",955,449,506,-2
200156,University of Jamestown,2013,"All students, Undergraduate, Degree/certificate-seeking total",923,440,483,-2
200156,University of Jamestown,2013,"All students, Undergraduate, Degree/certificate-seeking, First-time",262,126,136,-2
200156,University of Jamestown,2013,"All students, Undergraduate, Other degree/certificate-seeking",661,314,347,-2
200156,University of Jamestown,2013,"All students, Undergraduate, Other degree/certifcate-seeking, Transfer-ins",64,39,25,-2
200156,University of Jamestown,2013,"All students, Undergraduate, Other degree/certifcate-seeking, Continuing",597,275,322,-2
200156,University of Jamestown,2013,"All students, Undergraduate, Non-degree/certificate-seeking",32,9,23,-2
200156,University of Jamestown,2013,"All students, Graduate",42,17,25,-2
200217,University of Mary,2013,All students total,2910,1005,1905,-2
200217,University of Mary,2013,"All students, Undergraduate total",2044,729,1315,-2
200217,University of Mary,2013,"All students, Undergraduate, Degree/certificate-seeking total",1865,679,1186,-2
200217,University of Mary,2013,"All students, Undergraduate, Degree/certificate-seeking, First-time",423,153,270,-2
200217,University of Mary,2013,"All students, Undergraduate, Other degree/certificate-seeking",1442,526,916,-2
200217,University of Mary,2013,"All students, Undergraduate, Other degree/certifcate-seeking, Transfer-ins",182,70,112,-2
200217,University of Mary,2013,"All students, Undergraduate, Other degree/certifcate-seeking, Continuing",1260,456,804,-2
200217,University of Mary,2013,"All students, Undergraduate, Non-degree/certificate-seeking",179,50,129,-2
200217,University of Mary,2013,"All students, Graduate",866,276,590,-2
200226,Mayville State University,2013,All students total,1065,458,607,-2
200226,Mayville State University,2013,"All students, Undergraduate total",1036,452,584,-2
200226,Mayville State University,2013,"All students, Undergraduate, Degree/certificate-seeking total",763,345,418,-2
200226,Mayville State University,2013,"All students, Undergraduate, Degree/certificate-seeking, First-time",134,79,55,-2
200226,Mayville State University,2013,"All students, Undergraduate, Other degree/certificate-seeking",629,266,363,-2
200226,Mayville State University,2013,"All students, Undergraduate, Other degree/certifcate-seeking, Transfer-ins",98,39,59,-2
200226,Mayville State University,2013,"All students, Undergraduate, Other degree/certifcate-seeking, Continuing",531,227,304,-2
200226,Mayville State University,2013,"All students, Undergraduate, Non-degree/certificate-seeking",273,107,166,-2
200226,Mayville State University,2013,"All students, Graduate",29,6,23,-2
200244,Sanford College of Nursing,2013,All students total,136,15,121,-2
200244,Sanford College of Nursing,2013,"All students, Undergraduate total",136,15,121,-2
200244,Sanford College of Nursing,2013,"All students, Undergraduate, Degree/certificate-seeking total",136,15,121,-2
200244,Sanford College of Nursing,2013,"All students, Undergraduate, Other degree/certificate-seeking",136,15,121,-2
200244,Sanford College of Nursing,2013,"All students, Undergraduate, Other degree/certifcate-seeking, Transfer-ins",38,5,33,-2
200244,Sanford College of Nursing,2013,"All students, Undergraduate, Other degree/certifcate-seeking, Continuing",98,10,88,-2
200253,Minot State University,2013,All students total,3533,1344,2189,-2
200253,Minot State University,2013,"All students, Undergraduate total",3254,1254,2000,-2
200253,Minot State University,2013,"All students, Undergraduate, Degree/certificate-seeking total",2693,982,1711,-2
200253,Minot State University,2013,"All students, Undergraduate, Degree/certificate-seeking, First-time",397,154,243,-2
200253,Minot State University,2013,"All students, Undergraduate, Other degree/certificate-seeking",2296,828,1468,-2
200253,Minot State University,2013,"All students, Undergraduate, Other degree/certifcate-seeking, Transfer-ins",320,115,205,-2
200253,Minot State University,2013,"All students, Undergraduate, Other degree/certifcate-seeking, Continuing",1976,713,1263,-2
200253,Minot State University,2013,"All students, Undergraduate, Non-degree/certificate-seeking",561,272,289,-2
200253,Minot State University,2013,"All students, Graduate",279,90,189,-2
200280,University of North Dakota,2013,All students total,15143,8018,7125,-2
200280,University of North Dakota,2013,"All students, Undergraduate total",11724,6640,5084,-2
200280,University of North Dakota,2013,"All students, Undergraduate, Degree/certificate-seeking total",11182,6339,4843,-2
200280,University of North Dakota,2013,"All students, Undergraduate, Degree/certificate-seeking, First-time",1908,1057,851,-2
200280,University of North Dakota,2013,"All students, Undergraduate, Other degree/certificate-seeking",9274,5282,3992,-2
200280,University of North Dakota,2013,"All students, Undergraduate, Other degree/certifcate-seeking, Transfer-ins",824,514,310,-2
200280,University of North Dakota,2013,"All students, Undergraduate, Other degree/certifcate-seeking, Continuing",8450,4768,3682,-2
200280,University of North Dakota,2013,"All students, Undergraduate, Non-degree/certificate-seeking",542,301,241,-2
200280,University of North Dakota,2013,"All students, Graduate",3419,1378,2041,-2
200332,North Dakota State University-Main Campus,2013,All students total,14629,7956,6673,-2
200332,North Dakota State University-Main Campus,2013,"All students, Undergraduate total",11948,6676,5272,-2
200332,North Dakota State University-Main Campus,2013,"All students, Undergraduate, Degree/certificate-seeking total",11629,6512,5117,-2
200332,North Dakota State University-Main Campus,2013,"All students, Undergraduate, Degree/certificate-seeking, First-time",2553,1407,1146,-2
200332,North Dakota State University-Main Campus,2013,"All students, Undergraduate, Other degree/certificate-seeking",9076,5105,3971,-2
200332,North Dakota State University-Main Campus,2013,"All students, Undergraduate, Other degree/certifcate-seeking, Transfer-ins",644,364,280,-2
200332,North Dakota State University-Main Campus,2013,"All students, Undergraduate, Other degree/certifcate-seeking, Continuing",8432,4741,3691,-2
200332,North Dakota State University-Main Campus,2013,"All students, Undergraduate, Non-degree/certificate-seeking",319,164,155,-2
200332,North Dakota State University-Main Campus,2013,"All students, Graduate",2681,1280,1401,-2
200466,Sitting Bull College,2013,All students total,279,114,165,-2
200466,Sitting Bull College,2013,"All students, Undergraduate total",279,114,165,-2
200466,Sitting Bull College,2013,"All students, Undergraduate, Degree/certificate-seeking total",264,110,154,-2
200466,Sitting Bull College,2013,"All students, Undergraduate, Degree/certificate-seeking, First-time",81,51,30,-2
200466,Sitting Bull College,2013,"All students, Undergraduate, Other degree/certificate-seeking",183,59,124,-2
200466,Sitting Bull College,2013,"All students, Undergraduate, Other degree/certifcate-seeking, Transfer-ins",16,6,10,-2
200466,Sitting Bull College,2013,"All students, Undergraduate, Other degree/certifcate-seeking, Continuing",167,53,114,-2
200466,Sitting Bull College,2013,"All students, Undergraduate, Non-degree/certificate-seeking",15,4,11,-2
200484,Trinity Bible College,2013,All students total,198,121,77,-2
200484,Trinity Bible College,2013,"All students, Undergraduate total",198,121,77,-2
200484,Trinity Bible College,2013,"All students, Undergraduate, Degree/certificate-seeking total",195,119,76,-2
200484,Trinity Bible College,2013,"All students, Undergraduate, Degree/certificate-seeking, First-time",53,33,20,-2
200484,Trinity Bible College,2013,"All students, Undergraduate, Other degree/certificate-seeking",142,86,56,-2
200484,Trinity Bible College,2013,"All students, Undergraduate, Other degree/certifcate-seeking, Transfer-ins",9,6,3,-2
200484,Trinity Bible College,2013,"All students, Undergraduate, Other degree/certifcate-seeking, Continuing",133,80,53,-2
200484,Trinity Bible College,2013,"All students, Undergraduate, Non-degree/certificate-seeking",3,2,1,-2
200527,Turtle Mountain Community College,2013,All students total,602,227,375,-2
200527,Turtle Mountain Community College,2013,"All students, Undergraduate total",602,227,375,-2
200527,Turtle Mountain Community College,2013,"All students, Undergraduate, Degree/certificate-seeking total",537,205,332,-2
200527,Turtle Mountain Community College,2013,"All students, Undergraduate, Degree/certificate-seeking, First-time",120,53,67,-2
200527,Turtle Mountain Community College,2013,"All students, Undergraduate, Other degree/certificate-seeking",417,152,265,-2
200527,Turtle Mountain Community College,2013,"All students, Undergraduate, Other degree/certifcate-seeking, Transfer-ins",9,3,6,-2
200527,Turtle Mountain Community College,2013,"All students, Undergraduate, Other degree/certifcate-seeking, Continuing",408,149,259,-2
200527,Turtle Mountain Community College,2013,"All students, Undergraduate, Non-degree/certificate-seeking",65,22,43,-2
200554,United Tribes Technical College,2013,All students total,505,181,324,-2
200554,United Tribes Technical College,2013,"All students, Undergraduate total",505,181,324,-2
200554,United Tribes Technical College,2013,"All students, Undergraduate, Degree/certificate-seeking total",486,175,311,-2
200554,United Tribes Technical College,2013,"All students, Undergraduate, Degree/certificate-seeking, First-time",114,58,56,-2
200554,United Tribes Technical College,2013,"All students, Undergraduate, Other degree/certificate-seeking",372,117,255,-2
200554,United Tribes Technical College,2013,"All students, Undergraduate, Other degree/certifcate-seeking, Transfer-ins",70,24,46,-2
200554,United Tribes Technical College,2013,"All students, Undergraduate, Other degree/certifcate-seeking, Continuing",302,93,209,-2
200554,United Tribes Technical College,2013,"All students, Undergraduate, Non-degree/certificate-seeking",19,6,13,-2
200572,Valley City State University,2013,All students total,1366,583,783,-2
200572,Valley City State University,2013,"All students, Undergraduate total",1211,534,677,-2
200572,Valley City State University,2013,"All students, Undergraduate, Degree/certificate-seeking total",924,452,472,-2
200572,Valley City State University,2013,"All students, Undergraduate, Degree/certificate-seeking, First-time",185,98,87,-2
200572,Valley City State University,2013,"All students, Undergraduate, Other degree/certificate-seeking",739,354,385,-2
200572,Valley City State University,2013,"All students, Undergraduate, Other degree/certifcate-seeking, Transfer-ins",111,54,57,-2
200572,Valley City State University,2013,"All students, Undergraduate, Other degree/certifcate-seeking, Continuing",628,300,328,-2
200572,Valley City State University,2013,"All students, Undergraduate, Non-degree/certificate-seeking",287,82,205,-2
200572,Valley City State University,2013,"All students, Graduate",155,49,106,-2
200624,The Art Institute of Cincinnati,2013,All students total,38,19,19,-2
200624,The Art Institute of Cincinnati,2013,"All students, Undergraduate total",38,19,19,-2
200624,The Art Institute of Cincinnati,2013,"All students, Undergraduate, Degree/certificate-seeking total",38,19,19,-2
200624,The Art Institute of Cincinnati,2013,"All students, Undergraduate, Degree/certificate-seeking, First-time",9,4,5,-2
200624,The Art Institute of Cincinnati,2013,"All students, Undergraduate, Other degree/certificate-seeking",29,15,14,-2
200624,The Art Institute of Cincinnati,2013,"All students, Undergraduate, Other degree/certifcate-seeking, Transfer-ins",2,1,1,-2
200624,The Art Institute of Cincinnati,2013,"All students, Undergraduate, Other degree/certifcate-seeking, Continuing",27,14,13,-2
200697,Air Force Institute of Technology-Graduate School of Engineering & Management,2013,All students total,853,749,104,-2
200697,Air Force Institute of Technology-Graduate School of Engineering & Management,2013,"All students, Graduate",853,749,104,-2
200785,Akron Institute of Herzing University,2013,All students total,302,51,251,-2
200785,Akron Institute of Herzing University,2013,"All students, Undergraduate total",302,51,251,-2
200785,Akron Institute of Herzing University,2013,"All students, Undergraduate, Degree/certificate-seeking total",298,49,249,-2
200785,Akron Institute of Herzing University,2013,"All students, Undergraduate, Degree/certificate-seeking, First-time",35,5,30,-2
200785,Akron Institute of Herzing University,2013,"All students, Undergraduate, Other degree/certificate-seeking",263,44,219,-2
200785,Akron Institute of Herzing University,2013,"All students, Undergraduate, Other degree/certifcate-seeking, Transfer-ins",20,1,19,-2
200785,Akron Institute of Herzing University,2013,"All students, Undergraduate, Other degree/certifcate-seeking, Continuing",243,43,200,-2
200785,Akron Institute of Herzing University,2013,"All students, Undergraduate, Non-degree/certificate-seeking",4,2,2,-2
200800,University of Akron Main Campus,2013,All students total,24932,12640,12292,-2
200800,University of Akron Main Campus,2013,"All students, Undergraduate total",20477,10696,9781,-2
200800,University of Akron Main Campus,2013,"All students, Undergraduate, Degree/certificate-seeking total",19022,10042,8980,-2
200800,University of Akron Main Campus,2013,"All students, Undergraduate, Degree/certificate-seeking, First-time",3802,2013,1789,-2
200800,University of Akron Main Campus,2013,"All students, Undergraduate, Other degree/certificate-seeking",15220,8029,7191,-2
200800,University of Akron Main Campus,2013,"All students, Undergraduate, Other degree/certifcate-seeking, Transfer-ins",849,459,390,-2
200800,University of Akron Main Campus,2013,"All students, Undergraduate, Other degree/certifcate-seeking, Continuing",14371,7570,6801,-2
200800,University of Akron Main Campus,2013,"All students, Undergraduate, Non-degree/certificate-seeking",1455,654,801,-2
200800,University of Akron Main Campus,2013,"All students, Graduate",4455,1944,2511,-2
200873,Allegheny Wesleyan College,2013,All students total,43,17,26,-2
200873,Allegheny Wesleyan College,2013,"All students, Undergraduate total",43,17,26,-2
200873,Allegheny Wesleyan College,2013,"All students, Undergraduate, Degree/certificate-seeking total",37,14,23,-2
200873,Allegheny Wesleyan College,2013,"All students, Undergraduate, Degree/certificate-seeking, First-time",15,4,11,-2
200873,Allegheny Wesleyan College,2013,"All students, Undergraduate, Other degree/certificate-seeking",22,10,12,-2
200873,Allegheny Wesleyan College,2013,"All students, Undergraduate, Other degree/certifcate-seeking, Transfer-ins",2,1,1,-2
200873,Allegheny Wesleyan College,2013,"All students, Undergraduate, Other degree/certifcate-seeking, Continuing",20,9,11,-2
200873,Allegheny Wesleyan College,2013,"All students, Undergraduate, Non-degree/certificate-seeking",6,3,3,-2
201061,Art Academy of Cincinnati,2013,All students total,215,91,124,-2
201061,Art Academy of Cincinnati,2013,"All students, Undergraduate total",207,88,119,-2
201061,Art Academy of Cincinnati,2013,"All students, Undergraduate, Degree/certificate-seeking total",206,87,119,-2
201061,Art Academy of Cincinnati,2013,"All students, Undergraduate, Degree/certificate-seeking, First-time",55,22,33,-2
201061,Art Academy of Cincinnati,2013,"All students, Undergraduate, Other degree/certificate-seeking",151,65,86,-2
201061,Art Academy of Cincinnati,2013,"All students, Undergraduate, Other degree/certifcate-seeking, Transfer-ins",10,4,6,-2
201061,Art Academy of Cincinnati,2013,"All students, Undergraduate, Other degree/certifcate-seeking, Continuing",141,61,80,-2
201061,Art Academy of Cincinnati,2013,"All students, Undergraduate, Non-degree/certificate-seeking",1,1,0,-2
201061,Art Academy of Cincinnati,2013,"All students, Graduate",8,3,5,-2
201104,Ashland University,2013,All students total,5979,2598,3381,-2
201104,Ashland University,2013,"All students, Undergraduate total",3198,1555,1643,-2
201104,Ashland University,2013,"All students, Undergraduate, Degree/certificate-seeking total",3118,1529,1589,-2
201104,Ashland University,2013,"All students, Undergraduate, Degree/certificate-seeking, First-time",623,243,380,-2
201104,Ashland University,2013,"All students, Undergraduate, Other degree/certificate-seeking",2495,1286,1209,-2
201104,Ashland University,2013,"All students, Undergraduate, Other degree/certifcate-seeking, Transfer-ins",153,40,113,-2
201104,Ashland University,2013,"All students, Undergraduate, Other degree/certifcate-seeking, Continuing",2342,1246,1096,-2
201104,Ashland University,2013,"All students, Undergraduate, Non-degree/certificate-seeking",80,26,54,-2
201104,Ashland University,2013,"All students, Graduate",2781,1043,1738,-2
201140,Athenaeum of Ohio,2013,All students total,208,151,57,-2
201140,Athenaeum of Ohio,2013,"All students, Undergraduate total",96,66,30,-2
201140,Athenaeum of Ohio,2013,"All students, Undergraduate, Degree/certificate-seeking total",64,37,27,-2
201140,Athenaeum of Ohio,2013,"All students, Undergraduate, Degree/certificate-seeking, First-time",27,16,11,-2
201140,Athenaeum of Ohio,2013,"All students, Undergraduate, Other degree/certificate-seeking",37,21,16,-2
201140,Athenaeum of Ohio,2013,"All students, Undergraduate, Other degree/certifcate-seeking, Continuing",37,21,16,-2
201140,Athenaeum of Ohio,2013,"All students, Undergraduate, Non-degree/certificate-seeking",32,29,3,-2
201140,Athenaeum of Ohio,2013,"All students, Graduate",112,85,27,-2
201177,Aultman College of Nursing and Health Sciences,2013,All students total,306,40,266,-2
201177,Aultman College of Nursing and Health Sciences,2013,"All students, Undergraduate total",306,40,266,-2
201177,Aultman College of Nursing and Health Sciences,2013,"All students, Undergraduate, Degree/certificate-seeking total",300,40,260,-2
201177,Aultman College of Nursing and Health Sciences,2013,"All students, Undergraduate, Degree/certificate-seeking, First-time",5,1,4,-2
201177,Aultman College of Nursing and Health Sciences,2013,"All students, Undergraduate, Other degree/certificate-seeking",295,39,256,-2
201177,Aultman College of Nursing and Health Sciences,2013,"All students, Undergraduate, Other degree/certifcate-seeking, Transfer-ins",81,5,76,-2
201177,Aultman College of Nursing and Health Sciences,2013,"All students, Undergraduate, Other degree/certifcate-seeking, Continuing",214,34,180,-2
201177,Aultman College of Nursing and Health Sciences,2013,"All students, Undergraduate, Non-degree/certificate-seeking",6,0,6,-2
201195,Baldwin Wallace University,2013,All students total,4053,1794,2259,-2
201195,Baldwin Wallace University,2013,"All students, Undergraduate total",3425,1536,1889,-2
201195,Baldwin Wallace University,2013,"All students, Undergraduate, Degree/certificate-seeking total",3331,1499,1832,-2
201195,Baldwin Wallace University,2013,"All students, Undergraduate, Degree/certificate-seeking, First-time",765,367,398,-2
201195,Baldwin Wallace University,2013,"All students, Undergraduate, Other degree/certificate-seeking",2566,1132,1434,-2
201195,Baldwin Wallace University,2013,"All students, Undergraduate, Other degree/certifcate-seeking, Transfer-ins",201,79,122,-2
201195,Baldwin Wallace University,2013,"All students, Undergraduate, Other degree/certifcate-seeking, Continuing",2365,1053,1312,-2
201195,Baldwin Wallace University,2013,"All students, Undergraduate, Non-degree/certificate-seeking",94,37,57,-2
201195,Baldwin Wallace University,2013,"All students, Graduate",628,258,370,-2
201371,Bluffton University,2013,All students total,1146,571,575,-2
201371,Bluffton University,2013,"All students, Undergraduate total",1053,531,522,-2
201371,Bluffton University,2013,"All students, Undergraduate, Degree/certificate-seeking total",941,472,469,-2
201371,Bluffton University,2013,"All students, Undergraduate, Degree/certificate-seeking, First-time",250,151,99,-2
201371,Bluffton University,2013,"All students, Undergraduate, Other degree/certificate-seeking",691,321,370,-2
201371,Bluffton University,2013,"All students, Undergraduate, Other degree/certifcate-seeking, Transfer-ins",44,22,22,-2
201371,Bluffton University,2013,"All students, Undergraduate, Other degree/certifcate-seeking, Continuing",647,299,348,-2
201371,Bluffton University,2013,"All students, Undergraduate, Non-degree/certificate-seeking",112,59,53,-2
201371,Bluffton University,2013,"All students, Graduate",93,40,53,-2
201441,Bowling Green State University-Main Campus,2013,All students total,16958,7298,9660,-2
201441,Bowling Green State University-Main Campus,2013,"All students, Undergraduate total",14477,6333,8144,-2
201441,Bowling Green State University-Main Campus,2013,"All students, Undergraduate, Degree/certificate-seeking total",14161,6214,7947,-2
201441,Bowling Green State University-Main Campus,2013,"All students, Undergraduate, Degree/certificate-seeking, First-time",3348,1381,1967,-2
201441,Bowling Green State University-Main Campus,2013,"All students, Undergraduate, Other degree/certificate-seeking",10813,4833,5980,-2
201441,Bowling Green State University-Main Campus,2013,"All students, Undergraduate, Other degree/certifcate-seeking, Transfer-ins",674,326,348,-2
201441,Bowling Green State University-Main Campus,2013,"All students, Undergraduate, Other degree/certifcate-seeking, Continuing",10139,4507,5632,-2
201441,Bowling Green State University-Main Campus,2013,"All students, Undergraduate, Non-degree/certificate-seeking",316,119,197,-2
201441,Bowling Green State University-Main Campus,2013,"All students, Graduate",2481,965,1516,-2
201469,Bryant & Stratton College-Parma,2013,All students total,662,81,581,-2
201469,Bryant & Stratton College-Parma,2013,"All students, Undergraduate total",662,81,581,-2
201469,Bryant & Stratton College-Parma,2013,"All students, Undergraduate, Degree/certificate-seeking total",662,81,581,-2
201469,Bryant & Stratton College-Parma,2013,"All students, Undergraduate, Degree/certificate-seeking, First-time",42,9,33,-2
201469,Bryant & Stratton College-Parma,2013,"All students, Undergraduate, Other degree/certificate-seeking",620,72,548,-2
201469,Bryant & Stratton College-Parma,2013,"All students, Undergraduate, Other degree/certifcate-seeking, Transfer-ins",147,18,129,-2
201469,Bryant & Stratton College-Parma,2013,"All students, Undergraduate, Other degree/certifcate-seeking, Continuing",473,54,419,-2
201548,Capital University,2013,All students total,3628,1587,2041,-2
201548,Capital University,2013,"All students, Undergraduate total",2788,1176,1612,-2
201548,Capital University,2013,"All students, Undergraduate, Degree/certificate-seeking total",2647,1132,1515,-2
201548,Capital University,2013,"All students, Undergraduate, Degree/certificate-seeking, First-time",691,312,379,-2
201548,Capital University,2013,"All students, Undergraduate, Other degree/certificate-seeking",1956,820,1136,-2
201548,Capital University,2013,"All students, Undergraduate, Other degree/certifcate-seeking, Transfer-ins",160,55,105,-2
201548,Capital University,2013,"All students, Undergraduate, Other degree/certifcate-seeking, Continuing",1796,765,1031,-2
201548,Capital University,2013,"All students, Undergraduate, Non-degree/certificate-seeking",141,44,97,-2
201548,Capital University,2013,"All students, Graduate",840,411,429,-2
201645,Case Western Reserve University,2013,All students total,10325,5231,5094,-2
201645,Case Western Reserve University,2013,"All students, Undergraduate total",4661,2555,2106,-2
201645,Case Western Reserve University,2013,"All students, Undergraduate, Degree/certificate-seeking total",4551,2509,2042,-2
201645,Case Western Reserve University,2013,"All students, Undergraduate, Degree/certificate-seeking, First-time",1252,664,588,-2
201645,Case Western Reserve University,2013,"All students, Undergraduate, Other degree/certificate-seeking",3299,1845,1454,-2
201645,Case Western Reserve University,2013,"All students, Undergraduate, Other degree/certifcate-seeking, Transfer-ins",60,28,32,-2
201645,Case Western Reserve University,2013,"All students, Undergraduate, Other degree/certifcate-seeking, Continuing",3239,1817,1422,-2
201645,Case Western Reserve University,2013,"All students, Undergraduate, Non-degree/certificate-seeking",110,46,64,-2
201645,Case Western Reserve University,2013,"All students, Graduate",5664,2676,2988,-2
201654,Cedarville University,2013,All students total,3462,1608,1854,-2
201654,Cedarville University,2013,"All students, Undergraduate total",3238,1531,1707,-2
201654,Cedarville University,2013,"All students, Undergraduate, Degree/certificate-seeking total",3108,1471,1637,-2
201654,Cedarville University,2013,"All students, Undergraduate, Degree/certificate-seeking, First-time",781,368,413,-2
201654,Cedarville University,2013,"All students, Undergraduate, Other degree/certificate-seeking",2327,1103,1224,-2
201654,Cedarville University,2013,"All students, Undergraduate, Other degree/certifcate-seeking, Transfer-ins",66,31,35,-2
201654,Cedarville University,2013,"All students, Undergraduate, Other degree/certifcate-seeking, Continuing",2261,1072,1189,-2
201654,Cedarville University,2013,"All students, Undergraduate, Non-degree/certificate-seeking",130,60,70,-2
201654,Cedarville University,2013,"All students, Graduate",224,77,147,-2
201690,Central State University,2013,All students total,2068,963,1105,-2
201690,Central State University,2013,"All students, Undergraduate total",2036,949,1087,-2
201690,Central State University,2013,"All students, Undergraduate, Degree/certificate-seeking total",2028,946,1082,-2
201690,Central State University,2013,"All students, Undergraduate, Degree/certificate-seeking, First-time",417,200,217,-2
201690,Central State University,2013,"All students, Undergraduate, Other degree/certificate-seeking",1611,746,865,-2
201690,Central State University,2013,"All students, Undergraduate, Other degree/certifcate-seeking, Transfer-ins",161,68,93,-2
201690,Central State University,2013,"All students, Undergraduate, Other degree/certifcate-seeking, Continuing",1450,678,772,-2
201690,Central State University,2013,"All students, Undergraduate, Non-degree/certificate-seeking",8,3,5,-2
201690,Central State University,2013,"All students, Graduate",32,14,18,-2
201821,The Christ College of Nursing and Health Sciences,2013,All students total,535,65,470,-2
201821,The Christ College of Nursing and Health Sciences,2013,"All students, Undergraduate total",535,65,470,-2
201821,The Christ College of Nursing and Health Sciences,2013,"All students, Undergraduate, Degree/certificate-seeking total",535,65,470,-2
201821,The Christ College of Nursing and Health Sciences,2013,"All students, Undergraduate, Degree/certificate-seeking, First-time",30,2,28,-2
201821,The Christ College of Nursing and Health Sciences,2013,"All students, Undergraduate, Other degree/certificate-seeking",505,63,442,-2
201821,The Christ College of Nursing and Health Sciences,2013,"All students, Undergraduate, Other degree/certifcate-seeking, Transfer-ins",184,25,159,-2
201821,The Christ College of Nursing and Health Sciences,2013,"All students, Undergraduate, Other degree/certifcate-seeking, Continuing",321,38,283,-2
201858,Cincinnati Christian University,2013,All students total,918,530,388,-2
201858,Cincinnati Christian University,2013,"All students, Undergraduate total",676,363,313,-2
201858,Cincinnati Christian University,2013,"All students, Undergraduate, Degree/certificate-seeking total",669,363,306,-2
201858,Cincinnati Christian University,2013,"All students, Undergraduate, Degree/certificate-seeking, First-time",111,60,51,-2
201858,Cincinnati Christian University,2013,"All students, Undergraduate, Other degree/certificate-seeking",558,303,255,-2
201858,Cincinnati Christian University,2013,"All students, Undergraduate, Other degree/certifcate-seeking, Transfer-ins",69,28,41,-2
201858,Cincinnati Christian University,2013,"All students, Undergraduate, Other degree/certifcate-seeking, Continuing",489,275,214,-2
201858,Cincinnati Christian University,2013,"All students, Undergraduate, Non-degree/certificate-seeking",7,0,7,-2
201858,Cincinnati Christian University,2013,"All students, Graduate",242,167,75,-2
201867,Cincinnati College of Mortuary Science,2013,All students total,81,27,54,-2
201867,Cincinnati College of Mortuary Science,2013,"All students, Undergraduate total",81,27,54,-2
201867,Cincinnati College of Mortuary Science,2013,"All students, Undergraduate, Degree/certificate-seeking total",81,27,54,-2
201867,Cincinnati College of Mortuary Science,2013,"All students, Undergraduate, Other degree/certificate-seeking",81,27,54,-2
201867,Cincinnati College of Mortuary Science,2013,"All students, Undergraduate, Other degree/certifcate-seeking, Transfer-ins",46,20,26,-2
201867,Cincinnati College of Mortuary Science,2013,"All students, Undergraduate, Other degree/certifcate-seeking, Continuing",35,7,28,-2
201885,University of Cincinnati-Main Campus,2013,All students total,34379,16079,18300,-2
201885,University of Cincinnati-Main Campus,2013,"All students, Undergraduate total",23706,11812,11894,-2
201885,University of Cincinnati-Main Campus,2013,"All students, Undergraduate, Degree/certificate-seeking total",23360,11642,11718,-2
201885,University of Cincinnati-Main Campus,2013,"All students, Undergraduate, Degree/certificate-seeking, First-time",4486,2409,2077,-2
201885,University of Cincinnati-Main Campus,2013,"All students, Undergraduate, Other degree/certificate-seeking",18874,9233,9641,-2
201885,University of Cincinnati-Main Campus,2013,"All students, Undergraduate, Other degree/certifcate-seeking, Transfer-ins",1168,453,715,-2
201885,University of Cincinnati-Main Campus,2013,"All students, Undergraduate, Other degree/certifcate-seeking, Continuing",17706,8780,8926,-2
201885,University of Cincinnati-Main Campus,2013,"All students, Undergraduate, Non-degree/certificate-seeking",346,170,176,-2
201885,University of Cincinnati-Main Campus,2013,"All students, Graduate",10673,4267,6406,-2
201946,University of Cincinnati-Clermont College,2013,All students total,3461,1489,1972,-2
201946,University of Cincinnati-Clermont College,2013,"All students, Undergraduate total",3446,1485,1961,-2
201946,University of Cincinnati-Clermont College,2013,"All students, Undergraduate, Degree/certificate-seeking total",3015,1307,1708,-2
201946,University of Cincinnati-Clermont College,2013,"All students, Undergraduate, Degree/certificate-seeking, First-time",782,359,423,-2
201946,University of Cincinnati-Clermont College,2013,"All students, Undergraduate, Other degree/certificate-seeking",2233,948,1285,-2
201946,University of Cincinnati-Clermont College,2013,"All students, Undergraduate, Other degree/certifcate-seeking, Transfer-ins",237,100,137,-2
201946,University of Cincinnati-Clermont College,2013,"All students, Undergraduate, Other degree/certifcate-seeking, Continuing",1996,848,1148,-2
201946,University of Cincinnati-Clermont College,2013,"All students, Undergraduate, Non-degree/certificate-seeking",431,178,253,-2
201946,University of Cincinnati-Clermont College,2013,"All students, Graduate",15,4,11,-2
201955,University of Cincinnati-Blue Ash College,2013,All students total,4816,1980,2836,-2
201955,University of Cincinnati-Blue Ash College,2013,"All students, Undergraduate total",4796,1974,2822,-2
201955,University of Cincinnati-Blue Ash College,2013,"All students, Undergraduate, Degree/certificate-seeking total",4550,1864,2686,-2
201955,University of Cincinnati-Blue Ash College,2013,"All students, Undergraduate, Degree/certificate-seeking, First-time",1085,459,626,-2
201955,University of Cincinnati-Blue Ash College,2013,"All students, Undergraduate, Other degree/certificate-seeking",3465,1405,2060,-2
201955,University of Cincinnati-Blue Ash College,2013,"All students, Undergraduate, Other degree/certifcate-seeking, Transfer-ins",362,170,192,-2
201955,University of Cincinnati-Blue Ash College,2013,"All students, Undergraduate, Other degree/certifcate-seeking, Continuing",3103,1235,1868,-2
201955,University of Cincinnati-Blue Ash College,2013,"All students, Undergraduate, Non-degree/certificate-seeking",246,110,136,-2
201955,University of Cincinnati-Blue Ash College,2013,"All students, Graduate",20,6,14,-2
201964,Ohio Christian University,2013,All students total,3711,1482,2229,-2
201964,Ohio Christian University,2013,"All students, Undergraduate total",3528,1392,2136,-2
201964,Ohio Christian University,2013,"All students, Undergraduate, Degree/certificate-seeking total",3155,1256,1899,-2
201964,Ohio Christian University,2013,"All students, Undergraduate, Degree/certificate-seeking, First-time",719,310,409,-2
201964,Ohio Christian University,2013,"All students, Undergraduate, Other degree/certificate-seeking",2436,946,1490,-2
201964,Ohio Christian University,2013,"All students, Undergraduate, Other degree/certifcate-seeking, Transfer-ins",309,127,182,-2
201964,Ohio Christian University,2013,"All students, Undergraduate, Other degree/certifcate-seeking, Continuing",2127,819,1308,-2
201964,Ohio Christian University,2013,"All students, Undergraduate, Non-degree/certificate-seeking",373,136,237,-2
201964,Ohio Christian University,2013,"All students, Graduate",183,90,93,-2
202046,Cleveland Institute of Art,2013,All students total,568,241,327,-2
202046,Cleveland Institute of Art,2013,"All students, Undergraduate total",568,241,327,-2
202046,Cleveland Institute of Art,2013,"All students, Undergraduate, Degree/certificate-seeking total",556,236,320,-2
202046,Cleveland Institute of Art,2013,"All students, Undergraduate, Degree/certificate-seeking, First-time",155,60,95,-2
202046,Cleveland Institute of Art,2013,"All students, Undergraduate, Other degree/certificate-seeking",401,176,225,-2
202046,Cleveland Institute of Art,2013,"All students, Undergraduate, Other degree/certifcate-seeking, Transfer-ins",29,15,14,-2
202046,Cleveland Institute of Art,2013,"All students, Undergraduate, Other degree/certifcate-seeking, Continuing",372,161,211,-2
202046,Cleveland Institute of Art,2013,"All students, Undergraduate, Non-degree/certificate-seeking",12,5,7,-2
202073,Cleveland Institute of Music,2013,All students total,451,208,243,-2
202073,Cleveland Institute of Music,2013,"All students, Undergraduate total",237,119,118,-2
202073,Cleveland Institute of Music,2013,"All students, Undergraduate, Degree/certificate-seeking total",237,119,118,-2
202073,Cleveland Institute of Music,2013,"All students, Undergraduate, Degree/certificate-seeking, First-time",64,27,37,-2
202073,Cleveland Institute of Music,2013,"All students, Undergraduate, Other degree/certificate-seeking",173,92,81,-2
202073,Cleveland Institute of Music,2013,"All students, Undergraduate, Other degree/certifcate-seeking, Transfer-ins",5,3,2,-2
202073,Cleveland Institute of Music,2013,"All students, Undergraduate, Other degree/certifcate-seeking, Continuing",168,89,79,-2
202073,Cleveland Institute of Music,2013,"All students, Graduate",214,89,125,-2
202134,Cleveland State University,2013,All students total,17497,7811,9686,-2
202134,Cleveland State University,2013,"All students, Undergraduate total",12133,5547,6586,-2
202134,Cleveland State University,2013,"All students, Undergraduate, Degree/certificate-seeking total",11484,5275,6209,-2
202134,Cleveland State University,2013,"All students, Undergraduate, Degree/certificate-seeking, First-time",1773,787,986,-2
202134,Cleveland State University,2013,"All students, Undergraduate, Other degree/certificate-seeking",9711,4488,5223,-2
202134,Cleveland State University,2013,"All students, Undergraduate, Other degree/certifcate-seeking, Transfer-ins",1658,726,932,-2
202134,Cleveland State University,2013,"All students, Undergraduate, Other degree/certifcate-seeking, Continuing",8053,3762,4291,-2
202134,Cleveland State University,2013,"All students, Undergraduate, Non-degree/certificate-seeking",649,272,377,-2
202134,Cleveland State University,2013,"All students, Graduate",5364,2264,3100,-2
202170,Columbus College of Art and Design,2013,All students total,1379,523,856,-2
202170,Columbus College of Art and Design,2013,"All students, Undergraduate total",1348,508,840,-2
202170,Columbus College of Art and Design,2013,"All students, Undergraduate, Degree/certificate-seeking total",1277,486,791,-2
202170,Columbus College of Art and Design,2013,"All students, Undergraduate, Degree/certificate-seeking, First-time",235,82,153,-2
202170,Columbus College of Art and Design,2013,"All students, Undergraduate, Other degree/certificate-seeking",1042,404,638,-2
202170,Columbus College of Art and Design,2013,"All students, Undergraduate, Other degree/certifcate-seeking, Transfer-ins",87,24,63,-2
202170,Columbus College of Art and Design,2013,"All students, Undergraduate, Other degree/certifcate-seeking, Continuing",955,380,575,-2
202170,Columbus College of Art and Design,2013,"All students, Undergraduate, Non-degree/certificate-seeking",71,22,49,-2
202170,Columbus College of Art and Design,2013,"All students, Graduate",31,15,16,-2
202480,University of Dayton,2013,All students total,10835,5524,5311,-2
202480,University of Dayton,2013,"All students, Undergraduate total",7975,4122,3853,-2
202480,University of Dayton,2013,"All students, Undergraduate, Degree/certificate-seeking total",7812,4041,3771,-2
202480,University of Dayton,2013,"All students, Undergraduate, Degree/certificate-seeking, First-time",1769,900,869,-2
202480,University of Dayton,2013,"All students, Undergraduate, Other degree/certificate-seeking",6043,3141,2902,-2
202480,University of Dayton,2013,"All students, Undergraduate, Other degree/certifcate-seeking, Transfer-ins",133,78,55,-2
202480,University of Dayton,2013,"All students, Undergraduate, Other degree/certifcate-seeking, Continuing",5910,3063,2847,-2
202480,University of Dayton,2013,"All students, Undergraduate, Non-degree/certificate-seeking",163,81,82,-2
202480,University of Dayton,2013,"All students, Graduate",2860,1402,1458,-2
202514,Defiance College,2013,All students total,989,510,479,-2
202514,Defiance College,2013,"All students, Undergraduate total",892,462,430,-2
202514,Defiance College,2013,"All students, Undergraduate, Degree/certificate-seeking total",871,457,414,-2
202514,Defiance College,2013,"All students, Undergraduate, Degree/certificate-seeking, First-time",241,154,87,-2
202514,Defiance College,2013,"All students, Undergraduate, Other degree/certificate-seeking",630,303,327,-2
202514,Defiance College,2013,"All students, Undergraduate, Other degree/certifcate-seeking, Transfer-ins",57,27,30,-2
202514,Defiance College,2013,"All students, Undergraduate, Other degree/certifcate-seeking, Continuing",573,276,297,-2
202514,Defiance College,2013,"All students, Undergraduate, Non-degree/certificate-seeking",21,5,16,-2
202514,Defiance College,2013,"All students, Graduate",97,48,49,-2
202523,Denison University,2013,All students total,2274,958,1316,-2
202523,Denison University,2013,"All students, Undergraduate total",2274,958,1316,-2
202523,Denison University,2013,"All students, Undergraduate, Degree/certificate-seeking total",2255,950,1305,-2
202523,Denison University,2013,"All students, Undergraduate, Degree/certificate-seeking, First-time",582,259,323,-2
202523,Denison University,2013,"All students, Undergraduate, Other degree/certificate-seeking",1673,691,982,-2
202523,Denison University,2013,"All students, Undergraduate, Other degree/certifcate-seeking, Transfer-ins",17,10,7,-2
202523,Denison University,2013,"All students, Undergraduate, Other degree/certifcate-seeking, Continuing",1656,681,975,-2
202523,Denison University,2013,"All students, Undergraduate, Non-degree/certificate-seeking",19,8,11,-2
202541,DeVry University-Ohio,2013,,,,,-2
202611,Chancellor University,2013,,,,,-2
202684,Bryant & Stratton College-Cleveland,2013,All students total,538,119,419,-2
202684,Bryant & Stratton College-Cleveland,2013,"All students, Undergraduate total",538,119,419,-2
202684,Bryant & Stratton College-Cleveland,2013,"All students, Undergraduate, Degree/certificate-seeking total",538,119,419,-2
202684,Bryant & Stratton College-Cleveland,2013,"All students, Undergraduate, Degree/certificate-seeking, First-time",31,10,21,-2
202684,Bryant & Stratton College-Cleveland,2013,"All students, Undergraduate, Other degree/certificate-seeking",507,109,398,-2
202684,Bryant & Stratton College-Cleveland,2013,"All students, Undergraduate, Other degree/certifcate-seeking, Transfer-ins",80,21,59,-2
202684,Bryant & Stratton College-Cleveland,2013,"All students, Undergraduate, Other degree/certifcate-seeking, Continuing",427,88,339,-2
202763,The University of Findlay,2013,All students total,4880,1855,3025,-2
202763,The University of Findlay,2013,"All students, Undergraduate total",3872,1455,2417,-2
202763,The University of Findlay,2013,"All students, Undergraduate, Degree/certificate-seeking total",2663,958,1705,-2
202763,The University of Findlay,2013,"All students, Undergraduate, Degree/certificate-seeking, First-time",581,184,397,-2
202763,The University of Findlay,2013,"All students, Undergraduate, Other degree/certificate-seeking",2082,774,1308,-2
202763,The University of Findlay,2013,"All students, Undergraduate, Other degree/certifcate-seeking, Transfer-ins",128,47,81,-2
202763,The University of Findlay,2013,"All students, Undergraduate, Other degree/certifcate-seeking, Continuing",1954,727,1227,-2
202763,The University of Findlay,2013,"All students, Undergraduate, Non-degree/certificate-seeking",1209,497,712,-2
202763,The University of Findlay,2013,"All students, Graduate",1008,400,608,-2
202806,Franklin University,2013,All students total,6274,2684,3590,-2
202806,Franklin University,2013,"All students, Undergraduate total",5185,2262,2923,-2
202806,Franklin University,2013,"All students, Undergraduate, Degree/certificate-seeking total",5129,2226,2903,-2
202806,Franklin University,2013,"All students, Undergraduate, Degree/certificate-seeking, First-time",86,35,51,-2
202806,Franklin University,2013,"All students, Undergraduate, Other degree/certificate-seeking",5043,2191,2852,-2
202806,Franklin University,2013,"All students, Undergraduate, Other degree/certifcate-seeking, Transfer-ins",937,393,544,-2
202806,Franklin University,2013,"All students, Undergraduate, Other degree/certifcate-seeking, Continuing",4106,1798,2308,-2
202806,Franklin University,2013,"All students, Undergraduate, Non-degree/certificate-seeking",56,36,20,-2
202806,Franklin University,2013,"All students, Graduate",1089,422,667,-2
202903,Gods Bible School and College,2013,All students total,305,156,149,-2
202903,Gods Bible School and College,2013,"All students, Undergraduate total",305,156,149,-2
202903,Gods Bible School and College,2013,"All students, Undergraduate, Degree/certificate-seeking total",259,128,131,-2
202903,Gods Bible School and College,2013,"All students, Undergraduate, Degree/certificate-seeking, First-time",67,35,32,-2
202903,Gods Bible School and College,2013,"All students, Undergraduate, Other degree/certificate-seeking",192,93,99,-2
202903,Gods Bible School and College,2013,"All students, Undergraduate, Other degree/certifcate-seeking, Transfer-ins",14,5,9,-2
202903,Gods Bible School and College,2013,"All students, Undergraduate, Other degree/certifcate-seeking, Continuing",178,88,90,-2
202903,Gods Bible School and College,2013,"All students, Undergraduate, Non-degree/certificate-seeking",46,28,18,-2
202912,Good Samaritan College of Nursing and Health Science,2013,All students total,355,35,320,-2
202912,Good Samaritan College of Nursing and Health Science,2013,"All students, Undergraduate total",355,35,320,-2
202912,Good Samaritan College of Nursing and Health Science,2013,"All students, Undergraduate, Degree/certificate-seeking total",355,35,320,-2
202912,Good Samaritan College of Nursing and Health Science,2013,"All students, Undergraduate, Degree/certificate-seeking, First-time",16,1,15,-2
202912,Good Samaritan College of Nursing and Health Science,2013,"All students, Undergraduate, Other degree/certificate-seeking",339,34,305,-2
202912,Good Samaritan College of Nursing and Health Science,2013,"All students, Undergraduate, Other degree/certifcate-seeking, Transfer-ins",74,1,73,-2
202912,Good Samaritan College of Nursing and Health Science,2013,"All students, Undergraduate, Other degree/certifcate-seeking, Continuing",265,33,232,-2
203067,Hebrew Union College-Jewish Institute of Religion,2013,All students total,359,145,214,-2
203067,Hebrew Union College-Jewish Institute of Religion,2013,"All students, Graduate",359,145,214,-2
203085,Heidelberg University,2013,All students total,1241,590,651,-2
203085,Heidelberg University,2013,"All students, Undergraduate total",1107,551,556,-2
203085,Heidelberg University,2013,"All students, Undergraduate, Degree/certificate-seeking total",1099,550,549,-2
203085,Heidelberg University,2013,"All students, Undergraduate, Degree/certificate-seeking, First-time",351,176,175,-2
203085,Heidelberg University,2013,"All students, Undergraduate, Other degree/certificate-seeking",748,374,374,-2
203085,Heidelberg University,2013,"All students, Undergraduate, Other degree/certifcate-seeking, Transfer-ins",32,19,13,-2
203085,Heidelberg University,2013,"All students, Undergraduate, Other degree/certifcate-seeking, Continuing",716,355,361,-2
203085,Heidelberg University,2013,"All students, Undergraduate, Non-degree/certificate-seeking",8,1,7,-2
203085,Heidelberg University,2013,"All students, Graduate",134,39,95,-2
203128,Hiram College,2013,All students total,1311,590,721,-2
203128,Hiram College,2013,"All students, Undergraduate total",1283,581,702,-2
203128,Hiram College,2013,"All students, Undergraduate, Degree/certificate-seeking total",1260,572,688,-2
203128,Hiram College,2013,"All students, Undergraduate, Degree/certificate-seeking, First-time",290,159,131,-2
203128,Hiram College,2013,"All students, Undergraduate, Other degree/certificate-seeking",970,413,557,-2
203128,Hiram College,2013,"All students, Undergraduate, Other degree/certifcate-seeking, Transfer-ins",81,45,36,-2
203128,Hiram College,2013,"All students, Undergraduate, Other degree/certifcate-seeking, Continuing",889,368,521,-2
203128,Hiram College,2013,"All students, Undergraduate, Non-degree/certificate-seeking",23,9,14,-2
203128,Hiram College,2013,"All students, Graduate",28,9,19,-2
203313,ITT Technical Institute-Dayton,2013,All students total,304,195,109,-2
203313,ITT Technical Institute-Dayton,2013,"All students, Undergraduate total",304,195,109,-2
203313,ITT Technical Institute-Dayton,2013,"All students, Undergraduate, Degree/certificate-seeking total",304,195,109,-2
203313,ITT Technical Institute-Dayton,2013,"All students, Undergraduate, Degree/certificate-seeking, First-time",53,31,22,-2
203313,ITT Technical Institute-Dayton,2013,"All students, Undergraduate, Other degree/certificate-seeking",251,164,87,-2
203313,ITT Technical Institute-Dayton,2013,"All students, Undergraduate, Other degree/certifcate-seeking, Transfer-ins",8,3,5,-2
203313,ITT Technical Institute-Dayton,2013,"All students, Undergraduate, Other degree/certifcate-seeking, Continuing",243,161,82,-2
203368,John Carroll University,2013,All students total,3711,1786,1925,-2
203368,John Carroll University,2013,"All students, Undergraduate total",3040,1585,1455,-2
203368,John Carroll University,2013,"All students, Undergraduate, Degree/certificate-seeking total",3009,1564,1445,-2
203368,John Carroll University,2013,"All students, Undergraduate, Degree/certificate-seeking, First-time",793,411,382,-2
203368,John Carroll University,2013,"All students, Undergraduate, Other degree/certificate-seeking",2216,1153,1063,-2
203368,John Carroll University,2013,"All students, Undergraduate, Other degree/certifcate-seeking, Transfer-ins",92,51,41,-2
203368,John Carroll University,2013,"All students, Undergraduate, Other degree/certifcate-seeking, Continuing",2124,1102,1022,-2
203368,John Carroll University,2013,"All students, Undergraduate, Non-degree/certificate-seeking",31,21,10,-2
203368,John Carroll University,2013,"All students, Graduate",671,201,470,-2
203386,Hondros College,2013,All students total,1656,123,1533,-2
203386,Hondros College,2013,"All students, Undergraduate total",1656,123,1533,-2
203386,Hondros College,2013,"All students, Undergraduate, Degree/certificate-seeking total",1656,123,1533,-2
203386,Hondros College,2013,"All students, Undergraduate, Degree/certificate-seeking, First-time",58,3,55,-2
203386,Hondros College,2013,"All students, Undergraduate, Other degree/certificate-seeking",1598,120,1478,-2
203386,Hondros College,2013,"All students, Undergraduate, Other degree/certifcate-seeking, Transfer-ins",482,33,449,-2
203386,Hondros College,2013,"All students, Undergraduate, Other degree/certifcate-seeking, Continuing",1116,87,1029,-2
203447,Kent State University at Ashtabula,2013,All students total,2341,774,1567,-2
203447,Kent State University at Ashtabula,2013,"All students, Undergraduate total",2339,772,1567,-2
203447,Kent State University at Ashtabula,2013,"All students, Undergraduate, Degree/certificate-seeking total",2221,722,1499,-2
203447,Kent State University at Ashtabula,2013,"All students, Undergraduate, Degree/certificate-seeking, First-time",224,93,131,-2
203447,Kent State University at Ashtabula,2013,"All students, Undergraduate, Other degree/certificate-seeking",1997,629,1368,-2
203447,Kent State University at Ashtabula,2013,"All students, Undergraduate, Other degree/certifcate-seeking, Transfer-ins",147,45,102,-2
203447,Kent State University at Ashtabula,2013,"All students, Undergraduate, Other degree/certifcate-seeking, Continuing",1850,584,1266,-2
203447,Kent State University at Ashtabula,2013,"All students, Undergraduate, Non-degree/certificate-seeking",118,50,68,-2
203447,Kent State University at Ashtabula,2013,"All students, Graduate",2,2,0,-2
203456,Kent State University at East Liverpool,2013,All students total,1672,503,1169,-2
203456,Kent State University at East Liverpool,2013,"All students, Undergraduate total",1671,503,1168,-2
203456,Kent State University at East Liverpool,2013,"All students, Undergraduate, Degree/certificate-seeking total",1529,445,1084,-2
203456,Kent State University at East Liverpool,2013,"All students, Undergraduate, Degree/certificate-seeking, First-time",122,42,80,-2
203456,Kent State University at East Liverpool,2013,"All students, Undergraduate, Other degree/certificate-seeking",1407,403,1004,-2
203456,Kent State University at East Liverpool,2013,"All students, Undergraduate, Other degree/certifcate-seeking, Transfer-ins",74,20,54,-2
203456,Kent State University at East Liverpool,2013,"All students, Undergraduate, Other degree/certifcate-seeking, Continuing",1333,383,950,-2
203456,Kent State University at East Liverpool,2013,"All students, Undergraduate, Non-degree/certificate-seeking",142,58,84,-2
203456,Kent State University at East Liverpool,2013,"All students, Graduate",1,0,1,-2
203465,Kent State University at Stark,2013,All students total,4886,1964,2922,-2
203465,Kent State University at Stark,2013,"All students, Undergraduate total",4836,1941,2895,-2
203465,Kent State University at Stark,2013,"All students, Undergraduate, Degree/certificate-seeking total",4680,1895,2785,-2
203465,Kent State University at Stark,2013,"All students, Undergraduate, Degree/certificate-seeking, First-time",729,299,430,-2
203465,Kent State University at Stark,2013,"All students, Undergraduate, Other degree/certificate-seeking",3951,1596,2355,-2
203465,Kent State University at Stark,2013,"All students, Undergraduate, Other degree/certifcate-seeking, Transfer-ins",457,184,273,-2
203465,Kent State University at Stark,2013,"All students, Undergraduate, Other degree/certifcate-seeking, Continuing",3494,1412,2082,-2
203465,Kent State University at Stark,2013,"All students, Undergraduate, Non-degree/certificate-seeking",156,46,110,-2
203465,Kent State University at Stark,2013,"All students, Graduate",50,23,27,-2
203474,Kent State University at Trumbull,2013,All students total,3087,1132,1955,-2
203474,Kent State University at Trumbull,2013,"All students, Undergraduate total",3061,1129,1932,-2
203474,Kent State University at Trumbull,2013,"All students, Undergraduate, Degree/certificate-seeking total",2944,1085,1859,-2
203474,Kent State University at Trumbull,2013,"All students, Undergraduate, Degree/certificate-seeking, First-time",371,136,235,-2
203474,Kent State University at Trumbull,2013,"All students, Undergraduate, Other degree/certificate-seeking",2573,949,1624,-2
203474,Kent State University at Trumbull,2013,"All students, Undergraduate, Other degree/certifcate-seeking, Transfer-ins",198,70,128,-2
203474,Kent State University at Trumbull,2013,"All students, Undergraduate, Other degree/certifcate-seeking, Continuing",2375,879,1496,-2
203474,Kent State University at Trumbull,2013,"All students, Undergraduate, Non-degree/certificate-seeking",117,44,73,-2
203474,Kent State University at Trumbull,2013,"All students, Graduate",26,3,23,-2
203483,Kent State University at Tuscarawas,2013,All students total,2408,1015,1393,-2
203483,Kent State University at Tuscarawas,2013,"All students, Undergraduate total",2375,1010,1365,-2
203483,Kent State University at Tuscarawas,2013,"All students, Undergraduate, Degree/certificate-seeking total",2030,848,1182,-2
203483,Kent State University at Tuscarawas,2013,"All students, Undergraduate, Degree/certificate-seeking, First-time",329,135,194,-2
203483,Kent State University at Tuscarawas,2013,"All students, Undergraduate, Other degree/certificate-seeking",1701,713,988,-2
203483,Kent State University at Tuscarawas,2013,"All students, Undergraduate, Other degree/certifcate-seeking, Transfer-ins",94,41,53,-2
203483,Kent State University at Tuscarawas,2013,"All students, Undergraduate, Other degree/certifcate-seeking, Continuing",1607,672,935,-2
203483,Kent State University at Tuscarawas,2013,"All students, Undergraduate, Non-degree/certificate-seeking",345,162,183,-2
203483,Kent State University at Tuscarawas,2013,"All students, Graduate",33,5,28,-2
203492,Kent State University at Salem,2013,All students total,1846,538,1308,-2
203492,Kent State University at Salem,2013,"All students, Undergraduate total",1844,537,1307,-2
203492,Kent State University at Salem,2013,"All students, Undergraduate, Degree/certificate-seeking total",1713,482,1231,-2
203492,Kent State University at Salem,2013,"All students, Undergraduate, Degree/certificate-seeking, First-time",205,61,144,-2
203492,Kent State University at Salem,2013,"All students, Undergraduate, Other degree/certificate-seeking",1508,421,1087,-2
203492,Kent State University at Salem,2013,"All students, Undergraduate, Other degree/certifcate-seeking, Transfer-ins",116,34,82,-2
203492,Kent State University at Salem,2013,"All students, Undergraduate, Other degree/certifcate-seeking, Continuing",1392,387,1005,-2
203492,Kent State University at Salem,2013,"All students, Undergraduate, Non-degree/certificate-seeking",131,55,76,-2
203492,Kent State University at Salem,2013,"All students, Graduate",2,1,1,-2
203517,Kent State University at Kent,2013,All students total,28998,11682,17316,-2
203517,Kent State University at Kent,2013,"All students, Undergraduate total",22968,9508,13460,-2
203517,Kent State University at Kent,2013,"All students, Undergraduate, Degree/certificate-seeking total",22071,9126,12945,-2
203517,Kent State University at Kent,2013,"All students, Undergraduate, Degree/certificate-seeking, First-time",4350,1626,2724,-2
203517,Kent State University at Kent,2013,"All students, Undergraduate, Other degree/certificate-seeking",17721,7500,10221,-2
203517,Kent State University at Kent,2013,"All students, Undergraduate, Other degree/certifcate-seeking, Transfer-ins",1204,554,650,-2
203517,Kent State University at Kent,2013,"All students, Undergraduate, Other degree/certifcate-seeking, Continuing",16517,6946,9571,-2
203517,Kent State University at Kent,2013,"All students, Undergraduate, Non-degree/certificate-seeking",897,382,515,-2
203517,Kent State University at Kent,2013,"All students, Graduate",6030,2174,3856,-2
203526,Kent State University at Geauga,2013,All students total,2653,1009,1644,-2
203526,Kent State University at Geauga,2013,"All students, Undergraduate total",2646,1008,1638,-2
203526,Kent State University at Geauga,2013,"All students, Undergraduate, Degree/certificate-seeking total",2407,936,1471,-2
203526,Kent State University at Geauga,2013,"All students, Undergraduate, Degree/certificate-seeking, First-time",344,175,169,-2
203526,Kent State University at Geauga,2013,"All students, Undergraduate, Other degree/certificate-seeking",2063,761,1302,-2
203526,Kent State University at Geauga,2013,"All students, Undergraduate, Other degree/certifcate-seeking, Transfer-ins",192,75,117,-2
203526,Kent State University at Geauga,2013,"All students, Undergraduate, Other degree/certifcate-seeking, Continuing",1871,686,1185,-2
203526,Kent State University at Geauga,2013,"All students, Undergraduate, Non-degree/certificate-seeking",239,72,167,-2
203526,Kent State University at Geauga,2013,"All students, Graduate",7,1,6,-2
203535,Kenyon College,2013,All students total,1705,789,916,-2
203535,Kenyon College,2013,"All students, Undergraduate total",1705,789,916,-2
203535,Kenyon College,2013,"All students, Undergraduate, Degree/certificate-seeking total",1694,786,908,-2
203535,Kenyon College,2013,"All students, Undergraduate, Degree/certificate-seeking, First-time",480,220,260,-2
203535,Kenyon College,2013,"All students, Undergraduate, Other degree/certificate-seeking",1214,566,648,-2
203535,Kenyon College,2013,"All students, Undergraduate, Other degree/certifcate-seeking, Transfer-ins",13,4,9,-2
203535,Kenyon College,2013,"All students, Undergraduate, Other degree/certifcate-seeking, Continuing",1201,562,639,-2
203535,Kenyon College,2013,"All students, Undergraduate, Non-degree/certificate-seeking",11,3,8,-2
203544,Kettering College,2013,All students total,880,176,704,-2
203544,Kettering College,2013,"All students, Undergraduate total",800,148,652,-2
203544,Kettering College,2013,"All students, Undergraduate, Degree/certificate-seeking total",783,143,640,-2
203544,Kettering College,2013,"All students, Undergraduate, Degree/certificate-seeking, First-time",67,5,62,-2
203544,Kettering College,2013,"All students, Undergraduate, Other degree/certificate-seeking",716,138,578,-2
203544,Kettering College,2013,"All students, Undergraduate, Other degree/certifcate-seeking, Transfer-ins",109,24,85,-2
203544,Kettering College,2013,"All students, Undergraduate, Other degree/certifcate-seeking, Continuing",607,114,493,-2
203544,Kettering College,2013,"All students, Undergraduate, Non-degree/certificate-seeking",17,5,12,-2
203544,Kettering College,2013,"All students, Graduate",80,28,52,-2
203580,Lake Erie College,2013,All students total,1086,568,518,-2
203580,Lake Erie College,2013,"All students, Undergraduate total",922,474,448,-2
203580,Lake Erie College,2013,"All students, Undergraduate, Degree/certificate-seeking total",839,455,384,-2
203580,Lake Erie College,2013,"All students, Undergraduate, Degree/certificate-seeking, First-time",206,119,87,-2
203580,Lake Erie College,2013,"All students, Undergraduate, Other degree/certificate-seeking",633,336,297,-2
203580,Lake Erie College,2013,"All students, Undergraduate, Other degree/certifcate-seeking, Transfer-ins",45,28,17,-2
203580,Lake Erie College,2013,"All students, Undergraduate, Other degree/certifcate-seeking, Continuing",588,308,280,-2
203580,Lake Erie College,2013,"All students, Undergraduate, Non-degree/certificate-seeking",83,19,64,-2
203580,Lake Erie College,2013,"All students, Graduate",164,94,70,-2
203757,Lourdes University,2013,All students total,2187,602,1585,-2
203757,Lourdes University,2013,"All students, Undergraduate total",1806,535,1271,-2
203757,Lourdes University,2013,"All students, Undergraduate, Degree/certificate-seeking total",1747,515,1232,-2
203757,Lourdes University,2013,"All students, Undergraduate, Degree/certificate-seeking, First-time",223,61,162,-2
203757,Lourdes University,2013,"All students, Undergraduate, Other degree/certificate-seeking",1524,454,1070,-2
203757,Lourdes University,2013,"All students, Undergraduate, Other degree/certifcate-seeking, Transfer-ins",153,54,99,-2
203757,Lourdes University,2013,"All students, Undergraduate, Other degree/certifcate-seeking, Continuing",1371,400,971,-2
203757,Lourdes University,2013,"All students, Undergraduate, Non-degree/certificate-seeking",59,20,39,-2
203757,Lourdes University,2013,"All students, Graduate",381,67,314,-2
203775,Malone University,2013,All students total,2074,839,1235,-2
203775,Malone University,2013,"All students, Undergraduate total",1656,705,951,-2
203775,Malone University,2013,"All students, Undergraduate, Degree/certificate-seeking total",1571,682,889,-2
203775,Malone University,2013,"All students, Undergraduate, Degree/certificate-seeking, First-time",316,151,165,-2
203775,Malone University,2013,"All students, Undergraduate, Other degree/certificate-seeking",1255,531,724,-2
203775,Malone University,2013,"All students, Undergraduate, Other degree/certifcate-seeking, Transfer-ins",126,46,80,-2
203775,Malone University,2013,"All students, Undergraduate, Other degree/certifcate-seeking, Continuing",1129,485,644,-2
203775,Malone University,2013,"All students, Undergraduate, Non-degree/certificate-seeking",85,23,62,-2
203775,Malone University,2013,"All students, Graduate",418,134,284,-2
203845,Marietta College,2013,All students total,1542,848,694,-2
203845,Marietta College,2013,"All students, Undergraduate total",1416,824,592,-2
203845,Marietta College,2013,"All students, Undergraduate, Degree/certificate-seeking total",1390,810,580,-2
203845,Marietta College,2013,"All students, Undergraduate, Degree/certificate-seeking, First-time",385,243,142,-2
203845,Marietta College,2013,"All students, Undergraduate, Other degree/certificate-seeking",1005,567,438,-2
203845,Marietta College,2013,"All students, Undergraduate, Other degree/certifcate-seeking, Transfer-ins",38,20,18,-2
203845,Marietta College,2013,"All students, Undergraduate, Other degree/certifcate-seeking, Continuing",967,547,420,-2
203845,Marietta College,2013,"All students, Undergraduate, Non-degree/certificate-seeking",26,14,12,-2
203845,Marietta College,2013,"All students, Graduate",126,24,102,-2
203960,Mercy College of Ohio,2013,All students total,1195,170,1025,-2
203960,Mercy College of Ohio,2013,"All students, Undergraduate total",1195,170,1025,-2
203960,Mercy College of Ohio,2013,"All students, Undergraduate, Degree/certificate-seeking total",1192,168,1024,-2
203960,Mercy College of Ohio,2013,"All students, Undergraduate, Degree/certificate-seeking, First-time",34,6,28,-2
203960,Mercy College of Ohio,2013,"All students, Undergraduate, Other degree/certificate-seeking",1158,162,996,-2
203960,Mercy College of Ohio,2013,"All students, Undergraduate, Other degree/certifcate-seeking, Transfer-ins",356,54,302,-2
203960,Mercy College of Ohio,2013,"All students, Undergraduate, Other degree/certifcate-seeking, Continuing",802,108,694,-2
203960,Mercy College of Ohio,2013,"All students, Undergraduate, Non-degree/certificate-seeking",3,2,1,-2
203997,Methodist Theological School in Ohio,2013,All students total,193,80,113,-2
203997,Methodist Theological School in Ohio,2013,"All students, Graduate",193,80,113,-2
204006,Miami University-Hamilton,2013,All students total,3621,1615,2006,-2
204006,Miami University-Hamilton,2013,"All students, Undergraduate total",3621,1615,2006,-2
204006,Miami University-Hamilton,2013,"All students, Undergraduate, Degree/certificate-seeking total",3421,1559,1862,-2
204006,Miami University-Hamilton,2013,"All students, Undergraduate, Degree/certificate-seeking, First-time",783,362,421,-2
204006,Miami University-Hamilton,2013,"All students, Undergraduate, Other degree/certificate-seeking",2638,1197,1441,-2
204006,Miami University-Hamilton,2013,"All students, Undergraduate, Other degree/certifcate-seeking, Transfer-ins",220,110,110,-2
204006,Miami University-Hamilton,2013,"All students, Undergraduate, Other degree/certifcate-seeking, Continuing",2418,1087,1331,-2
204006,Miami University-Hamilton,2013,"All students, Undergraduate, Non-degree/certificate-seeking",200,56,144,-2
204015,Miami University-Middletown,2013,All students total,2221,902,1319,-2
204015,Miami University-Middletown,2013,"All students, Undergraduate total",2221,902,1319,-2
204015,Miami University-Middletown,2013,"All students, Undergraduate, Degree/certificate-seeking total",1765,745,1020,-2
204015,Miami University-Middletown,2013,"All students, Undergraduate, Degree/certificate-seeking, First-time",421,186,235,-2
204015,Miami University-Middletown,2013,"All students, Undergraduate, Other degree/certificate-seeking",1344,559,785,-2
204015,Miami University-Middletown,2013,"All students, Undergraduate, Other degree/certifcate-seeking, Transfer-ins",138,71,67,-2
204015,Miami University-Middletown,2013,"All students, Undergraduate, Other degree/certifcate-seeking, Continuing",1206,488,718,-2
204015,Miami University-Middletown,2013,"All students, Undergraduate, Non-degree/certificate-seeking",456,157,299,-2
204024,Miami University-Oxford,2013,All students total,17901,8239,9662,-2
204024,Miami University-Oxford,2013,"All students, Undergraduate total",15462,7470,7992,-2
204024,Miami University-Oxford,2013,"All students, Undergraduate, Degree/certificate-seeking total",15378,7430,7948,-2
204024,Miami University-Oxford,2013,"All students, Undergraduate, Degree/certificate-seeking, First-time",3644,1741,1903,-2
204024,Miami University-Oxford,2013,"All students, Undergraduate, Other degree/certificate-seeking",11734,5689,6045,-2
204024,Miami University-Oxford,2013,"All students, Undergraduate, Other degree/certifcate-seeking, Transfer-ins",254,142,112,-2
204024,Miami University-Oxford,2013,"All students, Undergraduate, Other degree/certifcate-seeking, Continuing",11480,5547,5933,-2
204024,Miami University-Oxford,2013,"All students, Undergraduate, Non-degree/certificate-seeking",84,40,44,-2
204024,Miami University-Oxford,2013,"All students, Graduate",2439,769,1670,-2
204176,Mount Carmel College of Nursing,2013,All students total,1121,106,1015,-2
204176,Mount Carmel College of Nursing,2013,"All students, Undergraduate total",947,96,851,-2
204176,Mount Carmel College of Nursing,2013,"All students, Undergraduate, Degree/certificate-seeking total",947,96,851,-2
204176,Mount Carmel College of Nursing,2013,"All students, Undergraduate, Degree/certificate-seeking, First-time",96,9,87,-2
204176,Mount Carmel College of Nursing,2013,"All students, Undergraduate, Other degree/certificate-seeking",851,87,764,-2
204176,Mount Carmel College of Nursing,2013,"All students, Undergraduate, Other degree/certifcate-seeking, Transfer-ins",146,13,133,-2
204176,Mount Carmel College of Nursing,2013,"All students, Undergraduate, Other degree/certifcate-seeking, Continuing",705,74,631,-2
204176,Mount Carmel College of Nursing,2013,"All students, Graduate",174,10,164,-2
204185,University of Mount Union,2013,All students total,2187,1079,1108,-2
204185,University of Mount Union,2013,"All students, Undergraduate total",2096,1053,1043,-2
204185,University of Mount Union,2013,"All students, Undergraduate, Degree/certificate-seeking total",2056,1030,1026,-2
204185,University of Mount Union,2013,"All students, Undergraduate, Degree/certificate-seeking, First-time",552,283,269,-2
204185,University of Mount Union,2013,"All students, Undergraduate, Other degree/certificate-seeking",1504,747,757,-2
204185,University of Mount Union,2013,"All students, Undergraduate, Other degree/certifcate-seeking, Transfer-ins",90,56,34,-2
204185,University of Mount Union,2013,"All students, Undergraduate, Other degree/certifcate-seeking, Continuing",1414,691,723,-2
204185,University of Mount Union,2013,"All students, Undergraduate, Non-degree/certificate-seeking",40,23,17,-2
204185,University of Mount Union,2013,"All students, Graduate",91,26,65,-2
204194,Mount Vernon Nazarene University,2013,All students total,2229,789,1440,-2
204194,Mount Vernon Nazarene University,2013,"All students, Undergraduate total",1829,650,1179,-2
204194,Mount Vernon Nazarene University,2013,"All students, Undergraduate, Degree/certificate-seeking total",1774,632,1142,-2
204194,Mount Vernon Nazarene University,2013,"All students, Undergraduate, Degree/certificate-seeking, First-time",302,116,186,-2
204194,Mount Vernon Nazarene University,2013,"All students, Undergraduate, Other degree/certificate-seeking",1472,516,956,-2
204194,Mount Vernon Nazarene University,2013,"All students, Undergraduate, Other degree/certifcate-seeking, Transfer-ins",56,28,28,-2
204194,Mount Vernon Nazarene University,2013,"All students, Undergraduate, Other degree/certifcate-seeking, Continuing",1416,488,928,-2
204194,Mount Vernon Nazarene University,2013,"All students, Undergraduate, Non-degree/certificate-seeking",55,18,37,-2
204194,Mount Vernon Nazarene University,2013,"All students, Graduate",400,139,261,-2
204200,College of Mount St Joseph,2013,All students total,2326,798,1528,-2
204200,College of Mount St Joseph,2013,"All students, Undergraduate total",1795,662,1133,-2
204200,College of Mount St Joseph,2013,"All students, Undergraduate, Degree/certificate-seeking total",1655,647,1008,-2
204200,College of Mount St Joseph,2013,"All students, Undergraduate, Degree/certificate-seeking, First-time",324,174,150,-2
204200,College of Mount St Joseph,2013,"All students, Undergraduate, Other degree/certificate-seeking",1331,473,858,-2
204200,College of Mount St Joseph,2013,"All students, Undergraduate, Other degree/certifcate-seeking, Transfer-ins",165,51,114,-2
204200,College of Mount St Joseph,2013,"All students, Undergraduate, Other degree/certifcate-seeking, Continuing",1166,422,744,-2
204200,College of Mount St Joseph,2013,"All students, Undergraduate, Non-degree/certificate-seeking",140,15,125,-2
204200,College of Mount St Joseph,2013,"All students, Graduate",531,136,395,-2
204264,Muskingum University,2013,All students total,2154,874,1280,-2
204264,Muskingum University,2013,"All students, Undergraduate total",1728,775,953,-2
204264,Muskingum University,2013,"All students, Undergraduate, Degree/certificate-seeking total",1641,739,902,-2
204264,Muskingum University,2013,"All students, Undergraduate, Degree/certificate-seeking, First-time",404,200,204,-2
204264,Muskingum University,2013,"All students, Undergraduate, Other degree/certificate-seeking",1237,539,698,-2
204264,Muskingum University,2013,"All students, Undergraduate, Other degree/certifcate-seeking, Transfer-ins",70,31,39,-2
204264,Muskingum University,2013,"All students, Undergraduate, Other degree/certifcate-seeking, Continuing",1167,508,659,-2
204264,Muskingum University,2013,"All students, Undergraduate, Non-degree/certificate-seeking",87,36,51,-2
204264,Muskingum University,2013,"All students, Graduate",426,99,327,-2
204316,Brown Mackie College-North Canton,2013,All students total,563,131,432,-2
204316,Brown Mackie College-North Canton,2013,"All students, Undergraduate total",563,131,432,-2
204316,Brown Mackie College-North Canton,2013,"All students, Undergraduate, Degree/certificate-seeking total",563,131,432,-2
204316,Brown Mackie College-North Canton,2013,"All students, Undergraduate, Degree/certificate-seeking, First-time",148,36,112,-2
204316,Brown Mackie College-North Canton,2013,"All students, Undergraduate, Other degree/certificate-seeking",415,95,320,-2
204316,Brown Mackie College-North Canton,2013,"All students, Undergraduate, Other degree/certifcate-seeking, Transfer-ins",10,3,7,-2
204316,Brown Mackie College-North Canton,2013,"All students, Undergraduate, Other degree/certifcate-seeking, Continuing",405,92,313,-2
204468,Notre Dame College,2013,All students total,2269,951,1318,-2
204468,Notre Dame College,2013,"All students, Undergraduate total",1989,890,1099,-2
204468,Notre Dame College,2013,"All students, Undergraduate, Degree/certificate-seeking total",1792,810,982,-2
204468,Notre Dame College,2013,"All students, Undergraduate, Degree/certificate-seeking, First-time",334,198,136,-2
204468,Notre Dame College,2013,"All students, Undergraduate, Other degree/certificate-seeking",1458,612,846,-2
204468,Notre Dame College,2013,"All students, Undergraduate, Other degree/certifcate-seeking, Transfer-ins",146,44,102,-2
204468,Notre Dame College,2013,"All students, Undergraduate, Other degree/certifcate-seeking, Continuing",1312,568,744,-2
204468,Notre Dame College,2013,"All students, Undergraduate, Non-degree/certificate-seeking",197,80,117,-2
204468,Notre Dame College,2013,"All students, Graduate",280,61,219,-2
204477,Northeast Ohio Medical University,2013,All students total,832,428,404,-2
204477,Northeast Ohio Medical University,2013,"All students, Graduate",832,428,404,-2
204486,University of Northwestern Ohio,2013,All students total,4167,3284,883,-2
204486,University of Northwestern Ohio,2013,"All students, Undergraduate total",4117,3261,856,-2
204486,University of Northwestern Ohio,2013,"All students, Undergraduate, Degree/certificate-seeking total",4104,3255,849,-2
204486,University of Northwestern Ohio,2013,"All students, Undergraduate, Degree/certificate-seeking, First-time",1362,1139,223,-2
204486,University of Northwestern Ohio,2013,"All students, Undergraduate, Other degree/certificate-seeking",2742,2116,626,-2
204486,University of Northwestern Ohio,2013,"All students, Undergraduate, Other degree/certifcate-seeking, Transfer-ins",201,104,97,-2
204486,University of Northwestern Ohio,2013,"All students, Undergraduate, Other degree/certifcate-seeking, Continuing",2541,2012,529,-2
204486,University of Northwestern Ohio,2013,"All students, Undergraduate, Non-degree/certificate-seeking",13,6,7,-2
204486,University of Northwestern Ohio,2013,"All students, Graduate",50,23,27,-2
204501,Oberlin College,2013,All students total,2911,1326,1585,-2
204501,Oberlin College,2013,"All students, Undergraduate total",2894,1316,1578,-2
204501,Oberlin College,2013,"All students, Undergraduate, Degree/certificate-seeking total",2894,1316,1578,-2
204501,Oberlin College,2013,"All students, Undergraduate, Degree/certificate-seeking, First-time",780,337,443,-2
204501,Oberlin College,2013,"All students, Undergraduate, Other degree/certificate-seeking",2114,979,1135,-2
204501,Oberlin College,2013,"All students, Undergraduate, Other degree/certifcate-seeking, Transfer-ins",24,13,11,-2
204501,Oberlin College,2013,"All students, Undergraduate, Other degree/certifcate-seeking, Continuing",2090,966,1124,-2
204501,Oberlin College,2013,"All students, Graduate",17,10,7,-2
204617,Ohio Dominican University,2013,All students total,2573,1028,1545,-2
204617,Ohio Dominican University,2013,"All students, Undergraduate total",2005,851,1154,-2
204617,Ohio Dominican University,2013,"All students, Undergraduate, Degree/certificate-seeking total",1483,639,844,-2
204617,Ohio Dominican University,2013,"All students, Undergraduate, Degree/certificate-seeking, First-time",239,119,120,-2
204617,Ohio Dominican University,2013,"All students, Undergraduate, Other degree/certificate-seeking",1244,520,724,-2
204617,Ohio Dominican University,2013,"All students, Undergraduate, Other degree/certifcate-seeking, Transfer-ins",114,47,67,-2
204617,Ohio Dominican University,2013,"All students, Undergraduate, Other degree/certifcate-seeking, Continuing",1130,473,657,-2
204617,Ohio Dominican University,2013,"All students, Undergraduate, Non-degree/certificate-seeking",522,212,310,-2
204617,Ohio Dominican University,2013,"All students, Graduate",568,177,391,-2
204635,Ohio Northern University,2013,All students total,3619,1780,1839,-2
204635,Ohio Northern University,2013,"All students, Undergraduate total",2702,1396,1306,-2
204635,Ohio Northern University,2013,"All students, Undergraduate, Degree/certificate-seeking total",2205,1153,1052,-2
204635,Ohio Northern University,2013,"All students, Undergraduate, Degree/certificate-seeking, First-time",613,299,314,-2
204635,Ohio Northern University,2013,"All students, Undergraduate, Other degree/certificate-seeking",1592,854,738,-2
204635,Ohio Northern University,2013,"All students, Undergraduate, Other degree/certifcate-seeking, Transfer-ins",73,39,34,-2
204635,Ohio Northern University,2013,"All students, Undergraduate, Other degree/certifcate-seeking, Continuing",1519,815,704,-2
204635,Ohio Northern University,2013,"All students, Undergraduate, Non-degree/certificate-seeking",497,243,254,-2
204635,Ohio Northern University,2013,"All students, Graduate",917,384,533,-2
204671,Ohio State University-Lima Campus,2013,All students total,1077,481,596,-2
204671,Ohio State University-Lima Campus,2013,"All students, Undergraduate total",1059,478,581,-2
204671,Ohio State University-Lima Campus,2013,"All students, Undergraduate, Degree/certificate-seeking total",1008,461,547,-2
204671,Ohio State University-Lima Campus,2013,"All students, Undergraduate, Degree/certificate-seeking, First-time",394,208,186,-2
204671,Ohio State University-Lima Campus,2013,"All students, Undergraduate, Other degree/certificate-seeking",614,253,361,-2
204671,Ohio State University-Lima Campus,2013,"All students, Undergraduate, Other degree/certifcate-seeking, Transfer-ins",65,18,47,-2
204671,Ohio State University-Lima Campus,2013,"All students, Undergraduate, Other degree/certifcate-seeking, Continuing",549,235,314,-2
204671,Ohio State University-Lima Campus,2013,"All students, Undergraduate, Non-degree/certificate-seeking",51,17,34,-2
204671,Ohio State University-Lima Campus,2013,"All students, Graduate",18,3,15,-2
204680,Ohio State University-Mansfield Campus,2013,All students total,1204,521,683,-2
204680,Ohio State University-Mansfield Campus,2013,"All students, Undergraduate total",1155,519,636,-2
204680,Ohio State University-Mansfield Campus,2013,"All students, Undergraduate, Degree/certificate-seeking total",1121,506,615,-2
204680,Ohio State University-Mansfield Campus,2013,"All students, Undergraduate, Degree/certificate-seeking, First-time",503,254,249,-2
204680,Ohio State University-Mansfield Campus,2013,"All students, Undergraduate, Other degree/certificate-seeking",618,252,366,-2
204680,Ohio State University-Mansfield Campus,2013,"All students, Undergraduate, Other degree/certifcate-seeking, Transfer-ins",51,23,28,-2
204680,Ohio State University-Mansfield Campus,2013,"All students, Undergraduate, Other degree/certifcate-seeking, Continuing",567,229,338,-2
204680,Ohio State University-Mansfield Campus,2013,"All students, Undergraduate, Non-degree/certificate-seeking",34,13,21,-2
204680,Ohio State University-Mansfield Campus,2013,"All students, Graduate",49,2,47,-2
204699,Ohio State University-Marion Campus,2013,All students total,1259,569,690,-2
204699,Ohio State University-Marion Campus,2013,"All students, Undergraduate total",1230,565,665,-2
204699,Ohio State University-Marion Campus,2013,"All students, Undergraduate, Degree/certificate-seeking total",1192,553,639,-2
204699,Ohio State University-Marion Campus,2013,"All students, Undergraduate, Degree/certificate-seeking, First-time",447,231,216,-2
204699,Ohio State University-Marion Campus,2013,"All students, Undergraduate, Other degree/certificate-seeking",745,322,423,-2
204699,Ohio State University-Marion Campus,2013,"All students, Undergraduate, Other degree/certifcate-seeking, Transfer-ins",69,27,42,-2
204699,Ohio State University-Marion Campus,2013,"All students, Undergraduate, Other degree/certifcate-seeking, Continuing",676,295,381,-2
204699,Ohio State University-Marion Campus,2013,"All students, Undergraduate, Non-degree/certificate-seeking",38,12,26,-2
204699,Ohio State University-Marion Campus,2013,"All students, Graduate",29,4,25,-2
204705,Ohio State University-Newark Campus,2013,All students total,2315,1097,1218,-2
204705,Ohio State University-Newark Campus,2013,"All students, Undergraduate total",2263,1093,1170,-2
204705,Ohio State University-Newark Campus,2013,"All students, Undergraduate, Degree/certificate-seeking total",2205,1060,1145,-2
204705,Ohio State University-Newark Campus,2013,"All students, Undergraduate, Degree/certificate-seeking, First-time",1092,582,510,-2
204705,Ohio State University-Newark Campus,2013,"All students, Undergraduate, Other degree/certificate-seeking",1113,478,635,-2
204705,Ohio State University-Newark Campus,2013,"All students, Undergraduate, Other degree/certifcate-seeking, Transfer-ins",131,57,74,-2
204705,Ohio State University-Newark Campus,2013,"All students, Undergraduate, Other degree/certifcate-seeking, Continuing",982,421,561,-2
204705,Ohio State University-Newark Campus,2013,"All students, Undergraduate, Non-degree/certificate-seeking",58,33,25,-2
204705,Ohio State University-Newark Campus,2013,"All students, Graduate",52,4,48,-2
204796,Ohio State University-Main Campus,2013,All students total,57466,29421,28045,-2
204796,Ohio State University-Main Campus,2013,"All students, Undergraduate total",44201,23282,20919,-2
204796,Ohio State University-Main Campus,2013,"All students, Undergraduate, Degree/certificate-seeking total",43139,22795,20344,-2
204796,Ohio State University-Main Campus,2013,"All students, Undergraduate, Degree/certificate-seeking, First-time",7130,3594,3536,-2
204796,Ohio State University-Main Campus,2013,"All students, Undergraduate, Other degree/certificate-seeking",36009,19201,16808,-2
204796,Ohio State University-Main Campus,2013,"All students, Undergraduate, Other degree/certifcate-seeking, Transfer-ins",2513,1339,1174,-2
204796,Ohio State University-Main Campus,2013,"All students, Undergraduate, Other degree/certifcate-seeking, Continuing",33496,17862,15634,-2
204796,Ohio State University-Main Campus,2013,"All students, Undergraduate, Non-degree/certificate-seeking",1062,487,575,-2
204796,Ohio State University-Main Campus,2013,"All students, Graduate",13265,6139,7126,-2
204802,Ohio University-Eastern Campus,2013,All students total,1091,444,647,-2
204802,Ohio University-Eastern Campus,2013,"All students, Undergraduate total",1091,444,647,-2
204802,Ohio University-Eastern Campus,2013,"All students, Undergraduate, Degree/certificate-seeking total",1010,413,597,-2
204802,Ohio University-Eastern Campus,2013,"All students, Undergraduate, Degree/certificate-seeking, First-time",121,54,67,-2
204802,Ohio University-Eastern Campus,2013,"All students, Undergraduate, Other degree/certificate-seeking",889,359,530,-2
204802,Ohio University-Eastern Campus,2013,"All students, Undergraduate, Other degree/certifcate-seeking, Transfer-ins",77,27,50,-2
204802,Ohio University-Eastern Campus,2013,"All students, Undergraduate, Other degree/certifcate-seeking, Continuing",812,332,480,-2
204802,Ohio University-Eastern Campus,2013,"All students, Undergraduate, Non-degree/certificate-seeking",81,31,50,-2
204820,Ohio University-Chillicothe Campus,2013,All students total,2330,877,1453,-2
204820,Ohio University-Chillicothe Campus,2013,"All students, Undergraduate total",2330,877,1453,-2
204820,Ohio University-Chillicothe Campus,2013,"All students, Undergraduate, Degree/certificate-seeking total",2219,836,1383,-2
204820,Ohio University-Chillicothe Campus,2013,"All students, Undergraduate, Degree/certificate-seeking, First-time",383,174,209,-2
204820,Ohio University-Chillicothe Campus,2013,"All students, Undergraduate, Other degree/certificate-seeking",1836,662,1174,-2
204820,Ohio University-Chillicothe Campus,2013,"All students, Undergraduate, Other degree/certifcate-seeking, Transfer-ins",143,47,96,-2
204820,Ohio University-Chillicothe Campus,2013,"All students, Undergraduate, Other degree/certifcate-seeking, Continuing",1693,615,1078,-2
204820,Ohio University-Chillicothe Campus,2013,"All students, Undergraduate, Non-degree/certificate-seeking",111,41,70,-2
204839,Ohio University-Southern Campus,2013,All students total,2012,734,1278,-2
204839,Ohio University-Southern Campus,2013,"All students, Undergraduate total",2012,734,1278,-2
204839,Ohio University-Southern Campus,2013,"All students, Undergraduate, Degree/certificate-seeking total",1841,673,1168,-2
204839,Ohio University-Southern Campus,2013,"All students, Undergraduate, Degree/certificate-seeking, First-time",275,99,176,-2
204839,Ohio University-Southern Campus,2013,"All students, Undergraduate, Other degree/certificate-seeking",1566,574,992,-2
204839,Ohio University-Southern Campus,2013,"All students, Undergraduate, Other degree/certifcate-seeking, Transfer-ins",131,47,84,-2
204839,Ohio University-Southern Campus,2013,"All students, Undergraduate, Other degree/certifcate-seeking, Continuing",1435,527,908,-2
204839,Ohio University-Southern Campus,2013,"All students, Undergraduate, Non-degree/certificate-seeking",171,61,110,-2
204848,Ohio University-Lancaster Campus,2013,All students total,2596,910,1686,-2
204848,Ohio University-Lancaster Campus,2013,"All students, Undergraduate total",2596,910,1686,-2
204848,Ohio University-Lancaster Campus,2013,"All students, Undergraduate, Degree/certificate-seeking total",2340,836,1504,-2
204848,Ohio University-Lancaster Campus,2013,"All students, Undergraduate, Degree/certificate-seeking, First-time",465,199,266,-2
204848,Ohio University-Lancaster Campus,2013,"All students, Undergraduate, Other degree/certificate-seeking",1875,637,1238,-2
204848,Ohio University-Lancaster Campus,2013,"All students, Undergraduate, Other degree/certifcate-seeking, Transfer-ins",107,31,76,-2
204848,Ohio University-Lancaster Campus,2013,"All students, Undergraduate, Other degree/certifcate-seeking, Continuing",1768,606,1162,-2
204848,Ohio University-Lancaster Campus,2013,"All students, Undergraduate, Non-degree/certificate-seeking",256,74,182,-2
204857,Ohio University-Main Campus,2013,All students total,28786,11887,16899,-2
204857,Ohio University-Main Campus,2013,"All students, Undergraduate total",23504,9464,14040,-2
204857,Ohio University-Main Campus,2013,"All students, Undergraduate, Degree/certificate-seeking total",23331,9382,13949,-2
204857,Ohio University-Main Campus,2013,"All students, Undergraduate, Degree/certificate-seeking, First-time",4243,2030,2213,-2
204857,Ohio University-Main Campus,2013,"All students, Undergraduate, Other degree/certificate-seeking",19088,7352,11736,-2
204857,Ohio University-Main Campus,2013,"All students, Undergraduate, Other degree/certifcate-seeking, Transfer-ins",1519,459,1060,-2
204857,Ohio University-Main Campus,2013,"All students, Undergraduate, Other degree/certifcate-seeking, Continuing",17569,6893,10676,-2
204857,Ohio University-Main Campus,2013,"All students, Undergraduate, Non-degree/certificate-seeking",173,82,91,-2
204857,Ohio University-Main Campus,2013,"All students, Graduate",5282,2423,2859,-2
204866,Ohio University-Zanesville Campus,2013,All students total,2042,629,1413,-2
204866,Ohio University-Zanesville Campus,2013,"All students, Undergraduate total",2042,629,1413,-2
204866,Ohio University-Zanesville Campus,2013,"All students, Undergraduate, Degree/certificate-seeking total",1899,584,1315,-2
204866,Ohio University-Zanesville Campus,2013,"All students, Undergraduate, Degree/certificate-seeking, First-time",301,108,193,-2
204866,Ohio University-Zanesville Campus,2013,"All students, Undergraduate, Other degree/certificate-seeking",1598,476,1122,-2
204866,Ohio University-Zanesville Campus,2013,"All students, Undergraduate, Other degree/certifcate-seeking, Transfer-ins",131,43,88,-2
204866,Ohio University-Zanesville Campus,2013,"All students, Undergraduate, Other degree/certifcate-seeking, Continuing",1467,433,1034,-2
204866,Ohio University-Zanesville Campus,2013,"All students, Undergraduate, Non-degree/certificate-seeking",143,45,98,-2
204909,Ohio Wesleyan University,2013,All students total,1830,833,997,-2
204909,Ohio Wesleyan University,2013,"All students, Undergraduate total",1830,833,997,-2
204909,Ohio Wesleyan University,2013,"All students, Undergraduate, Degree/certificate-seeking total",1817,830,987,-2
204909,Ohio Wesleyan University,2013,"All students, Undergraduate, Degree/certificate-seeking, First-time",537,249,288,-2
204909,Ohio Wesleyan University,2013,"All students, Undergraduate, Other degree/certificate-seeking",1280,581,699,-2
204909,Ohio Wesleyan University,2013,"All students, Undergraduate, Other degree/certifcate-seeking, Transfer-ins",31,16,15,-2
204909,Ohio Wesleyan University,2013,"All students, Undergraduate, Other degree/certifcate-seeking, Continuing",1249,565,684,-2
204909,Ohio Wesleyan University,2013,"All students, Undergraduate, Non-degree/certificate-seeking",13,3,10,-2
204936,Otterbein University,2013,All students total,2919,1032,1887,-2
204936,Otterbein University,2013,"All students, Undergraduate total",2479,934,1545,-2
204936,Otterbein University,2013,"All students, Undergraduate, Degree/certificate-seeking total",2436,925,1511,-2
204936,Otterbein University,2013,"All students, Undergraduate, Degree/certificate-seeking, First-time",575,212,363,-2
204936,Otterbein University,2013,"All students, Undergraduate, Other degree/certificate-seeking",1861,713,1148,-2
204936,Otterbein University,2013,"All students, Undergraduate, Other degree/certifcate-seeking, Transfer-ins",103,51,52,-2
204936,Otterbein University,2013,"All students, Undergraduate, Other degree/certifcate-seeking, Continuing",1758,662,1096,-2
204936,Otterbein University,2013,"All students, Undergraduate, Non-degree/certificate-seeking",43,9,34,-2
204936,Otterbein University,2013,"All students, Graduate",440,98,342,-2
204990,Payne Theological Seminary,2013,All students total,135,59,76,-2
204990,Payne Theological Seminary,2013,"All students, Graduate",135,59,76,-2
205027,Pontifical College Josephinum,2013,All students total,213,212,1,-2
205027,Pontifical College Josephinum,2013,"All students, Undergraduate total",135,135,0,-2
205027,Pontifical College Josephinum,2013,"All students, Undergraduate, Degree/certificate-seeking total",135,135,0,-2
205027,Pontifical College Josephinum,2013,"All students, Undergraduate, Degree/certificate-seeking, First-time",14,14,0,-2
205027,Pontifical College Josephinum,2013,"All students, Undergraduate, Other degree/certificate-seeking",121,121,0,-2
205027,Pontifical College Josephinum,2013,"All students, Undergraduate, Other degree/certifcate-seeking, Transfer-ins",40,40,0,-2
205027,Pontifical College Josephinum,2013,"All students, Undergraduate, Other degree/certifcate-seeking, Continuing",81,81,0,-2
205027,Pontifical College Josephinum,2013,"All students, Graduate",78,77,1,-2
205124,Rabbinical College Telshe,2013,All students total,96,96,0,-2
205124,Rabbinical College Telshe,2013,"All students, Undergraduate total",56,56,0,-2
205124,Rabbinical College Telshe,2013,"All students, Undergraduate, Degree/certificate-seeking total",56,56,0,-2
205124,Rabbinical College Telshe,2013,"All students, Undergraduate, Degree/certificate-seeking, First-time",13,13,0,-2
205124,Rabbinical College Telshe,2013,"All students, Undergraduate, Other degree/certificate-seeking",43,43,0,-2
205124,Rabbinical College Telshe,2013,"All students, Undergraduate, Other degree/certifcate-seeking, Transfer-ins",2,2,0,-2
205124,Rabbinical College Telshe,2013,"All students, Undergraduate, Other degree/certifcate-seeking, Continuing",41,41,0,-2
205124,Rabbinical College Telshe,2013,"All students, Graduate",40,40,0,-2
205179,Fortis College-Centerville,2013,All students total,2802,444,2358,-2
205179,Fortis College-Centerville,2013,"All students, Undergraduate total",2802,444,2358,-2
205179,Fortis College-Centerville,2013,"All students, Undergraduate, Degree/certificate-seeking total",2802,444,2358,-2
205179,Fortis College-Centerville,2013,"All students, Undergraduate, Degree/certificate-seeking, First-time",777,97,680,-2
205179,Fortis College-Centerville,2013,"All students, Undergraduate, Other degree/certificate-seeking",2025,347,1678,-2
205179,Fortis College-Centerville,2013,"All students, Undergraduate, Other degree/certifcate-seeking, Transfer-ins",9,0,9,-2
205179,Fortis College-Centerville,2013,"All students, Undergraduate, Other degree/certifcate-seeking, Continuing",2016,347,1669,-2
205203,University of Rio Grande,2013,All students total,2314,868,1446,-2
205203,University of Rio Grande,2013,"All students, Undergraduate total",2206,829,1377,-2
205203,University of Rio Grande,2013,"All students, Undergraduate, Degree/certificate-seeking total",1419,521,898,-2
205203,University of Rio Grande,2013,"All students, Undergraduate, Degree/certificate-seeking, First-time",425,172,253,-2
205203,University of Rio Grande,2013,"All students, Undergraduate, Other degree/certificate-seeking",994,349,645,-2
205203,University of Rio Grande,2013,"All students, Undergraduate, Other degree/certifcate-seeking, Transfer-ins",80,34,46,-2
205203,University of Rio Grande,2013,"All students, Undergraduate, Other degree/certifcate-seeking, Continuing",914,315,599,-2
205203,University of Rio Grande,2013,"All students, Undergraduate, Non-degree/certificate-seeking",787,308,479,-2
205203,University of Rio Grande,2013,"All students, Graduate",108,39,69,-2
205443,Shawnee State University,2013,All students total,4341,1797,2544,-2
205443,Shawnee State University,2013,"All students, Undergraduate total",4255,1779,2476,-2
205443,Shawnee State University,2013,"All students, Undergraduate, Degree/certificate-seeking total",4110,1726,2384,-2
205443,Shawnee State University,2013,"All students, Undergraduate, Degree/certificate-seeking, First-time",1104,472,632,-2
205443,Shawnee State University,2013,"All students, Undergraduate, Other degree/certificate-seeking",3006,1254,1752,-2
205443,Shawnee State University,2013,"All students, Undergraduate, Other degree/certifcate-seeking, Transfer-ins",229,103,126,-2
205443,Shawnee State University,2013,"All students, Undergraduate, Other degree/certifcate-seeking, Continuing",2777,1151,1626,-2
205443,Shawnee State University,2013,"All students, Undergraduate, Non-degree/certificate-seeking",145,53,92,-2
205443,Shawnee State University,2013,"All students, Graduate",86,18,68,-2
205610,Brown Mackie College-Cincinnati,2013,All students total,1045,288,757,-2
205610,Brown Mackie College-Cincinnati,2013,"All students, Undergraduate total",1045,288,757,-2
205610,Brown Mackie College-Cincinnati,2013,"All students, Undergraduate, Degree/certificate-seeking total",1045,288,757,-2
205610,Brown Mackie College-Cincinnati,2013,"All students, Undergraduate, Degree/certificate-seeking, First-time",172,52,120,-2
205610,Brown Mackie College-Cincinnati,2013,"All students, Undergraduate, Other degree/certificate-seeking",873,236,637,-2
205610,Brown Mackie College-Cincinnati,2013,"All students, Undergraduate, Other degree/certifcate-seeking, Transfer-ins",141,34,107,-2
205610,Brown Mackie College-Cincinnati,2013,"All students, Undergraduate, Other degree/certifcate-seeking, Continuing",732,202,530,-2
205647,Brown Mackie College-Akron,2013,All students total,694,144,550,-2
205647,Brown Mackie College-Akron,2013,"All students, Undergraduate total",694,144,550,-2
205647,Brown Mackie College-Akron,2013,"All students, Undergraduate, Degree/certificate-seeking total",694,144,550,-2
205647,Brown Mackie College-Akron,2013,"All students, Undergraduate, Degree/certificate-seeking, First-time",87,19,68,-2
205647,Brown Mackie College-Akron,2013,"All students, Undergraduate, Other degree/certificate-seeking",607,125,482,-2
205647,Brown Mackie College-Akron,2013,"All students, Undergraduate, Other degree/certifcate-seeking, Transfer-ins",81,12,69,-2
205647,Brown Mackie College-Akron,2013,"All students, Undergraduate, Other degree/certifcate-seeking, Continuing",526,113,413,-2
205957,Franciscan University of Steubenville,2013,All students total,2733,1054,1679,-2
205957,Franciscan University of Steubenville,2013,"All students, Undergraduate total",2112,805,1307,-2
205957,Franciscan University of Steubenville,2013,"All students, Undergraduate, Degree/certificate-seeking total",2055,782,1273,-2
205957,Franciscan University of Steubenville,2013,"All students, Undergraduate, Degree/certificate-seeking, First-time",460,150,310,-2
205957,Franciscan University of Steubenville,2013,"All students, Undergraduate, Other degree/certificate-seeking",1595,632,963,-2
205957,Franciscan University of Steubenville,2013,"All students, Undergraduate, Other degree/certifcate-seeking, Transfer-ins",147,64,83,-2
205957,Franciscan University of Steubenville,2013,"All students, Undergraduate, Other degree/certifcate-seeking, Continuing",1448,568,880,-2
205957,Franciscan University of Steubenville,2013,"All students, Undergraduate, Non-degree/certificate-seeking",57,23,34,-2
205957,Franciscan University of Steubenville,2013,"All students, Graduate",621,249,372,-2
206002,Ohio Mid-Western College,2013,All students total,140,113,27,-2
206002,Ohio Mid-Western College,2013,"All students, Undergraduate total",140,113,27,-2
206002,Ohio Mid-Western College,2013,"All students, Undergraduate, Degree/certificate-seeking total",139,113,26,-2
206002,Ohio Mid-Western College,2013,"All students, Undergraduate, Degree/certificate-seeking, First-time",70,55,15,-2
206002,Ohio Mid-Western College,2013,"All students, Undergraduate, Other degree/certificate-seeking",69,58,11,-2
206002,Ohio Mid-Western College,2013,"All students, Undergraduate, Other degree/certifcate-seeking, Continuing",69,58,11,-2
206002,Ohio Mid-Western College,2013,"All students, Undergraduate, Non-degree/certificate-seeking",1,0,1,-2
206048,Tiffin University,2013,All students total,4954,2007,2947,-2
206048,Tiffin University,2013,"All students, Undergraduate total",3764,1544,2220,-2
206048,Tiffin University,2013,"All students, Undergraduate, Degree/certificate-seeking total",3309,1351,1958,-2
206048,Tiffin University,2013,"All students, Undergraduate, Degree/certificate-seeking, First-time",487,269,218,-2
206048,Tiffin University,2013,"All students, Undergraduate, Other degree/certificate-seeking",2822,1082,1740,-2
206048,Tiffin University,2013,"All students, Undergraduate, Other degree/certifcate-seeking, Transfer-ins",318,122,196,-2
206048,Tiffin University,2013,"All students, Undergraduate, Other degree/certifcate-seeking, Continuing",2504,960,1544,-2
206048,Tiffin University,2013,"All students, Undergraduate, Non-degree/certificate-seeking",455,193,262,-2
206048,Tiffin University,2013,"All students, Graduate",1190,463,727,-2
206084,University of Toledo,2013,All students total,20743,10322,10421,-2
206084,University of Toledo,2013,"All students, Undergraduate total",16153,8253,7900,-2
206084,University of Toledo,2013,"All students, Undergraduate, Degree/certificate-seeking total",15440,7936,7504,-2
206084,University of Toledo,2013,"All students, Undergraduate, Degree/certificate-seeking, First-time",3362,1654,1708,-2
206084,University of Toledo,2013,"All students, Undergraduate, Other degree/certificate-seeking",12078,6282,5796,-2
206084,University of Toledo,2013,"All students, Undergraduate, Other degree/certifcate-seeking, Transfer-ins",994,502,492,-2
206084,University of Toledo,2013,"All students, Undergraduate, Other degree/certifcate-seeking, Continuing",11084,5780,5304,-2
206084,University of Toledo,2013,"All students, Undergraduate, Non-degree/certificate-seeking",713,317,396,-2
206084,University of Toledo,2013,"All students, Graduate",4590,2069,2521,-2
206154,Tri-State Bible College,2013,All students total,59,35,24,-2
206154,Tri-State Bible College,2013,"All students, Undergraduate total",59,35,24,-2
206154,Tri-State Bible College,2013,"All students, Undergraduate, Degree/certificate-seeking total",59,35,24,-2
206154,Tri-State Bible College,2013,"All students, Undergraduate, Degree/certificate-seeking, First-time",4,3,1,-2
206154,Tri-State Bible College,2013,"All students, Undergraduate, Other degree/certificate-seeking",55,32,23,-2
206154,Tri-State Bible College,2013,"All students, Undergraduate, Other degree/certifcate-seeking, Transfer-ins",7,4,3,-2
206154,Tri-State Bible College,2013,"All students, Undergraduate, Other degree/certifcate-seeking, Continuing",48,28,20,-2
206215,Trinity Lutheran Seminary,2013,All students total,116,70,46,-2
206215,Trinity Lutheran Seminary,2013,"All students, Graduate",116,70,46,-2
206279,Union Institute & University,2013,All students total,1660,681,979,-2
206279,Union Institute & University,2013,"All students, Undergraduate total",1241,562,679,-2
206279,Union Institute & University,2013,"All students, Undergraduate, Degree/certificate-seeking total",1217,551,666,-2
206279,Union Institute & University,2013,"All students, Undergraduate, Degree/certificate-seeking, First-time",18,8,10,-2
206279,Union Institute & University,2013,"All students, Undergraduate, Other degree/certificate-seeking",1199,543,656,-2
206279,Union Institute & University,2013,"All students, Undergraduate, Other degree/certifcate-seeking, Transfer-ins",399,154,245,-2
206279,Union Institute & University,2013,"All students, Undergraduate, Other degree/certifcate-seeking, Continuing",800,389,411,-2
206279,Union Institute & University,2013,"All students, Undergraduate, Non-degree/certificate-seeking",24,11,13,-2
206279,Union Institute & University,2013,"All students, Graduate",419,119,300,-2
206288,United Theological Seminary,2013,All students total,640,364,276,-2
206288,United Theological Seminary,2013,"All students, Graduate",640,364,276,-2
206330,Urbana University,2013,All students total,1748,751,997,-2
206330,Urbana University,2013,"All students, Undergraduate total",1584,695,889,-2
206330,Urbana University,2013,"All students, Undergraduate, Degree/certificate-seeking total",1008,480,528,-2
206330,Urbana University,2013,"All students, Undergraduate, Degree/certificate-seeking, First-time",288,149,139,-2
206330,Urbana University,2013,"All students, Undergraduate, Other degree/certificate-seeking",720,331,389,-2
206330,Urbana University,2013,"All students, Undergraduate, Other degree/certifcate-seeking, Transfer-ins",247,108,139,-2
206330,Urbana University,2013,"All students, Undergraduate, Other degree/certifcate-seeking, Continuing",473,223,250,-2
206330,Urbana University,2013,"All students, Undergraduate, Non-degree/certificate-seeking",576,215,361,-2
206330,Urbana University,2013,"All students, Graduate",164,56,108,-2
206349,Ursuline College,2013,All students total,1357,131,1226,-2
206349,Ursuline College,2013,"All students, Undergraduate total",805,66,739,-2
206349,Ursuline College,2013,"All students, Undergraduate, Degree/certificate-seeking total",798,66,732,-2
206349,Ursuline College,2013,"All students, Undergraduate, Degree/certificate-seeking, First-time",103,3,100,-2
206349,Ursuline College,2013,"All students, Undergraduate, Other degree/certificate-seeking",695,63,632,-2
206349,Ursuline College,2013,"All students, Undergraduate, Other degree/certifcate-seeking, Transfer-ins",104,13,91,-2
206349,Ursuline College,2013,"All students, Undergraduate, Other degree/certifcate-seeking, Continuing",591,50,541,-2
206349,Ursuline College,2013,"All students, Undergraduate, Non-degree/certificate-seeking",7,0,7,-2
206349,Ursuline College,2013,"All students, Graduate",552,65,487,-2
206437,Walsh University,2013,All students total,2963,1090,1873,-2
206437,Walsh University,2013,"All students, Undergraduate total",2385,924,1461,-2
206437,Walsh University,2013,"All students, Undergraduate, Degree/certificate-seeking total",2280,887,1393,-2
206437,Walsh University,2013,"All students, Undergraduate, Degree/certificate-seeking, First-time",493,216,277,-2
206437,Walsh University,2013,"All students, Undergraduate, Other degree/certificate-seeking",1787,671,1116,-2
206437,Walsh University,2013,"All students, Undergraduate, Other degree/certifcate-seeking, Transfer-ins",146,65,81,-2
206437,Walsh University,2013,"All students, Undergraduate, Other degree/certifcate-seeking, Continuing",1641,606,1035,-2
206437,Walsh University,2013,"All students, Undergraduate, Non-degree/certificate-seeking",105,37,68,-2
206437,Walsh University,2013,"All students, Graduate",578,166,412,-2
206491,Wilberforce University,2013,All students total,479,183,296,-2
206491,Wilberforce University,2013,"All students, Undergraduate total",463,179,284,-2
206491,Wilberforce University,2013,"All students, Undergraduate, Degree/certificate-seeking total",463,179,284,-2
206491,Wilberforce University,2013,"All students, Undergraduate, Degree/certificate-seeking, First-time",70,30,40,-2
206491,Wilberforce University,2013,"All students, Undergraduate, Other degree/certificate-seeking",393,149,244,-2
206491,Wilberforce University,2013,"All students, Undergraduate, Other degree/certifcate-seeking, Transfer-ins",16,9,7,-2
206491,Wilberforce University,2013,"All students, Undergraduate, Other degree/certifcate-seeking, Continuing",377,140,237,-2
206491,Wilberforce University,2013,"All students, Graduate",16,4,12,-2
206507,Wilmington College,2013,All students total,1173,549,624,-2
206507,Wilmington College,2013,"All students, Undergraduate total",1169,548,621,-2
206507,Wilmington College,2013,"All students, Undergraduate, Degree/certificate-seeking total",1163,542,621,-2
206507,Wilmington College,2013,"All students, Undergraduate, Degree/certificate-seeking, First-time",272,131,141,-2
206507,Wilmington College,2013,"All students, Undergraduate, Other degree/certificate-seeking",891,411,480,-2
206507,Wilmington College,2013,"All students, Undergraduate, Other degree/certifcate-seeking, Transfer-ins",48,26,22,-2
206507,Wilmington College,2013,"All students, Undergraduate, Other degree/certifcate-seeking, Continuing",843,385,458,-2
206507,Wilmington College,2013,"All students, Undergraduate, Non-degree/certificate-seeking",6,6,0,-2
206507,Wilmington College,2013,"All students, Graduate",4,1,3,-2
206516,Winebrenner Theological Seminary,2013,All students total,60,34,26,-2
206516,Winebrenner Theological Seminary,2013,"All students, Graduate",60,34,26,-2
206525,Wittenberg University,2013,All students total,1979,851,1128,-2
206525,Wittenberg University,2013,"All students, Undergraduate total",1959,851,1108,-2
206525,Wittenberg University,2013,"All students, Undergraduate, Degree/certificate-seeking total",1891,835,1056,-2
206525,Wittenberg University,2013,"All students, Undergraduate, Degree/certificate-seeking, First-time",549,224,325,-2
206525,Wittenberg University,2013,"All students, Undergraduate, Other degree/certificate-seeking",1342,611,731,-2
206525,Wittenberg University,2013,"All students, Undergraduate, Other degree/certifcate-seeking, Transfer-ins",32,18,14,-2
206525,Wittenberg University,2013,"All students, Undergraduate, Other degree/certifcate-seeking, Continuing",1310,593,717,-2
206525,Wittenberg University,2013,"All students, Undergraduate, Non-degree/certificate-seeking",68,16,52,-2
206525,Wittenberg University,2013,"All students, Graduate",20,0,20,-2
206589,The College of Wooster,2013,All students total,2116,937,1179,-2
206589,The College of Wooster,2013,"All students, Undergraduate total",2116,937,1179,-2
206589,The College of Wooster,2013,"All students, Undergraduate, Degree/certificate-seeking total",2070,920,1150,-2
206589,The College of Wooster,2013,"All students, Undergraduate, Degree/certificate-seeking, First-time",560,236,324,-2
206589,The College of Wooster,2013,"All students, Undergraduate, Other degree/certificate-seeking",1510,684,826,-2
206589,The College of Wooster,2013,"All students, Undergraduate, Other degree/certifcate-seeking, Continuing",1510,684,826,-2
206589,The College of Wooster,2013,"All students, Undergraduate, Non-degree/certificate-seeking",46,17,29,-2
206604,Wright State University-Main Campus,2013,All students total,16656,8001,8655,-2
206604,Wright State University-Main Campus,2013,"All students, Undergraduate total",12796,6222,6574,-2
206604,Wright State University-Main Campus,2013,"All students, Undergraduate, Degree/certificate-seeking total",12161,5906,6255,-2
206604,Wright State University-Main Campus,2013,"All students, Undergraduate, Degree/certificate-seeking, First-time",2184,1017,1167,-2
206604,Wright State University-Main Campus,2013,"All students, Undergraduate, Other degree/certificate-seeking",9977,4889,5088,-2
206604,Wright State University-Main Campus,2013,"All students, Undergraduate, Other degree/certifcate-seeking, Transfer-ins",1147,579,568,-2
206604,Wright State University-Main Campus,2013,"All students, Undergraduate, Other degree/certifcate-seeking, Continuing",8830,4310,4520,-2
206604,Wright State University-Main Campus,2013,"All students, Undergraduate, Non-degree/certificate-seeking",635,316,319,-2
206604,Wright State University-Main Campus,2013,"All students, Graduate",3860,1779,2081,-2
206613,Wright State University-Lake Campus,2013,All students total,1133,509,624,-2
206613,Wright State University-Lake Campus,2013,"All students, Undergraduate total",1096,495,601,-2
206613,Wright State University-Lake Campus,2013,"All students, Undergraduate, Degree/certificate-seeking total",926,433,493,-2
206613,Wright State University-Lake Campus,2013,"All students, Undergraduate, Degree/certificate-seeking, First-time",220,119,101,-2
206613,Wright State University-Lake Campus,2013,"All students, Undergraduate, Other degree/certificate-seeking",706,314,392,-2
206613,Wright State University-Lake Campus,2013,"All students, Undergraduate, Other degree/certifcate-seeking, Transfer-ins",70,36,34,-2
206613,Wright State University-Lake Campus,2013,"All students, Undergraduate, Other degree/certifcate-seeking, Continuing",636,278,358,-2
206613,Wright State University-Lake Campus,2013,"All students, Undergraduate, Non-degree/certificate-seeking",170,62,108,-2
206613,Wright State University-Lake Campus,2013,"All students, Graduate",37,14,23,-2
206622,Xavier University,2013,All students total,6633,2908,3725,-2
206622,Xavier University,2013,"All students, Undergraduate total",4620,2125,2495,-2
206622,Xavier University,2013,"All students, Undergraduate, Degree/certificate-seeking total",4452,2036,2416,-2
206622,Xavier University,2013,"All students, Undergraduate, Degree/certificate-seeking, First-time",1289,566,723,-2
206622,Xavier University,2013,"All students, Undergraduate, Other degree/certificate-seeking",3163,1470,1693,-2
206622,Xavier University,2013,"All students, Undergraduate, Other degree/certifcate-seeking, Transfer-ins",120,54,66,-2
206622,Xavier University,2013,"All students, Undergraduate, Other degree/certifcate-seeking, Continuing",3043,1416,1627,-2
206622,Xavier University,2013,"All students, Undergraduate, Non-degree/certificate-seeking",168,89,79,-2
206622,Xavier University,2013,"All students, Graduate",2013,783,1230,-2
206631,ITT Technical Institute-Youngstown,2013,All students total,472,243,229,-2
206631,ITT Technical Institute-Youngstown,2013,"All students, Undergraduate total",472,243,229,-2
206631,ITT Technical Institute-Youngstown,2013,"All students, Undergraduate, Degree/certificate-seeking total",472,243,229,-2
206631,ITT Technical Institute-Youngstown,2013,"All students, Undergraduate, Degree/certificate-seeking, First-time",66,38,28,-2
206631,ITT Technical Institute-Youngstown,2013,"All students, Undergraduate, Other degree/certificate-seeking",406,205,201,-2
206631,ITT Technical Institute-Youngstown,2013,"All students, Undergraduate, Other degree/certifcate-seeking, Transfer-ins",15,5,10,-2
206631,ITT Technical Institute-Youngstown,2013,"All students, Undergraduate, Other degree/certifcate-seeking, Continuing",391,200,191,-2
206695,Youngstown State University,2013,All students total,13352,6166,7186,-2
206695,Youngstown State University,2013,"All students, Undergraduate total",12138,5709,6429,-2
206695,Youngstown State University,2013,"All students, Undergraduate, Degree/certificate-seeking total",11613,5482,6131,-2
206695,Youngstown State University,2013,"All students, Undergraduate, Degree/certificate-seeking, First-time",2090,977,1113,-2
206695,Youngstown State University,2013,"All students, Undergraduate, Other degree/certificate-seeking",9523,4505,5018,-2
206695,Youngstown State University,2013,"All students, Undergraduate, Other degree/certifcate-seeking, Transfer-ins",574,268,306,-2
206695,Youngstown State University,2013,"All students, Undergraduate, Other degree/certifcate-seeking, Continuing",8949,4237,4712,-2
206695,Youngstown State University,2013,"All students, Undergraduate, Non-degree/certificate-seeking",525,227,298,-2
206695,Youngstown State University,2013,"All students, Graduate",1214,457,757,-2
210492,Bryn Athyn College of the New Church,2013,All students total,278,135,143,-2
210492,Bryn Athyn College of the New Church,2013,"All students, Undergraduate total",270,130,140,-2
210492,Bryn Athyn College of the New Church,2013,"All students, Undergraduate, Degree/certificate-seeking total",269,129,140,-2
210492,Bryn Athyn College of the New Church,2013,"All students, Undergraduate, Degree/certificate-seeking, First-time",81,42,39,-2
210492,Bryn Athyn College of the New Church,2013,"All students, Undergraduate, Other degree/certificate-seeking",188,87,101,-2
210492,Bryn Athyn College of the New Church,2013,"All students, Undergraduate, Other degree/certifcate-seeking, Transfer-ins",13,7,6,-2
210492,Bryn Athyn College of the New Church,2013,"All students, Undergraduate, Other degree/certifcate-seeking, Continuing",175,80,95,-2
210492,Bryn Athyn College of the New Church,2013,"All students, Undergraduate, Non-degree/certificate-seeking",1,1,0,-2
210492,Bryn Athyn College of the New Church,2013,"All students, Graduate",8,5,3,-2
210508,Academy of Vocal Arts,2013,All students total,29,17,12,-2
210508,Academy of Vocal Arts,2013,"All students, Graduate",29,17,12,-2
210571,Albright College,2013,All students total,2384,996,1388,-2
210571,Albright College,2013,"All students, Undergraduate total",2349,986,1363,-2
210571,Albright College,2013,"All students, Undergraduate, Degree/certificate-seeking total",2333,982,1351,-2
210571,Albright College,2013,"All students, Undergraduate, Degree/certificate-seeking, First-time",655,270,385,-2
210571,Albright College,2013,"All students, Undergraduate, Other degree/certificate-seeking",1678,712,966,-2
210571,Albright College,2013,"All students, Undergraduate, Other degree/certifcate-seeking, Transfer-ins",107,41,66,-2
210571,Albright College,2013,"All students, Undergraduate, Other degree/certifcate-seeking, Continuing",1571,671,900,-2
210571,Albright College,2013,"All students, Undergraduate, Non-degree/certificate-seeking",16,4,12,-2
210571,Albright College,2013,"All students, Graduate",35,10,25,-2
210669,Allegheny College,2013,All students total,2161,986,1175,-2
210669,Allegheny College,2013,"All students, Undergraduate total",2161,986,1175,-2
210669,Allegheny College,2013,"All students, Undergraduate, Degree/certificate-seeking total",2126,978,1148,-2
210669,Allegheny College,2013,"All students, Undergraduate, Degree/certificate-seeking, First-time",604,293,311,-2
210669,Allegheny College,2013,"All students, Undergraduate, Other degree/certificate-seeking",1522,685,837,-2
210669,Allegheny College,2013,"All students, Undergraduate, Other degree/certifcate-seeking, Transfer-ins",22,13,9,-2
210669,Allegheny College,2013,"All students, Undergraduate, Other degree/certifcate-seeking, Continuing",1500,672,828,-2
210669,Allegheny College,2013,"All students, Undergraduate, Non-degree/certificate-seeking",35,8,27,-2
210739,DeSales University,2013,All students total,3266,1268,1998,-2
210739,DeSales University,2013,"All students, Undergraduate total",2482,948,1534,-2
210739,DeSales University,2013,"All students, Undergraduate, Degree/certificate-seeking total",2482,948,1534,-2
210739,DeSales University,2013,"All students, Undergraduate, Degree/certificate-seeking, First-time",413,186,227,-2
210739,DeSales University,2013,"All students, Undergraduate, Other degree/certificate-seeking",2069,762,1307,-2
210739,DeSales University,2013,"All students, Undergraduate, Other degree/certifcate-seeking, Transfer-ins",77,29,48,-2
210739,DeSales University,2013,"All students, Undergraduate, Other degree/certifcate-seeking, Continuing",1992,733,1259,-2
210739,DeSales University,2013,"All students, Graduate",784,320,464,-2
210775,Alvernia University,2013,All students total,2871,841,2030,-2
210775,Alvernia University,2013,"All students, Undergraduate total",2371,657,1714,-2
210775,Alvernia University,2013,"All students, Undergraduate, Degree/certificate-seeking total",2169,630,1539,-2
210775,Alvernia University,2013,"All students, Undergraduate, Degree/certificate-seeking, First-time",389,111,278,-2
210775,Alvernia University,2013,"All students, Undergraduate, Other degree/certificate-seeking",1780,519,1261,-2
210775,Alvernia University,2013,"All students, Undergraduate, Other degree/certifcate-seeking, Transfer-ins",105,38,67,-2
210775,Alvernia University,2013,"All students, Undergraduate, Other degree/certifcate-seeking, Continuing",1675,481,1194,-2
210775,Alvernia University,2013,"All students, Undergraduate, Non-degree/certificate-seeking",202,27,175,-2
210775,Alvernia University,2013,"All students, Graduate",500,184,316,-2
210809,American College of Financial Services,2013,All students total,27749,19513,8236,-2
210809,American College of Financial Services,2013,"All students, Undergraduate total",26837,18854,7983,-2
210809,American College of Financial Services,2013,"All students, Undergraduate, Degree/certificate-seeking total",26837,18854,7983,-2
210809,American College of Financial Services,2013,"All students, Undergraduate, Other degree/certificate-seeking",26837,18854,7983,-2
210809,American College of Financial Services,2013,"All students, Undergraduate, Other degree/certifcate-seeking, Continuing",26837,18854,7983,-2
210809,American College of Financial Services,2013,"All students, Graduate",912,659,253,-2
210906,The Art Institutes of York-PA,2013,All students total,462,216,246,-2
210906,The Art Institutes of York-PA,2013,"All students, Undergraduate total",462,216,246,-2
210906,The Art Institutes of York-PA,2013,"All students, Undergraduate, Degree/certificate-seeking total",462,216,246,-2
210906,The Art Institutes of York-PA,2013,"All students, Undergraduate, Degree/certificate-seeking, First-time",115,56,59,-2
210906,The Art Institutes of York-PA,2013,"All students, Undergraduate, Other degree/certificate-seeking",347,160,187,-2
210906,The Art Institutes of York-PA,2013,"All students, Undergraduate, Other degree/certifcate-seeking, Transfer-ins",25,13,12,-2
210906,The Art Institutes of York-PA,2013,"All students, Undergraduate, Other degree/certifcate-seeking, Continuing",322,147,175,-2
210942,The Art Institute of Philadelphia,2013,All students total,2494,1206,1288,-2
210942,The Art Institute of Philadelphia,2013,"All students, Undergraduate total",2494,1206,1288,-2
210942,The Art Institute of Philadelphia,2013,"All students, Undergraduate, Degree/certificate-seeking total",2494,1206,1288,-2
210942,The Art Institute of Philadelphia,2013,"All students, Undergraduate, Degree/certificate-seeking, First-time",642,329,313,-2
210942,The Art Institute of Philadelphia,2013,"All students, Undergraduate, Other degree/certificate-seeking",1852,877,975,-2
210942,The Art Institute of Philadelphia,2013,"All students, Undergraduate, Other degree/certifcate-seeking, Transfer-ins",145,67,78,-2
210942,The Art Institute of Philadelphia,2013,"All students, Undergraduate, Other degree/certifcate-seeking, Continuing",1707,810,897,-2
210960,The Art Institute of Pittsburgh,2013,All students total,1544,769,775,-2
210960,The Art Institute of Pittsburgh,2013,"All students, Undergraduate total",1544,769,775,-2
210960,The Art Institute of Pittsburgh,2013,"All students, Undergraduate, Degree/certificate-seeking total",1544,769,775,-2
210960,The Art Institute of Pittsburgh,2013,"All students, Undergraduate, Degree/certificate-seeking, First-time",373,194,179,-2
210960,The Art Institute of Pittsburgh,2013,"All students, Undergraduate, Other degree/certificate-seeking",1171,575,596,-2
210960,The Art Institute of Pittsburgh,2013,"All students, Undergraduate, Other degree/certifcate-seeking, Transfer-ins",140,57,83,-2
210960,The Art Institute of Pittsburgh,2013,"All students, Undergraduate, Other degree/certifcate-seeking, Continuing",1031,518,513,-2
211024,Baptist Bible College & Seminary of Pennsylvania,2013,All students total,918,543,375,-2
211024,Baptist Bible College & Seminary of Pennsylvania,2013,"All students, Undergraduate total",624,323,301,-2
211024,Baptist Bible College & Seminary of Pennsylvania,2013,"All students, Undergraduate, Degree/certificate-seeking total",606,309,297,-2
211024,Baptist Bible College & Seminary of Pennsylvania,2013,"All students, Undergraduate, Degree/certificate-seeking, First-time",106,46,60,-2
211024,Baptist Bible College & Seminary of Pennsylvania,2013,"All students, Undergraduate, Other degree/certificate-seeking",500,263,237,-2
211024,Baptist Bible College & Seminary of Pennsylvania,2013,"All students, Undergraduate, Other degree/certifcate-seeking, Transfer-ins",50,29,21,-2
211024,Baptist Bible College & Seminary of Pennsylvania,2013,"All students, Undergraduate, Other degree/certifcate-seeking, Continuing",450,234,216,-2
211024,Baptist Bible College & Seminary of Pennsylvania,2013,"All students, Undergraduate, Non-degree/certificate-seeking",18,14,4,-2
211024,Baptist Bible College & Seminary of Pennsylvania,2013,"All students, Graduate",294,220,74,-2
211088,Arcadia University,2013,All students total,3905,1148,2757,-2
211088,Arcadia University,2013,"All students, Undergraduate total",2453,792,1661,-2
211088,Arcadia University,2013,"All students, Undergraduate, Degree/certificate-seeking total",2400,765,1635,-2
211088,Arcadia University,2013,"All students, Undergraduate, Degree/certificate-seeking, First-time",597,178,419,-2
211088,Arcadia University,2013,"All students, Undergraduate, Other degree/certificate-seeking",1803,587,1216,-2
211088,Arcadia University,2013,"All students, Undergraduate, Other degree/certifcate-seeking, Transfer-ins",116,43,73,-2
211088,Arcadia University,2013,"All students, Undergraduate, Other degree/certifcate-seeking, Continuing",1687,544,1143,-2
211088,Arcadia University,2013,"All students, Undergraduate, Non-degree/certificate-seeking",53,27,26,-2
211088,Arcadia University,2013,"All students, Graduate",1452,356,1096,-2
211130,Biblical Theological Seminary,2013,All students total,294,195,99,-2
211130,Biblical Theological Seminary,2013,"All students, Graduate",294,195,99,-2
211158,Bloomsburg University of Pennsylvania,2013,All students total,10127,4294,5833,-2
211158,Bloomsburg University of Pennsylvania,2013,"All students, Undergraduate total",9416,4098,5318,-2
211158,Bloomsburg University of Pennsylvania,2013,"All students, Undergraduate, Degree/certificate-seeking total",9245,4025,5220,-2
211158,Bloomsburg University of Pennsylvania,2013,"All students, Undergraduate, Degree/certificate-seeking, First-time",2218,923,1295,-2
211158,Bloomsburg University of Pennsylvania,2013,"All students, Undergraduate, Other degree/certificate-seeking",7027,3102,3925,-2
211158,Bloomsburg University of Pennsylvania,2013,"All students, Undergraduate, Other degree/certifcate-seeking, Transfer-ins",469,233,236,-2
211158,Bloomsburg University of Pennsylvania,2013,"All students, Undergraduate, Other degree/certifcate-seeking, Continuing",6558,2869,3689,-2
211158,Bloomsburg University of Pennsylvania,2013,"All students, Undergraduate, Non-degree/certificate-seeking",171,73,98,-2
211158,Bloomsburg University of Pennsylvania,2013,"All students, Graduate",711,196,515,-2
211273,Bryn Mawr College,2013,All students total,1738,83,1655,-2
211273,Bryn Mawr College,2013,"All students, Undergraduate total",1328,0,1328,-2
211273,Bryn Mawr College,2013,"All students, Undergraduate, Degree/certificate-seeking total",1316,0,1316,-2
211273,Bryn Mawr College,2013,"All students, Undergraduate, Degree/certificate-seeking, First-time",365,0,365,-2
211273,Bryn Mawr College,2013,"All students, Undergraduate, Other degree/certificate-seeking",951,0,951,-2
211273,Bryn Mawr College,2013,"All students, Undergraduate, Other degree/certifcate-seeking, Transfer-ins",12,0,12,-2
211273,Bryn Mawr College,2013,"All students, Undergraduate, Other degree/certifcate-seeking, Continuing",939,0,939,-2
211273,Bryn Mawr College,2013,"All students, Undergraduate, Non-degree/certificate-seeking",12,0,12,-2
211273,Bryn Mawr College,2013,"All students, Graduate",410,83,327,-2
211291,Bucknell University,2013,All students total,3608,1723,1885,-2
211291,Bucknell University,2013,"All students, Undergraduate total",3532,1687,1845,-2
211291,Bucknell University,2013,"All students, Undergraduate, Degree/certificate-seeking total",3498,1668,1830,-2
211291,Bucknell University,2013,"All students, Undergraduate, Degree/certificate-seeking, First-time",933,449,484,-2
211291,Bucknell University,2013,"All students, Undergraduate, Other degree/certificate-seeking",2565,1219,1346,-2
211291,Bucknell University,2013,"All students, Undergraduate, Other degree/certifcate-seeking, Transfer-ins",28,12,16,-2
211291,Bucknell University,2013,"All students, Undergraduate, Other degree/certifcate-seeking, Continuing",2537,1207,1330,-2
211291,Bucknell University,2013,"All students, Undergraduate, Non-degree/certificate-seeking",34,19,15,-2
211291,Bucknell University,2013,"All students, Graduate",76,36,40,-2
211352,Cabrini College,2013,All students total,2448,753,1695,-2
211352,Cabrini College,2013,"All students, Undergraduate total",1337,487,850,-2
211352,Cabrini College,2013,"All students, Undergraduate, Degree/certificate-seeking total",1286,466,820,-2
211352,Cabrini College,2013,"All students, Undergraduate, Degree/certificate-seeking, First-time",304,103,201,-2
211352,Cabrini College,2013,"All students, Undergraduate, Other degree/certificate-seeking",982,363,619,-2
211352,Cabrini College,2013,"All students, Undergraduate, Other degree/certifcate-seeking, Transfer-ins",72,35,37,-2
211352,Cabrini College,2013,"All students, Undergraduate, Other degree/certifcate-seeking, Continuing",910,328,582,-2
211352,Cabrini College,2013,"All students, Undergraduate, Non-degree/certificate-seeking",51,21,30,-2
211352,Cabrini College,2013,"All students, Graduate",1111,266,845,-2
211361,California University of Pennsylvania,2013,All students total,8243,3806,4437,-2
211361,California University of Pennsylvania,2013,"All students, Undergraduate total",6450,3122,3328,-2
211361,California University of Pennsylvania,2013,"All students, Undergraduate, Degree/certificate-seeking total",6393,3089,3304,-2
211361,California University of Pennsylvania,2013,"All students, Undergraduate, Degree/certificate-seeking, First-time",1173,562,611,-2
211361,California University of Pennsylvania,2013,"All students, Undergraduate, Other degree/certificate-seeking",5220,2527,2693,-2
211361,California University of Pennsylvania,2013,"All students, Undergraduate, Other degree/certifcate-seeking, Transfer-ins",646,281,365,-2
211361,California University of Pennsylvania,2013,"All students, Undergraduate, Other degree/certifcate-seeking, Continuing",4574,2246,2328,-2
211361,California University of Pennsylvania,2013,"All students, Undergraduate, Non-degree/certificate-seeking",57,33,24,-2
211361,California University of Pennsylvania,2013,"All students, Graduate",1793,684,1109,-2
211370,Calvary Baptist Theological Seminary,2013,All students total,62,60,2,-2
211370,Calvary Baptist Theological Seminary,2013,"All students, Graduate",62,60,2,-2
211431,Carlow University,2013,All students total,3012,501,2511,-2
211431,Carlow University,2013,"All students, Undergraduate total",2100,374,1726,-2
211431,Carlow University,2013,"All students, Undergraduate, Degree/certificate-seeking total",1496,142,1354,-2
211431,Carlow University,2013,"All students, Undergraduate, Degree/certificate-seeking, First-time",205,14,191,-2
211431,Carlow University,2013,"All students, Undergraduate, Other degree/certificate-seeking",1291,128,1163,-2
211431,Carlow University,2013,"All students, Undergraduate, Other degree/certifcate-seeking, Transfer-ins",197,23,174,-2
211431,Carlow University,2013,"All students, Undergraduate, Other degree/certifcate-seeking, Continuing",1094,105,989,-2
211431,Carlow University,2013,"All students, Undergraduate, Non-degree/certificate-seeking",604,232,372,-2
211431,Carlow University,2013,"All students, Graduate",912,127,785,-2
211440,Carnegie Mellon University,2013,All students total,12367,7740,4627,-2
211440,Carnegie Mellon University,2013,"All students, Undergraduate total",5917,3420,2497,-2
211440,Carnegie Mellon University,2013,"All students, Undergraduate, Degree/certificate-seeking total",5834,3365,2469,-2
211440,Carnegie Mellon University,2013,"All students, Undergraduate, Degree/certificate-seeking, First-time",1442,800,642,-2
211440,Carnegie Mellon University,2013,"All students, Undergraduate, Other degree/certificate-seeking",4392,2565,1827,-2
211440,Carnegie Mellon University,2013,"All students, Undergraduate, Other degree/certifcate-seeking, Transfer-ins",66,43,23,-2
211440,Carnegie Mellon University,2013,"All students, Undergraduate, Other degree/certifcate-seeking, Continuing",4326,2522,1804,-2
211440,Carnegie Mellon University,2013,"All students, Undergraduate, Non-degree/certificate-seeking",83,55,28,-2
211440,Carnegie Mellon University,2013,"All students, Graduate",6450,4320,2130,-2
211468,Cedar Crest College,2013,All students total,1486,109,1377,-2
211468,Cedar Crest College,2013,"All students, Undergraduate total",1286,90,1196,-2
211468,Cedar Crest College,2013,"All students, Undergraduate, Degree/certificate-seeking total",1252,84,1168,-2
211468,Cedar Crest College,2013,"All students, Undergraduate, Degree/certificate-seeking, First-time",141,1,140,-2
211468,Cedar Crest College,2013,"All students, Undergraduate, Other degree/certificate-seeking",1111,83,1028,-2
211468,Cedar Crest College,2013,"All students, Undergraduate, Other degree/certifcate-seeking, Transfer-ins",220,29,191,-2
211468,Cedar Crest College,2013,"All students, Undergraduate, Other degree/certifcate-seeking, Continuing",891,54,837,-2
211468,Cedar Crest College,2013,"All students, Undergraduate, Non-degree/certificate-seeking",34,6,28,-2
211468,Cedar Crest College,2013,"All students, Graduate",200,19,181,-2
211477,Central Penn College,2013,All students total,1297,456,841,-2
211477,Central Penn College,2013,"All students, Undergraduate total",1277,452,825,-2
211477,Central Penn College,2013,"All students, Undergraduate, Degree/certificate-seeking total",1277,452,825,-2
211477,Central Penn College,2013,"All students, Undergraduate, Degree/certificate-seeking, First-time",127,57,70,-2
211477,Central Penn College,2013,"All students, Undergraduate, Other degree/certificate-seeking",1150,395,755,-2
211477,Central Penn College,2013,"All students, Undergraduate, Other degree/certifcate-seeking, Continuing",1150,395,755,-2
211477,Central Penn College,2013,"All students, Graduate",20,4,16,-2
211556,Chatham University,2013,All students total,2170,331,1839,-2
211556,Chatham University,2013,"All students, Undergraduate total",973,88,885,-2
211556,Chatham University,2013,"All students, Undergraduate, Degree/certificate-seeking total",616,11,605,-2
211556,Chatham University,2013,"All students, Undergraduate, Degree/certificate-seeking, First-time",92,0,92,-2
211556,Chatham University,2013,"All students, Undergraduate, Other degree/certificate-seeking",524,11,513,-2
211556,Chatham University,2013,"All students, Undergraduate, Other degree/certifcate-seeking, Transfer-ins",64,0,64,-2
211556,Chatham University,2013,"All students, Undergraduate, Other degree/certifcate-seeking, Continuing",460,11,449,-2
211556,Chatham University,2013,"All students, Undergraduate, Non-degree/certificate-seeking",357,77,280,-2
211556,Chatham University,2013,"All students, Graduate",1197,243,954,-2
211583,Chestnut Hill College,2013,All students total,2189,635,1554,-2
211583,Chestnut Hill College,2013,"All students, Undergraduate total",1517,491,1026,-2
211583,Chestnut Hill College,2013,"All students, Undergraduate, Degree/certificate-seeking total",1510,489,1021,-2
211583,Chestnut Hill College,2013,"All students, Undergraduate, Degree/certificate-seeking, First-time",190,78,112,-2
211583,Chestnut Hill College,2013,"All students, Undergraduate, Other degree/certificate-seeking",1320,411,909,-2
211583,Chestnut Hill College,2013,"All students, Undergraduate, Other degree/certifcate-seeking, Transfer-ins",234,63,171,-2
211583,Chestnut Hill College,2013,"All students, Undergraduate, Other degree/certifcate-seeking, Continuing",1086,348,738,-2
211583,Chestnut Hill College,2013,"All students, Undergraduate, Non-degree/certificate-seeking",7,2,5,-2
211583,Chestnut Hill College,2013,"All students, Graduate",672,144,528,-2
211608,Cheyney University of Pennsylvania,2013,All students total,1212,584,628,-2
211608,Cheyney University of Pennsylvania,2013,"All students, Undergraduate total",1179,570,609,-2
211608,Cheyney University of Pennsylvania,2013,"All students, Undergraduate, Degree/certificate-seeking total",1178,569,609,-2
211608,Cheyney University of Pennsylvania,2013,"All students, Undergraduate, Degree/certificate-seeking, First-time",346,174,172,-2
211608,Cheyney University of Pennsylvania,2013,"All students, Undergraduate, Other degree/certificate-seeking",832,395,437,-2
211608,Cheyney University of Pennsylvania,2013,"All students, Undergraduate, Other degree/certifcate-seeking, Transfer-ins",63,32,31,-2
211608,Cheyney University of Pennsylvania,2013,"All students, Undergraduate, Other degree/certifcate-seeking, Continuing",769,363,406,-2
211608,Cheyney University of Pennsylvania,2013,"All students, Undergraduate, Non-degree/certificate-seeking",1,1,0,-2
211608,Cheyney University of Pennsylvania,2013,"All students, Graduate",33,14,19,-2
211644,Clarion University of Pennsylvania,2013,All students total,6080,2128,3952,-2
211644,Clarion University of Pennsylvania,2013,"All students, Undergraduate total",5199,1934,3265,-2
211644,Clarion University of Pennsylvania,2013,"All students, Undergraduate, Degree/certificate-seeking total",5046,1897,3149,-2
211644,Clarion University of Pennsylvania,2013,"All students, Undergraduate, Degree/certificate-seeking, First-time",996,392,604,-2
211644,Clarion University of Pennsylvania,2013,"All students, Undergraduate, Other degree/certificate-seeking",4050,1505,2545,-2
211644,Clarion University of Pennsylvania,2013,"All students, Undergraduate, Other degree/certifcate-seeking, Transfer-ins",475,187,288,-2
211644,Clarion University of Pennsylvania,2013,"All students, Undergraduate, Other degree/certifcate-seeking, Continuing",3575,1318,2257,-2
211644,Clarion University of Pennsylvania,2013,"All students, Undergraduate, Non-degree/certificate-seeking",153,37,116,-2
211644,Clarion University of Pennsylvania,2013,"All students, Graduate",881,194,687,-2
211893,Curtis Institute of Music,2013,All students total,168,93,75,-2
211893,Curtis Institute of Music,2013,"All students, Undergraduate total",122,65,57,-2
211893,Curtis Institute of Music,2013,"All students, Undergraduate, Degree/certificate-seeking total",122,65,57,-2
211893,Curtis Institute of Music,2013,"All students, Undergraduate, Degree/certificate-seeking, First-time",29,14,15,-2
211893,Curtis Institute of Music,2013,"All students, Undergraduate, Other degree/certificate-seeking",93,51,42,-2
211893,Curtis Institute of Music,2013,"All students, Undergraduate, Other degree/certifcate-seeking, Transfer-ins",5,2,3,-2
211893,Curtis Institute of Music,2013,"All students, Undergraduate, Other degree/certifcate-seeking, Continuing",88,49,39,-2
211893,Curtis Institute of Music,2013,"All students, Graduate",46,28,18,-2
211981,Delaware Valley College,2013,All students total,2023,750,1273,-2
211981,Delaware Valley College,2013,"All students, Undergraduate total",1807,661,1146,-2
211981,Delaware Valley College,2013,"All students, Undergraduate, Degree/certificate-seeking total",1774,640,1134,-2
211981,Delaware Valley College,2013,"All students, Undergraduate, Degree/certificate-seeking, First-time",416,140,276,-2
211981,Delaware Valley College,2013,"All students, Undergraduate, Other degree/certificate-seeking",1358,500,858,-2
211981,Delaware Valley College,2013,"All students, Undergraduate, Other degree/certifcate-seeking, Transfer-ins",96,46,50,-2
211981,Delaware Valley College,2013,"All students, Undergraduate, Other degree/certifcate-seeking, Continuing",1262,454,808,-2
211981,Delaware Valley College,2013,"All students, Undergraduate, Non-degree/certificate-seeking",33,21,12,-2
211981,Delaware Valley College,2013,"All students, Graduate",216,89,127,-2
212009,Dickinson College,2013,All students total,2396,1054,1342,-2
212009,Dickinson College,2013,"All students, Undergraduate total",2396,1054,1342,-2
212009,Dickinson College,2013,"All students, Undergraduate, Degree/certificate-seeking total",2352,1037,1315,-2
212009,Dickinson College,2013,"All students, Undergraduate, Degree/certificate-seeking, First-time",626,270,356,-2
212009,Dickinson College,2013,"All students, Undergraduate, Other degree/certificate-seeking",1726,767,959,-2
212009,Dickinson College,2013,"All students, Undergraduate, Other degree/certifcate-seeking, Transfer-ins",16,5,11,-2
212009,Dickinson College,2013,"All students, Undergraduate, Other degree/certifcate-seeking, Continuing",1710,762,948,-2
212009,Dickinson College,2013,"All students, Undergraduate, Non-degree/certificate-seeking",44,17,27,-2
212018,The Dickinson School of Law of the Pennsylvania State University,2013,All students total,142,75,67,-2
212018,The Dickinson School of Law of the Pennsylvania State University,2013,"All students, Graduate",142,75,67,-2
212054,Drexel University,2013,All students total,26132,12625,13507,-2
212054,Drexel University,2013,"All students, Undergraduate total",16616,8863,7753,-2
212054,Drexel University,2013,"All students, Undergraduate, Degree/certificate-seeking total",16257,8697,7560,-2
212054,Drexel University,2013,"All students, Undergraduate, Degree/certificate-seeking, First-time",3039,1760,1279,-2
212054,Drexel University,2013,"All students, Undergraduate, Other degree/certificate-seeking",13218,6937,6281,-2
212054,Drexel University,2013,"All students, Undergraduate, Other degree/certifcate-seeking, Transfer-ins",1498,599,899,-2
212054,Drexel University,2013,"All students, Undergraduate, Other degree/certifcate-seeking, Continuing",11720,6338,5382,-2
212054,Drexel University,2013,"All students, Undergraduate, Non-degree/certificate-seeking",359,166,193,-2
212054,Drexel University,2013,"All students, Graduate",9516,3762,5754,-2
212106,Duquesne University,2013,All students total,9904,4058,5846,-2
212106,Duquesne University,2013,"All students, Undergraduate total",5970,2466,3504,-2
212106,Duquesne University,2013,"All students, Undergraduate, Degree/certificate-seeking total",5944,2450,3494,-2
212106,Duquesne University,2013,"All students, Undergraduate, Degree/certificate-seeking, First-time",1547,573,974,-2
212106,Duquesne University,2013,"All students, Undergraduate, Other degree/certificate-seeking",4397,1877,2520,-2
212106,Duquesne University,2013,"All students, Undergraduate, Other degree/certifcate-seeking, Transfer-ins",148,79,69,-2
212106,Duquesne University,2013,"All students, Undergraduate, Other degree/certifcate-seeking, Continuing",4249,1798,2451,-2
212106,Duquesne University,2013,"All students, Undergraduate, Non-degree/certificate-seeking",26,16,10,-2
212106,Duquesne University,2013,"All students, Graduate",3934,1592,2342,-2
212115,East Stroudsburg University of Pennsylvania,2013,All students total,6778,2986,3792,-2
212115,East Stroudsburg University of Pennsylvania,2013,"All students, Undergraduate total",6186,2762,3424,-2
212115,East Stroudsburg University of Pennsylvania,2013,"All students, Undergraduate, Degree/certificate-seeking total",6109,2732,3377,-2
212115,East Stroudsburg University of Pennsylvania,2013,"All students, Undergraduate, Degree/certificate-seeking, First-time",1212,554,658,-2
212115,East Stroudsburg University of Pennsylvania,2013,"All students, Undergraduate, Other degree/certificate-seeking",4897,2178,2719,-2
212115,East Stroudsburg University of Pennsylvania,2013,"All students, Undergraduate, Other degree/certifcate-seeking, Transfer-ins",646,287,359,-2
212115,East Stroudsburg University of Pennsylvania,2013,"All students, Undergraduate, Other degree/certifcate-seeking, Continuing",4251,1891,2360,-2
212115,East Stroudsburg University of Pennsylvania,2013,"All students, Undergraduate, Non-degree/certificate-seeking",77,30,47,-2
212115,East Stroudsburg University of Pennsylvania,2013,"All students, Graduate",592,224,368,-2
212133,Eastern University,2013,All students total,4004,1273,2731,-2
212133,Eastern University,2013,"All students, Undergraduate total",2541,758,1783,-2
212133,Eastern University,2013,"All students, Undergraduate, Degree/certificate-seeking total",2458,729,1729,-2
212133,Eastern University,2013,"All students, Undergraduate, Degree/certificate-seeking, First-time",450,136,314,-2
212133,Eastern University,2013,"All students, Undergraduate, Other degree/certificate-seeking",2008,593,1415,-2
212133,Eastern University,2013,"All students, Undergraduate, Other degree/certifcate-seeking, Transfer-ins",271,62,209,-2
212133,Eastern University,2013,"All students, Undergraduate, Other degree/certifcate-seeking, Continuing",1737,531,1206,-2
212133,Eastern University,2013,"All students, Undergraduate, Non-degree/certificate-seeking",83,29,54,-2
212133,Eastern University,2013,"All students, Graduate",1463,515,948,-2
212160,Edinboro University of Pennsylvania,2013,All students total,7098,2738,4360,-2
212160,Edinboro University of Pennsylvania,2013,"All students, Undergraduate total",5864,2445,3419,-2
212160,Edinboro University of Pennsylvania,2013,"All students, Undergraduate, Degree/certificate-seeking total",5756,2415,3341,-2
212160,Edinboro University of Pennsylvania,2013,"All students, Undergraduate, Degree/certificate-seeking, First-time",1086,454,632,-2
212160,Edinboro University of Pennsylvania,2013,"All students, Undergraduate, Other degree/certificate-seeking",4670,1961,2709,-2
212160,Edinboro University of Pennsylvania,2013,"All students, Undergraduate, Other degree/certifcate-seeking, Transfer-ins",461,204,257,-2
212160,Edinboro University of Pennsylvania,2013,"All students, Undergraduate, Other degree/certifcate-seeking, Continuing",4209,1757,2452,-2
212160,Edinboro University of Pennsylvania,2013,"All students, Undergraduate, Non-degree/certificate-seeking",108,30,78,-2
212160,Edinboro University of Pennsylvania,2013,"All students, Graduate",1234,293,941,-2
212197,Elizabethtown College,2013,All students total,1892,671,1221,-2
212197,Elizabethtown College,2013,"All students, Undergraduate total",1844,669,1175,-2
212197,Elizabethtown College,2013,"All students, Undergraduate, Degree/certificate-seeking total",1808,656,1152,-2
212197,Elizabethtown College,2013,"All students, Undergraduate, Degree/certificate-seeking, First-time",530,224,306,-2
212197,Elizabethtown College,2013,"All students, Undergraduate, Other degree/certificate-seeking",1278,432,846,-2
212197,Elizabethtown College,2013,"All students, Undergraduate, Other degree/certifcate-seeking, Transfer-ins",25,8,17,-2
212197,Elizabethtown College,2013,"All students, Undergraduate, Other degree/certifcate-seeking, Continuing",1253,424,829,-2
212197,Elizabethtown College,2013,"All students, Undergraduate, Non-degree/certificate-seeking",36,13,23,-2
212197,Elizabethtown College,2013,"All students, Graduate",48,2,46,-2
212443,Evangelical Theological Seminary,2013,All students total,113,67,46,-2
212443,Evangelical Theological Seminary,2013,"All students, Graduate",113,67,46,-2
212452,Faith Theological Seminary,2013,All students total,380,190,190,-2
212452,Faith Theological Seminary,2013,"All students, Undergraduate total",269,113,156,-2
212452,Faith Theological Seminary,2013,"All students, Undergraduate, Degree/certificate-seeking total",236,106,130,-2
212452,Faith Theological Seminary,2013,"All students, Undergraduate, Degree/certificate-seeking, First-time",27,14,13,-2
212452,Faith Theological Seminary,2013,"All students, Undergraduate, Other degree/certificate-seeking",209,92,117,-2
212452,Faith Theological Seminary,2013,"All students, Undergraduate, Other degree/certifcate-seeking, Continuing",209,92,117,-2
212452,Faith Theological Seminary,2013,"All students, Undergraduate, Non-degree/certificate-seeking",33,7,26,-2
212452,Faith Theological Seminary,2013,"All students, Graduate",111,77,34,-2
212577,Franklin and Marshall College,2013,All students total,2297,1111,1186,-2
212577,Franklin and Marshall College,2013,"All students, Undergraduate total",2297,1111,1186,-2
212577,Franklin and Marshall College,2013,"All students, Undergraduate, Degree/certificate-seeking total",2262,1102,1160,-2
212577,Franklin and Marshall College,2013,"All students, Undergraduate, Degree/certificate-seeking, First-time",605,302,303,-2
212577,Franklin and Marshall College,2013,"All students, Undergraduate, Other degree/certificate-seeking",1657,800,857,-2
212577,Franklin and Marshall College,2013,"All students, Undergraduate, Other degree/certifcate-seeking, Transfer-ins",11,6,5,-2
212577,Franklin and Marshall College,2013,"All students, Undergraduate, Other degree/certifcate-seeking, Continuing",1646,794,852,-2
212577,Franklin and Marshall College,2013,"All students, Undergraduate, Non-degree/certificate-seeking",35,9,26,-2
212601,Gannon University,2013,All students total,4211,1805,2406,-2
212601,Gannon University,2013,"All students, Undergraduate total",3111,1328,1783,-2
212601,Gannon University,2013,"All students, Undergraduate, Degree/certificate-seeking total",2697,1135,1562,-2
212601,Gannon University,2013,"All students, Undergraduate, Degree/certificate-seeking, First-time",622,272,350,-2
212601,Gannon University,2013,"All students, Undergraduate, Other degree/certificate-seeking",2075,863,1212,-2
212601,Gannon University,2013,"All students, Undergraduate, Other degree/certifcate-seeking, Transfer-ins",148,69,79,-2
212601,Gannon University,2013,"All students, Undergraduate, Other degree/certifcate-seeking, Continuing",1927,794,1133,-2
212601,Gannon University,2013,"All students, Undergraduate, Non-degree/certificate-seeking",414,193,221,-2
212601,Gannon University,2013,"All students, Graduate",1100,477,623,-2
212656,Geneva College,2013,All students total,1852,845,1007,-2
212656,Geneva College,2013,"All students, Undergraduate total",1541,738,803,-2
212656,Geneva College,2013,"All students, Undergraduate, Degree/certificate-seeking total",1532,732,800,-2
212656,Geneva College,2013,"All students, Undergraduate, Degree/certificate-seeking, First-time",338,174,164,-2
212656,Geneva College,2013,"All students, Undergraduate, Other degree/certificate-seeking",1194,558,636,-2
212656,Geneva College,2013,"All students, Undergraduate, Other degree/certifcate-seeking, Transfer-ins",49,25,24,-2
212656,Geneva College,2013,"All students, Undergraduate, Other degree/certifcate-seeking, Continuing",1145,533,612,-2
212656,Geneva College,2013,"All students, Undergraduate, Non-degree/certificate-seeking",9,6,3,-2
212656,Geneva College,2013,"All students, Graduate",311,107,204,-2
212674,Gettysburg College,2013,All students total,2524,1204,1320,-2
212674,Gettysburg College,2013,"All students, Undergraduate total",2524,1204,1320,-2
212674,Gettysburg College,2013,"All students, Undergraduate, Degree/certificate-seeking total",2520,1201,1319,-2
212674,Gettysburg College,2013,"All students, Undergraduate, Degree/certificate-seeking, First-time",703,337,366,-2
212674,Gettysburg College,2013,"All students, Undergraduate, Other degree/certificate-seeking",1817,864,953,-2
212674,Gettysburg College,2013,"All students, Undergraduate, Other degree/certifcate-seeking, Transfer-ins",14,5,9,-2
212674,Gettysburg College,2013,"All students, Undergraduate, Other degree/certifcate-seeking, Continuing",1803,859,944,-2
212674,Gettysburg College,2013,"All students, Undergraduate, Non-degree/certificate-seeking",4,3,1,-2
212771,Gratz College,2013,All students total,673,175,498,-2
212771,Gratz College,2013,"All students, Undergraduate total",11,3,8,-2
212771,Gratz College,2013,"All students, Undergraduate, Degree/certificate-seeking total",9,2,7,-2
212771,Gratz College,2013,"All students, Undergraduate, Other degree/certificate-seeking",9,2,7,-2
212771,Gratz College,2013,"All students, Undergraduate, Other degree/certifcate-seeking, Continuing",9,2,7,-2
212771,Gratz College,2013,"All students, Undergraduate, Non-degree/certificate-seeking",2,1,1,-2
212771,Gratz College,2013,"All students, Graduate",662,172,490,-2
212805,Grove City College,2013,All students total,2491,1226,1265,-2
212805,Grove City College,2013,"All students, Undergraduate total",2491,1226,1265,-2
212805,Grove City College,2013,"All students, Undergraduate, Degree/certificate-seeking total",2455,1210,1245,-2
212805,Grove City College,2013,"All students, Undergraduate, Degree/certificate-seeking, First-time",648,316,332,-2
212805,Grove City College,2013,"All students, Undergraduate, Other degree/certificate-seeking",1807,894,913,-2
212805,Grove City College,2013,"All students, Undergraduate, Other degree/certifcate-seeking, Transfer-ins",32,19,13,-2
212805,Grove City College,2013,"All students, Undergraduate, Other degree/certifcate-seeking, Continuing",1775,875,900,-2
212805,Grove City College,2013,"All students, Undergraduate, Non-degree/certificate-seeking",36,16,20,-2
212832,Gwynedd Mercy University,2013,All students total,2371,580,1791,-2
212832,Gwynedd Mercy University,2013,"All students, Undergraduate total",2062,515,1547,-2
212832,Gwynedd Mercy University,2013,"All students, Undergraduate, Degree/certificate-seeking total",2031,508,1523,-2
212832,Gwynedd Mercy University,2013,"All students, Undergraduate, Degree/certificate-seeking, First-time",211,70,141,-2
212832,Gwynedd Mercy University,2013,"All students, Undergraduate, Other degree/certificate-seeking",1820,438,1382,-2
212832,Gwynedd Mercy University,2013,"All students, Undergraduate, Other degree/certifcate-seeking, Transfer-ins",279,42,237,-2
212832,Gwynedd Mercy University,2013,"All students, Undergraduate, Other degree/certifcate-seeking, Continuing",1541,396,1145,-2
212832,Gwynedd Mercy University,2013,"All students, Undergraduate, Non-degree/certificate-seeking",31,7,24,-2
212832,Gwynedd Mercy University,2013,"All students, Graduate",309,65,244,-2
212911,Haverford College,2013,All students total,1187,568,619,-2
212911,Haverford College,2013,"All students, Undergraduate total",1187,568,619,-2
212911,Haverford College,2013,"All students, Undergraduate, Degree/certificate-seeking total",1187,568,619,-2
212911,Haverford College,2013,"All students, Undergraduate, Degree/certificate-seeking, First-time",330,157,173,-2
212911,Haverford College,2013,"All students, Undergraduate, Other degree/certificate-seeking",857,411,446,-2
212911,Haverford College,2013,"All students, Undergraduate, Other degree/certifcate-seeking, Transfer-ins",2,1,1,-2
212911,Haverford College,2013,"All students, Undergraduate, Other degree/certifcate-seeking, Continuing",855,410,445,-2
212984,Holy Family University,2013,All students total,2956,766,2190,-2
212984,Holy Family University,2013,"All students, Undergraduate total",2182,571,1611,-2
212984,Holy Family University,2013,"All students, Undergraduate, Degree/certificate-seeking total",2018,520,1498,-2
212984,Holy Family University,2013,"All students, Undergraduate, Degree/certificate-seeking, First-time",291,77,214,-2
212984,Holy Family University,2013,"All students, Undergraduate, Other degree/certificate-seeking",1727,443,1284,-2
212984,Holy Family University,2013,"All students, Undergraduate, Other degree/certifcate-seeking, Transfer-ins",215,54,161,-2
212984,Holy Family University,2013,"All students, Undergraduate, Other degree/certifcate-seeking, Continuing",1512,389,1123,-2
212984,Holy Family University,2013,"All students, Undergraduate, Non-degree/certificate-seeking",164,51,113,-2
212984,Holy Family University,2013,"All students, Graduate",774,195,579,-2
213011,Immaculata University,2013,All students total,3675,906,2769,-2
213011,Immaculata University,2013,"All students, Undergraduate total",2560,624,1936,-2
213011,Immaculata University,2013,"All students, Undergraduate, Degree/certificate-seeking total",2452,600,1852,-2
213011,Immaculata University,2013,"All students, Undergraduate, Degree/certificate-seeking, First-time",289,106,183,-2
213011,Immaculata University,2013,"All students, Undergraduate, Other degree/certificate-seeking",2163,494,1669,-2
213011,Immaculata University,2013,"All students, Undergraduate, Other degree/certifcate-seeking, Transfer-ins",230,60,170,-2
213011,Immaculata University,2013,"All students, Undergraduate, Other degree/certifcate-seeking, Continuing",1933,434,1499,-2
213011,Immaculata University,2013,"All students, Undergraduate, Non-degree/certificate-seeking",108,24,84,-2
213011,Immaculata University,2013,"All students, Graduate",1115,282,833,-2
213020,Indiana University of Pennsylvania-Main Campus,2013,All students total,14925,6646,8279,-2
213020,Indiana University of Pennsylvania-Main Campus,2013,"All students, Undergraduate total",12668,5721,6947,-2
213020,Indiana University of Pennsylvania-Main Campus,2013,"All students, Undergraduate, Degree/certificate-seeking total",12405,5587,6818,-2
213020,Indiana University of Pennsylvania-Main Campus,2013,"All students, Undergraduate, Degree/certificate-seeking, First-time",2766,1165,1601,-2
213020,Indiana University of Pennsylvania-Main Campus,2013,"All students, Undergraduate, Other degree/certificate-seeking",9639,4422,5217,-2
213020,Indiana University of Pennsylvania-Main Campus,2013,"All students, Undergraduate, Other degree/certifcate-seeking, Transfer-ins",626,342,284,-2
213020,Indiana University of Pennsylvania-Main Campus,2013,"All students, Undergraduate, Other degree/certifcate-seeking, Continuing",9013,4080,4933,-2
213020,Indiana University of Pennsylvania-Main Campus,2013,"All students, Undergraduate, Non-degree/certificate-seeking",263,134,129,-2
213020,Indiana University of Pennsylvania-Main Campus,2013,"All students, Graduate",2257,925,1332,-2
213251,Juniata College,2013,All students total,1635,734,901,-2
213251,Juniata College,2013,"All students, Undergraduate total",1625,730,895,-2
213251,Juniata College,2013,"All students, Undergraduate, Degree/certificate-seeking total",1503,683,820,-2
213251,Juniata College,2013,"All students, Undergraduate, Degree/certificate-seeking, First-time",391,175,216,-2
213251,Juniata College,2013,"All students, Undergraduate, Other degree/certificate-seeking",1112,508,604,-2
213251,Juniata College,2013,"All students, Undergraduate, Other degree/certifcate-seeking, Transfer-ins",25,11,14,-2
213251,Juniata College,2013,"All students, Undergraduate, Other degree/certifcate-seeking, Continuing",1087,497,590,-2
213251,Juniata College,2013,"All students, Undergraduate, Non-degree/certificate-seeking",122,47,75,-2
213251,Juniata College,2013,"All students, Graduate",10,4,6,-2
213303,Keystone College,2013,All students total,1595,650,945,-2
213303,Keystone College,2013,"All students, Undergraduate total",1574,644,930,-2
213303,Keystone College,2013,"All students, Undergraduate, Degree/certificate-seeking total",1550,630,920,-2
213303,Keystone College,2013,"All students, Undergraduate, Degree/certificate-seeking, First-time",323,125,198,-2
213303,Keystone College,2013,"All students, Undergraduate, Other degree/certificate-seeking",1227,505,722,-2
213303,Keystone College,2013,"All students, Undergraduate, Other degree/certifcate-seeking, Transfer-ins",123,63,60,-2
213303,Keystone College,2013,"All students, Undergraduate, Other degree/certifcate-seeking, Continuing",1104,442,662,-2
213303,Keystone College,2013,"All students, Undergraduate, Non-degree/certificate-seeking",24,14,10,-2
213303,Keystone College,2013,"All students, Graduate",21,6,15,-2
213321,King's College,2013,All students total,2391,1165,1226,-2
213321,King's College,2013,"All students, Undergraduate total",2144,1102,1042,-2
213321,King's College,2013,"All students, Undergraduate, Degree/certificate-seeking total",1987,1037,950,-2
213321,King's College,2013,"All students, Undergraduate, Degree/certificate-seeking, First-time",500,273,227,-2
213321,King's College,2013,"All students, Undergraduate, Other degree/certificate-seeking",1487,764,723,-2
213321,King's College,2013,"All students, Undergraduate, Other degree/certifcate-seeking, Transfer-ins",71,32,39,-2
213321,King's College,2013,"All students, Undergraduate, Other degree/certifcate-seeking, Continuing",1416,732,684,-2
213321,King's College,2013,"All students, Undergraduate, Non-degree/certificate-seeking",157,65,92,-2
213321,King's College,2013,"All students, Graduate",247,63,184,-2
213349,Kutztown University of Pennsylvania,2013,All students total,9513,4009,5504,-2
213349,Kutztown University of Pennsylvania,2013,"All students, Undergraduate total",8815,3829,4986,-2
213349,Kutztown University of Pennsylvania,2013,"All students, Undergraduate, Degree/certificate-seeking total",8538,3755,4783,-2
213349,Kutztown University of Pennsylvania,2013,"All students, Undergraduate, Degree/certificate-seeking, First-time",1814,734,1080,-2
213349,Kutztown University of Pennsylvania,2013,"All students, Undergraduate, Other degree/certificate-seeking",6724,3021,3703,-2
213349,Kutztown University of Pennsylvania,2013,"All students, Undergraduate, Other degree/certifcate-seeking, Transfer-ins",696,372,324,-2
213349,Kutztown University of Pennsylvania,2013,"All students, Undergraduate, Other degree/certifcate-seeking, Continuing",6028,2649,3379,-2
213349,Kutztown University of Pennsylvania,2013,"All students, Undergraduate, Non-degree/certificate-seeking",277,74,203,-2
213349,Kutztown University of Pennsylvania,2013,"All students, Graduate",698,180,518,-2
213358,La Roche College,2013,All students total,1481,616,865,-2
213358,La Roche College,2013,"All students, Undergraduate total",1363,585,778,-2
213358,La Roche College,2013,"All students, Undergraduate, Degree/certificate-seeking total",1344,580,764,-2
213358,La Roche College,2013,"All students, Undergraduate, Degree/certificate-seeking, First-time",229,99,130,-2
213358,La Roche College,2013,"All students, Undergraduate, Other degree/certificate-seeking",1115,481,634,-2
213358,La Roche College,2013,"All students, Undergraduate, Other degree/certifcate-seeking, Transfer-ins",167,59,108,-2
213358,La Roche College,2013,"All students, Undergraduate, Other degree/certifcate-seeking, Continuing",948,422,526,-2
213358,La Roche College,2013,"All students, Undergraduate, Non-degree/certificate-seeking",19,5,14,-2
213358,La Roche College,2013,"All students, Graduate",118,31,87,-2
213367,La Salle University,2013,All students total,6436,2175,4261,-2
213367,La Salle University,2013,"All students, Undergraduate total",4409,1558,2851,-2
213367,La Salle University,2013,"All students, Undergraduate, Degree/certificate-seeking total",4228,1531,2697,-2
213367,La Salle University,2013,"All students, Undergraduate, Degree/certificate-seeking, First-time",939,340,599,-2
213367,La Salle University,2013,"All students, Undergraduate, Other degree/certificate-seeking",3289,1191,2098,-2
213367,La Salle University,2013,"All students, Undergraduate, Other degree/certifcate-seeking, Transfer-ins",232,83,149,-2
213367,La Salle University,2013,"All students, Undergraduate, Other degree/certifcate-seeking, Continuing",3057,1108,1949,-2
213367,La Salle University,2013,"All students, Undergraduate, Non-degree/certificate-seeking",181,27,154,-2
213367,La Salle University,2013,"All students, Graduate",2027,617,1410,-2
213385,Lafayette College,2013,All students total,2486,1326,1160,-2
213385,Lafayette College,2013,"All students, Undergraduate total",2486,1326,1160,-2
213385,Lafayette College,2013,"All students, Undergraduate, Degree/certificate-seeking total",2452,1307,1145,-2
213385,Lafayette College,2013,"All students, Undergraduate, Degree/certificate-seeking, First-time",635,329,306,-2
213385,Lafayette College,2013,"All students, Undergraduate, Other degree/certificate-seeking",1817,978,839,-2
213385,Lafayette College,2013,"All students, Undergraduate, Other degree/certifcate-seeking, Transfer-ins",12,8,4,-2
213385,Lafayette College,2013,"All students, Undergraduate, Other degree/certifcate-seeking, Continuing",1805,970,835,-2
213385,Lafayette College,2013,"All students, Undergraduate, Non-degree/certificate-seeking",34,19,15,-2
213400,Lancaster Bible College,2013,All students total,1763,928,835,-2
213400,Lancaster Bible College,2013,"All students, Undergraduate total",1313,670,643,-2
213400,Lancaster Bible College,2013,"All students, Undergraduate, Degree/certificate-seeking total",1212,628,584,-2
213400,Lancaster Bible College,2013,"All students, Undergraduate, Degree/certificate-seeking, First-time",152,62,90,-2
213400,Lancaster Bible College,2013,"All students, Undergraduate, Other degree/certificate-seeking",1060,566,494,-2
213400,Lancaster Bible College,2013,"All students, Undergraduate, Other degree/certifcate-seeking, Transfer-ins",174,91,83,-2
213400,Lancaster Bible College,2013,"All students, Undergraduate, Other degree/certifcate-seeking, Continuing",886,475,411,-2
213400,Lancaster Bible College,2013,"All students, Undergraduate, Non-degree/certificate-seeking",101,42,59,-2
213400,Lancaster Bible College,2013,"All students, Graduate",450,258,192,-2
213446,Lancaster Theological Seminary,2013,All students total,128,62,66,-2
213446,Lancaster Theological Seminary,2013,"All students, Graduate",128,62,66,-2
213507,Lebanon Valley College,2013,All students total,2022,931,1091,-2
213507,Lebanon Valley College,2013,"All students, Undergraduate total",1766,827,939,-2
213507,Lebanon Valley College,2013,"All students, Undergraduate, Degree/certificate-seeking total",1698,793,905,-2
213507,Lebanon Valley College,2013,"All students, Undergraduate, Degree/certificate-seeking, First-time",415,191,224,-2
213507,Lebanon Valley College,2013,"All students, Undergraduate, Other degree/certificate-seeking",1283,602,681,-2
213507,Lebanon Valley College,2013,"All students, Undergraduate, Other degree/certifcate-seeking, Transfer-ins",61,29,32,-2
213507,Lebanon Valley College,2013,"All students, Undergraduate, Other degree/certifcate-seeking, Continuing",1222,573,649,-2
213507,Lebanon Valley College,2013,"All students, Undergraduate, Non-degree/certificate-seeking",68,34,34,-2
213507,Lebanon Valley College,2013,"All students, Graduate",256,104,152,-2
213543,Lehigh University,2013,All students total,7096,3938,3158,-2
213543,Lehigh University,2013,"All students, Undergraduate total",4931,2773,2158,-2
213543,Lehigh University,2013,"All students, Undergraduate, Degree/certificate-seeking total",4904,2753,2151,-2
213543,Lehigh University,2013,"All students, Undergraduate, Degree/certificate-seeking, First-time",1198,680,518,-2
213543,Lehigh University,2013,"All students, Undergraduate, Other degree/certificate-seeking",3706,2073,1633,-2
213543,Lehigh University,2013,"All students, Undergraduate, Other degree/certifcate-seeking, Transfer-ins",41,23,18,-2
213543,Lehigh University,2013,"All students, Undergraduate, Other degree/certifcate-seeking, Continuing",3665,2050,1615,-2
213543,Lehigh University,2013,"All students, Undergraduate, Non-degree/certificate-seeking",27,20,7,-2
213543,Lehigh University,2013,"All students, Graduate",2165,1165,1000,-2
213598,Lincoln University of Pennsylvania,2013,All students total,1963,791,1172,-2
213598,Lincoln University of Pennsylvania,2013,"All students, Undergraduate total",1624,671,953,-2
213598,Lincoln University of Pennsylvania,2013,"All students, Undergraduate, Degree/certificate-seeking total",1614,666,948,-2
213598,Lincoln University of Pennsylvania,2013,"All students, Undergraduate, Degree/certificate-seeking, First-time",333,136,197,-2
213598,Lincoln University of Pennsylvania,2013,"All students, Undergraduate, Other degree/certificate-seeking",1281,530,751,-2
213598,Lincoln University of Pennsylvania,2013,"All students, Undergraduate, Other degree/certifcate-seeking, Transfer-ins",105,50,55,-2
213598,Lincoln University of Pennsylvania,2013,"All students, Undergraduate, Other degree/certifcate-seeking, Continuing",1176,480,696,-2
213598,Lincoln University of Pennsylvania,2013,"All students, Undergraduate, Non-degree/certificate-seeking",10,5,5,-2
213598,Lincoln University of Pennsylvania,2013,"All students, Graduate",339,120,219,-2
213613,Lock Haven University,2013,All students total,5260,2206,3054,-2
213613,Lock Haven University,2013,"All students, Undergraduate total",4855,2096,2759,-2
213613,Lock Haven University,2013,"All students, Undergraduate, Degree/certificate-seeking total",4783,2059,2724,-2
213613,Lock Haven University,2013,"All students, Undergraduate, Degree/certificate-seeking, First-time",1086,486,600,-2
213613,Lock Haven University,2013,"All students, Undergraduate, Other degree/certificate-seeking",3697,1573,2124,-2
213613,Lock Haven University,2013,"All students, Undergraduate, Other degree/certifcate-seeking, Transfer-ins",211,90,121,-2
213613,Lock Haven University,2013,"All students, Undergraduate, Other degree/certifcate-seeking, Continuing",3486,1483,2003,-2
213613,Lock Haven University,2013,"All students, Undergraduate, Non-degree/certificate-seeking",72,37,35,-2
213613,Lock Haven University,2013,"All students, Graduate",405,110,295,-2
213631,Lutheran Theological Seminary at Gettysburg,2013,All students total,122,54,68,-2
213631,Lutheran Theological Seminary at Gettysburg,2013,"All students, Graduate",122,54,68,-2
213640,Lutheran Theological Seminary at Philadelphia,2013,All students total,230,113,117,-2
213640,Lutheran Theological Seminary at Philadelphia,2013,"All students, Graduate",230,113,117,-2
213668,Lycoming College,2013,All students total,1307,572,735,-2
213668,Lycoming College,2013,"All students, Undergraduate total",1307,572,735,-2
213668,Lycoming College,2013,"All students, Undergraduate, Degree/certificate-seeking total",1288,561,727,-2
213668,Lycoming College,2013,"All students, Undergraduate, Degree/certificate-seeking, First-time",345,149,196,-2
213668,Lycoming College,2013,"All students, Undergraduate, Other degree/certificate-seeking",943,412,531,-2
213668,Lycoming College,2013,"All students, Undergraduate, Other degree/certifcate-seeking, Transfer-ins",24,15,9,-2
213668,Lycoming College,2013,"All students, Undergraduate, Other degree/certifcate-seeking, Continuing",919,397,522,-2
213668,Lycoming College,2013,"All students, Undergraduate, Non-degree/certificate-seeking",19,11,8,-2
213783,Mansfield University of Pennsylvania,2013,All students total,2970,1156,1814,-2
213783,Mansfield University of Pennsylvania,2013,"All students, Undergraduate total",2717,1109,1608,-2
213783,Mansfield University of Pennsylvania,2013,"All students, Undergraduate, Degree/certificate-seeking total",2640,1085,1555,-2
213783,Mansfield University of Pennsylvania,2013,"All students, Undergraduate, Degree/certificate-seeking, First-time",628,265,363,-2
213783,Mansfield University of Pennsylvania,2013,"All students, Undergraduate, Other degree/certificate-seeking",2012,820,1192,-2
213783,Mansfield University of Pennsylvania,2013,"All students, Undergraduate, Other degree/certifcate-seeking, Transfer-ins",160,70,90,-2
213783,Mansfield University of Pennsylvania,2013,"All students, Undergraduate, Other degree/certifcate-seeking, Continuing",1852,750,1102,-2
213783,Mansfield University of Pennsylvania,2013,"All students, Undergraduate, Non-degree/certificate-seeking",77,24,53,-2
213783,Mansfield University of Pennsylvania,2013,"All students, Graduate",253,47,206,-2
213826,Marywood University,2013,All students total,3175,967,2208,-2
213826,Marywood University,2013,"All students, Undergraduate total",2148,714,1434,-2
213826,Marywood University,2013,"All students, Undergraduate, Degree/certificate-seeking total",2034,673,1361,-2
213826,Marywood University,2013,"All students, Undergraduate, Degree/certificate-seeking, First-time",405,135,270,-2
213826,Marywood University,2013,"All students, Undergraduate, Other degree/certificate-seeking",1629,538,1091,-2
213826,Marywood University,2013,"All students, Undergraduate, Other degree/certifcate-seeking, Transfer-ins",133,53,80,-2
213826,Marywood University,2013,"All students, Undergraduate, Other degree/certifcate-seeking, Continuing",1496,485,1011,-2
213826,Marywood University,2013,"All students, Undergraduate, Non-degree/certificate-seeking",114,41,73,-2
213826,Marywood University,2013,"All students, Graduate",1027,253,774,-2
213987,Mercyhurst University,2013,All students total,3011,1324,1687,-2
213987,Mercyhurst University,2013,"All students, Undergraduate total",2680,1178,1502,-2
213987,Mercyhurst University,2013,"All students, Undergraduate, Degree/certificate-seeking total",2679,1178,1501,-2
213987,Mercyhurst University,2013,"All students, Undergraduate, Degree/certificate-seeking, First-time",602,267,335,-2
213987,Mercyhurst University,2013,"All students, Undergraduate, Other degree/certificate-seeking",2077,911,1166,-2
213987,Mercyhurst University,2013,"All students, Undergraduate, Other degree/certifcate-seeking, Transfer-ins",65,33,32,-2
213987,Mercyhurst University,2013,"All students, Undergraduate, Other degree/certifcate-seeking, Continuing",2012,878,1134,-2
213987,Mercyhurst University,2013,"All students, Undergraduate, Non-degree/certificate-seeking",1,0,1,-2
213987,Mercyhurst University,2013,"All students, Graduate",331,146,185,-2
213996,Messiah College,2013,All students total,3084,1159,1925,-2
213996,Messiah College,2013,"All students, Undergraduate total",2772,1088,1684,-2
213996,Messiah College,2013,"All students, Undergraduate, Degree/certificate-seeking total",2739,1077,1662,-2
213996,Messiah College,2013,"All students, Undergraduate, Degree/certificate-seeking, First-time",648,260,388,-2
213996,Messiah College,2013,"All students, Undergraduate, Other degree/certificate-seeking",2091,817,1274,-2
213996,Messiah College,2013,"All students, Undergraduate, Other degree/certifcate-seeking, Transfer-ins",100,33,67,-2
213996,Messiah College,2013,"All students, Undergraduate, Other degree/certifcate-seeking, Continuing",1991,784,1207,-2
213996,Messiah College,2013,"All students, Undergraduate, Non-degree/certificate-seeking",33,11,22,-2
213996,Messiah College,2013,"All students, Graduate",312,71,241,-2
214041,Millersville University of Pennsylvania,2013,All students total,8279,3551,4728,-2
214041,Millersville University of Pennsylvania,2013,"All students, Undergraduate total",7388,3312,4076,-2
214041,Millersville University of Pennsylvania,2013,"All students, Undergraduate, Degree/certificate-seeking total",7313,3273,4040,-2
214041,Millersville University of Pennsylvania,2013,"All students, Undergraduate, Degree/certificate-seeking, First-time",1299,559,740,-2
214041,Millersville University of Pennsylvania,2013,"All students, Undergraduate, Other degree/certificate-seeking",6014,2714,3300,-2
214041,Millersville University of Pennsylvania,2013,"All students, Undergraduate, Other degree/certifcate-seeking, Transfer-ins",689,310,379,-2
214041,Millersville University of Pennsylvania,2013,"All students, Undergraduate, Other degree/certifcate-seeking, Continuing",5325,2404,2921,-2
214041,Millersville University of Pennsylvania,2013,"All students, Undergraduate, Non-degree/certificate-seeking",75,39,36,-2
214041,Millersville University of Pennsylvania,2013,"All students, Graduate",891,239,652,-2
214069,Misericordia University,2013,All students total,3026,941,2085,-2
214069,Misericordia University,2013,"All students, Undergraduate total",2417,764,1653,-2
214069,Misericordia University,2013,"All students, Undergraduate, Degree/certificate-seeking total",2362,745,1617,-2
214069,Misericordia University,2013,"All students, Undergraduate, Degree/certificate-seeking, First-time",438,172,266,-2
214069,Misericordia University,2013,"All students, Undergraduate, Other degree/certificate-seeking",1924,573,1351,-2
214069,Misericordia University,2013,"All students, Undergraduate, Other degree/certifcate-seeking, Transfer-ins",194,63,131,-2
214069,Misericordia University,2013,"All students, Undergraduate, Other degree/certifcate-seeking, Continuing",1730,510,1220,-2
214069,Misericordia University,2013,"All students, Undergraduate, Non-degree/certificate-seeking",55,19,36,-2
214069,Misericordia University,2013,"All students, Graduate",609,177,432,-2
214148,Moore College of Art and Design,2013,All students total,484,5,479,-2
214148,Moore College of Art and Design,2013,"All students, Undergraduate total",437,0,437,-2
214148,Moore College of Art and Design,2013,"All students, Undergraduate, Degree/certificate-seeking total",437,0,437,-2
214148,Moore College of Art and Design,2013,"All students, Undergraduate, Degree/certificate-seeking, First-time",75,0,75,-2
214148,Moore College of Art and Design,2013,"All students, Undergraduate, Other degree/certificate-seeking",362,0,362,-2
214148,Moore College of Art and Design,2013,"All students, Undergraduate, Other degree/certifcate-seeking, Transfer-ins",41,0,41,-2
214148,Moore College of Art and Design,2013,"All students, Undergraduate, Other degree/certifcate-seeking, Continuing",321,0,321,-2
214148,Moore College of Art and Design,2013,"All students, Graduate",47,5,42,-2
214157,Moravian College,2013,All students total,1837,712,1125,-2
214157,Moravian College,2013,"All students, Undergraduate total",1553,635,918,-2
214157,Moravian College,2013,"All students, Undergraduate, Degree/certificate-seeking total",1508,616,892,-2
214157,Moravian College,2013,"All students, Undergraduate, Degree/certificate-seeking, First-time",355,149,206,-2
214157,Moravian College,2013,"All students, Undergraduate, Other degree/certificate-seeking",1153,467,686,-2
214157,Moravian College,2013,"All students, Undergraduate, Other degree/certifcate-seeking, Transfer-ins",81,39,42,-2
214157,Moravian College,2013,"All students, Undergraduate, Other degree/certifcate-seeking, Continuing",1072,428,644,-2
214157,Moravian College,2013,"All students, Undergraduate, Non-degree/certificate-seeking",45,19,26,-2
214157,Moravian College,2013,"All students, Graduate",284,77,207,-2
214166,Mount Aloysius College,2013,All students total,1835,517,1318,-2
214166,Mount Aloysius College,2013,"All students, Undergraduate total",1781,503,1278,-2
214166,Mount Aloysius College,2013,"All students, Undergraduate, Degree/certificate-seeking total",1571,423,1148,-2
214166,Mount Aloysius College,2013,"All students, Undergraduate, Degree/certificate-seeking, First-time",394,116,278,-2
214166,Mount Aloysius College,2013,"All students, Undergraduate, Other degree/certificate-seeking",1177,307,870,-2
214166,Mount Aloysius College,2013,"All students, Undergraduate, Other degree/certifcate-seeking, Transfer-ins",139,34,105,-2
214166,Mount Aloysius College,2013,"All students, Undergraduate, Other degree/certifcate-seeking, Continuing",1038,273,765,-2
214166,Mount Aloysius College,2013,"All students, Undergraduate, Non-degree/certificate-seeking",210,80,130,-2
214166,Mount Aloysius College,2013,"All students, Graduate",54,14,40,-2
214175,Muhlenberg College,2013,All students total,2448,1009,1439,-2
214175,Muhlenberg College,2013,"All students, Undergraduate total",2448,1009,1439,-2
214175,Muhlenberg College,2013,"All students, Undergraduate, Degree/certificate-seeking total",2357,962,1395,-2
214175,Muhlenberg College,2013,"All students, Undergraduate, Degree/certificate-seeking, First-time",579,215,364,-2
214175,Muhlenberg College,2013,"All students, Undergraduate, Other degree/certificate-seeking",1778,747,1031,-2
214175,Muhlenberg College,2013,"All students, Undergraduate, Other degree/certifcate-seeking, Transfer-ins",22,9,13,-2
214175,Muhlenberg College,2013,"All students, Undergraduate, Other degree/certifcate-seeking, Continuing",1756,738,1018,-2
214175,Muhlenberg College,2013,"All students, Undergraduate, Non-degree/certificate-seeking",91,47,44,-2
214272,Neumann University,2013,All students total,2956,1032,1924,-2
214272,Neumann University,2013,"All students, Undergraduate total",2573,917,1656,-2
214272,Neumann University,2013,"All students, Undergraduate, Degree/certificate-seeking total",2462,876,1586,-2
214272,Neumann University,2013,"All students, Undergraduate, Degree/certificate-seeking, First-time",503,182,321,-2
214272,Neumann University,2013,"All students, Undergraduate, Other degree/certificate-seeking",1959,694,1265,-2
214272,Neumann University,2013,"All students, Undergraduate, Other degree/certifcate-seeking, Transfer-ins",101,43,58,-2
214272,Neumann University,2013,"All students, Undergraduate, Other degree/certifcate-seeking, Continuing",1858,651,1207,-2
214272,Neumann University,2013,"All students, Undergraduate, Non-degree/certificate-seeking",111,41,70,-2
214272,Neumann University,2013,"All students, Graduate",383,115,268,-2
214564,Salus University,2013,All students total,1011,291,720,-2
214564,Salus University,2013,"All students, Graduate",1011,291,720,-2
214591,Pennsylvania State University-Penn State Erie-Behrend College,2013,All students total,4057,2651,1406,-2
214591,Pennsylvania State University-Penn State Erie-Behrend College,2013,"All students, Undergraduate total",3943,2570,1373,-2
214591,Pennsylvania State University-Penn State Erie-Behrend College,2013,"All students, Undergraduate, Degree/certificate-seeking total",3797,2479,1318,-2
214591,Pennsylvania State University-Penn State Erie-Behrend College,2013,"All students, Undergraduate, Degree/certificate-seeking, First-time",1113,699,414,-2
214591,Pennsylvania State University-Penn State Erie-Behrend College,2013,"All students, Undergraduate, Other degree/certificate-seeking",2684,1780,904,-2
214591,Pennsylvania State University-Penn State Erie-Behrend College,2013,"All students, Undergraduate, Other degree/certifcate-seeking, Transfer-ins",138,79,59,-2
214591,Pennsylvania State University-Penn State Erie-Behrend College,2013,"All students, Undergraduate, Other degree/certifcate-seeking, Continuing",2546,1701,845,-2
214591,Pennsylvania State University-Penn State Erie-Behrend College,2013,"All students, Undergraduate, Non-degree/certificate-seeking",146,91,55,-2
214591,Pennsylvania State University-Penn State Erie-Behrend College,2013,"All students, Graduate",114,81,33,-2
214607,Pennsylvania State University-Penn State Great Valley,2013,All students total,473,322,151,-2
214607,Pennsylvania State University-Penn State Great Valley,2013,"All students, Graduate",473,322,151,-2
214616,Pennsylvania State University-College of Medicine,2013,All students total,797,389,408,-2
214616,Pennsylvania State University-College of Medicine,2013,"All students, Graduate",797,389,408,-2
214625,Pennsylvania State University-Penn State New Kensington,2013,All students total,680,395,285,-2
214625,Pennsylvania State University-Penn State New Kensington,2013,"All students, Undergraduate total",680,395,285,-2
214625,Pennsylvania State University-Penn State New Kensington,2013,"All students, Undergraduate, Degree/certificate-seeking total",615,365,250,-2
214625,Pennsylvania State University-Penn State New Kensington,2013,"All students, Undergraduate, Degree/certificate-seeking, First-time",168,101,67,-2
214625,Pennsylvania State University-Penn State New Kensington,2013,"All students, Undergraduate, Other degree/certificate-seeking",447,264,183,-2
214625,Pennsylvania State University-Penn State New Kensington,2013,"All students, Undergraduate, Other degree/certifcate-seeking, Transfer-ins",58,26,32,-2
214625,Pennsylvania State University-Penn State New Kensington,2013,"All students, Undergraduate, Other degree/certifcate-seeking, Continuing",389,238,151,-2
214625,Pennsylvania State University-Penn State New Kensington,2013,"All students, Undergraduate, Non-degree/certificate-seeking",65,30,35,-2
214634,Pennsylvania State University-Penn State Shenango,2013,All students total,568,185,383,-2
214634,Pennsylvania State University-Penn State Shenango,2013,"All students, Undergraduate total",568,185,383,-2
214634,Pennsylvania State University-Penn State Shenango,2013,"All students, Undergraduate, Degree/certificate-seeking total",490,155,335,-2
214634,Pennsylvania State University-Penn State Shenango,2013,"All students, Undergraduate, Degree/certificate-seeking, First-time",97,32,65,-2
214634,Pennsylvania State University-Penn State Shenango,2013,"All students, Undergraduate, Other degree/certificate-seeking",393,123,270,-2
214634,Pennsylvania State University-Penn State Shenango,2013,"All students, Undergraduate, Other degree/certifcate-seeking, Transfer-ins",58,14,44,-2
214634,Pennsylvania State University-Penn State Shenango,2013,"All students, Undergraduate, Other degree/certifcate-seeking, Continuing",335,109,226,-2
214634,Pennsylvania State University-Penn State Shenango,2013,"All students, Undergraduate, Non-degree/certificate-seeking",78,30,48,-2
214643,Pennsylvania State University-Penn State Wilkes-Barre,2013,All students total,613,443,170,-2
214643,Pennsylvania State University-Penn State Wilkes-Barre,2013,"All students, Undergraduate total",606,442,164,-2
214643,Pennsylvania State University-Penn State Wilkes-Barre,2013,"All students, Undergraduate, Degree/certificate-seeking total",534,406,128,-2
214643,Pennsylvania State University-Penn State Wilkes-Barre,2013,"All students, Undergraduate, Degree/certificate-seeking, First-time",168,122,46,-2
214643,Pennsylvania State University-Penn State Wilkes-Barre,2013,"All students, Undergraduate, Other degree/certificate-seeking",366,284,82,-2
214643,Pennsylvania State University-Penn State Wilkes-Barre,2013,"All students, Undergraduate, Other degree/certifcate-seeking, Transfer-ins",31,23,8,-2
214643,Pennsylvania State University-Penn State Wilkes-Barre,2013,"All students, Undergraduate, Other degree/certifcate-seeking, Continuing",335,261,74,-2
214643,Pennsylvania State University-Penn State Wilkes-Barre,2013,"All students, Undergraduate, Non-degree/certificate-seeking",72,36,36,-2
214643,Pennsylvania State University-Penn State Wilkes-Barre,2013,"All students, Graduate",7,1,6,-2
214652,Pennsylvania State University-Penn State Worthington Scranton,2013,All students total,1178,528,650,-2
214652,Pennsylvania State University-Penn State Worthington Scranton,2013,"All students, Undergraduate total",1178,528,650,-2
214652,Pennsylvania State University-Penn State Worthington Scranton,2013,"All students, Undergraduate, Degree/certificate-seeking total",1089,483,606,-2
214652,Pennsylvania State University-Penn State Worthington Scranton,2013,"All students, Undergraduate, Degree/certificate-seeking, First-time",257,138,119,-2
214652,Pennsylvania State University-Penn State Worthington Scranton,2013,"All students, Undergraduate, Other degree/certificate-seeking",832,345,487,-2
214652,Pennsylvania State University-Penn State Worthington Scranton,2013,"All students, Undergraduate, Other degree/certifcate-seeking, Transfer-ins",73,23,50,-2
214652,Pennsylvania State University-Penn State Worthington Scranton,2013,"All students, Undergraduate, Other degree/certifcate-seeking, Continuing",759,322,437,-2
214652,Pennsylvania State University-Penn State Worthington Scranton,2013,"All students, Undergraduate, Non-degree/certificate-seeking",89,45,44,-2
214661,Pennsylvania State System of Higher Education-Central Office,2013,,,,,-2
214670,Pennsylvania State University-Penn State Lehigh Valley,2013,All students total,925,509,416,-2
214670,Pennsylvania State University-Penn State Lehigh Valley,2013,"All students, Undergraduate total",889,505,384,-2
214670,Pennsylvania State University-Penn State Lehigh Valley,2013,"All students, Undergraduate, Degree/certificate-seeking total",788,453,335,-2
214670,Pennsylvania State University-Penn State Lehigh Valley,2013,"All students, Undergraduate, Degree/certificate-seeking, First-time",233,147,86,-2
214670,Pennsylvania State University-Penn State Lehigh Valley,2013,"All students, Undergraduate, Other degree/certificate-seeking",555,306,249,-2
214670,Pennsylvania State University-Penn State Lehigh Valley,2013,"All students, Undergraduate, Other degree/certifcate-seeking, Transfer-ins",81,33,48,-2
214670,Pennsylvania State University-Penn State Lehigh Valley,2013,"All students, Undergraduate, Other degree/certifcate-seeking, Continuing",474,273,201,-2
214670,Pennsylvania State University-Penn State Lehigh Valley,2013,"All students, Undergraduate, Non-degree/certificate-seeking",101,52,49,-2
214670,Pennsylvania State University-Penn State Lehigh Valley,2013,"All students, Graduate",36,4,32,-2
214689,Pennsylvania State University-Penn State Altoona,2013,All students total,3861,2054,1807,-2
214689,Pennsylvania State University-Penn State Altoona,2013,"All students, Undergraduate total",3861,2054,1807,-2
214689,Pennsylvania State University-Penn State Altoona,2013,"All students, Undergraduate, Degree/certificate-seeking total",3779,2008,1771,-2
214689,Pennsylvania State University-Penn State Altoona,2013,"All students, Undergraduate, Degree/certificate-seeking, First-time",1423,769,654,-2
214689,Pennsylvania State University-Penn State Altoona,2013,"All students, Undergraduate, Other degree/certificate-seeking",2356,1239,1117,-2
214689,Pennsylvania State University-Penn State Altoona,2013,"All students, Undergraduate, Other degree/certifcate-seeking, Transfer-ins",113,53,60,-2
214689,Pennsylvania State University-Penn State Altoona,2013,"All students, Undergraduate, Other degree/certifcate-seeking, Continuing",2243,1186,1057,-2
214689,Pennsylvania State University-Penn State Altoona,2013,"All students, Undergraduate, Non-degree/certificate-seeking",82,46,36,-2
214698,Pennsylvania State University-Penn State Beaver,2013,All students total,703,430,273,-2
214698,Pennsylvania State University-Penn State Beaver,2013,"All students, Undergraduate total",703,430,273,-2
214698,Pennsylvania State University-Penn State Beaver,2013,"All students, Undergraduate, Degree/certificate-seeking total",636,395,241,-2
214698,Pennsylvania State University-Penn State Beaver,2013,"All students, Undergraduate, Degree/certificate-seeking, First-time",241,159,82,-2
214698,Pennsylvania State University-Penn State Beaver,2013,"All students, Undergraduate, Other degree/certificate-seeking",395,236,159,-2
214698,Pennsylvania State University-Penn State Beaver,2013,"All students, Undergraduate, Other degree/certifcate-seeking, Transfer-ins",39,21,18,-2
214698,Pennsylvania State University-Penn State Beaver,2013,"All students, Undergraduate, Other degree/certifcate-seeking, Continuing",356,215,141,-2
214698,Pennsylvania State University-Penn State Beaver,2013,"All students, Undergraduate, Non-degree/certificate-seeking",67,35,32,-2
214704,Pennsylvania State University-Penn State Berks,2013,All students total,2732,1528,1204,-2
214704,Pennsylvania State University-Penn State Berks,2013,"All students, Undergraduate total",2712,1525,1187,-2
214704,Pennsylvania State University-Penn State Berks,2013,"All students, Undergraduate, Degree/certificate-seeking total",2573,1444,1129,-2
214704,Pennsylvania State University-Penn State Berks,2013,"All students, Undergraduate, Degree/certificate-seeking, First-time",807,443,364,-2
214704,Pennsylvania State University-Penn State Berks,2013,"All students, Undergraduate, Other degree/certificate-seeking",1766,1001,765,-2
214704,Pennsylvania State University-Penn State Berks,2013,"All students, Undergraduate, Other degree/certifcate-seeking, Transfer-ins",149,84,65,-2
214704,Pennsylvania State University-Penn State Berks,2013,"All students, Undergraduate, Other degree/certifcate-seeking, Continuing",1617,917,700,-2
214704,Pennsylvania State University-Penn State Berks,2013,"All students, Undergraduate, Non-degree/certificate-seeking",139,81,58,-2
214704,Pennsylvania State University-Penn State Berks,2013,"All students, Graduate",20,3,17,-2
214713,Pennsylvania State University-Penn State Harrisburg,2013,All students total,4441,2417,2024,-2
214713,Pennsylvania State University-Penn State Harrisburg,2013,"All students, Undergraduate total",3577,2056,1521,-2
214713,Pennsylvania State University-Penn State Harrisburg,2013,"All students, Undergraduate, Degree/certificate-seeking total",3461,1988,1473,-2
214713,Pennsylvania State University-Penn State Harrisburg,2013,"All students, Undergraduate, Degree/certificate-seeking, First-time",744,443,301,-2
214713,Pennsylvania State University-Penn State Harrisburg,2013,"All students, Undergraduate, Other degree/certificate-seeking",2717,1545,1172,-2
214713,Pennsylvania State University-Penn State Harrisburg,2013,"All students, Undergraduate, Other degree/certifcate-seeking, Transfer-ins",303,147,156,-2
214713,Pennsylvania State University-Penn State Harrisburg,2013,"All students, Undergraduate, Other degree/certifcate-seeking, Continuing",2414,1398,1016,-2
214713,Pennsylvania State University-Penn State Harrisburg,2013,"All students, Undergraduate, Non-degree/certificate-seeking",116,68,48,-2
214713,Pennsylvania State University-Penn State Harrisburg,2013,"All students, Graduate",864,361,503,-2
214731,Pennsylvania State University-Penn State Brandywine,2013,All students total,1492,847,645,-2
214731,Pennsylvania State University-Penn State Brandywine,2013,"All students, Undergraduate total",1492,847,645,-2
214731,Pennsylvania State University-Penn State Brandywine,2013,"All students, Undergraduate, Degree/certificate-seeking total",1327,747,580,-2
214731,Pennsylvania State University-Penn State Brandywine,2013,"All students, Undergraduate, Degree/certificate-seeking, First-time",333,199,134,-2
214731,Pennsylvania State University-Penn State Brandywine,2013,"All students, Undergraduate, Other degree/certificate-seeking",994,548,446,-2
214731,Pennsylvania State University-Penn State Brandywine,2013,"All students, Undergraduate, Other degree/certifcate-seeking, Transfer-ins",63,35,28,-2
214731,Pennsylvania State University-Penn State Brandywine,2013,"All students, Undergraduate, Other degree/certifcate-seeking, Continuing",931,513,418,-2
214731,Pennsylvania State University-Penn State Brandywine,2013,"All students, Undergraduate, Non-degree/certificate-seeking",165,100,65,-2
214740,Pennsylvania State University-Penn State Dubois,2013,All students total,704,366,338,-2
214740,Pennsylvania State University-Penn State Dubois,2013,"All students, Undergraduate total",704,366,338,-2
214740,Pennsylvania State University-Penn State Dubois,2013,"All students, Undergraduate, Degree/certificate-seeking total",591,305,286,-2
214740,Pennsylvania State University-Penn State Dubois,2013,"All students, Undergraduate, Degree/certificate-seeking, First-time",191,111,80,-2
214740,Pennsylvania State University-Penn State Dubois,2013,"All students, Undergraduate, Other degree/certificate-seeking",400,194,206,-2
214740,Pennsylvania State University-Penn State Dubois,2013,"All students, Undergraduate, Other degree/certifcate-seeking, Transfer-ins",29,13,16,-2
214740,Pennsylvania State University-Penn State Dubois,2013,"All students, Undergraduate, Other degree/certifcate-seeking, Continuing",371,181,190,-2
214740,Pennsylvania State University-Penn State Dubois,2013,"All students, Undergraduate, Non-degree/certificate-seeking",113,61,52,-2
214759,Pennsylvania State University-Penn State Fayette- Eberly,2013,All students total,846,369,477,-2
214759,Pennsylvania State University-Penn State Fayette- Eberly,2013,"All students, Undergraduate total",846,369,477,-2
214759,Pennsylvania State University-Penn State Fayette- Eberly,2013,"All students, Undergraduate, Degree/certificate-seeking total",762,335,427,-2
214759,Pennsylvania State University-Penn State Fayette- Eberly,2013,"All students, Undergraduate, Degree/certificate-seeking, First-time",202,90,112,-2
214759,Pennsylvania State University-Penn State Fayette- Eberly,2013,"All students, Undergraduate, Other degree/certificate-seeking",560,245,315,-2
214759,Pennsylvania State University-Penn State Fayette- Eberly,2013,"All students, Undergraduate, Other degree/certifcate-seeking, Transfer-ins",50,16,34,-2
214759,Pennsylvania State University-Penn State Fayette- Eberly,2013,"All students, Undergraduate, Other degree/certifcate-seeking, Continuing",510,229,281,-2
214759,Pennsylvania State University-Penn State Fayette- Eberly,2013,"All students, Undergraduate, Non-degree/certificate-seeking",84,34,50,-2
214768,Pennsylvania State University-Penn State Hazleton,2013,All students total,951,494,457,-2
214768,Pennsylvania State University-Penn State Hazleton,2013,"All students, Undergraduate total",951,494,457,-2
214768,Pennsylvania State University-Penn State Hazleton,2013,"All students, Undergraduate, Degree/certificate-seeking total",918,471,447,-2
214768,Pennsylvania State University-Penn State Hazleton,2013,"All students, Undergraduate, Degree/certificate-seeking, First-time",363,182,181,-2
214768,Pennsylvania State University-Penn State Hazleton,2013,"All students, Undergraduate, Other degree/certificate-seeking",555,289,266,-2
214768,Pennsylvania State University-Penn State Hazleton,2013,"All students, Undergraduate, Other degree/certifcate-seeking, Transfer-ins",42,17,25,-2
214768,Pennsylvania State University-Penn State Hazleton,2013,"All students, Undergraduate, Other degree/certifcate-seeking, Continuing",513,272,241,-2
214768,Pennsylvania State University-Penn State Hazleton,2013,"All students, Undergraduate, Non-degree/certificate-seeking",33,23,10,-2
214777,Pennsylvania State University-Main Campus,2013,All students total,46615,25090,21525,-2
214777,Pennsylvania State University-Main Campus,2013,"All students, Undergraduate total",40085,21527,18558,-2
214777,Pennsylvania State University-Main Campus,2013,"All students, Undergraduate, Degree/certificate-seeking total",39460,21162,18298,-2
214777,Pennsylvania State University-Main Campus,2013,"All students, Undergraduate, Degree/certificate-seeking, First-time",8043,4220,3823,-2
214777,Pennsylvania State University-Main Campus,2013,"All students, Undergraduate, Other degree/certificate-seeking",31417,16942,14475,-2
214777,Pennsylvania State University-Main Campus,2013,"All students, Undergraduate, Other degree/certifcate-seeking, Transfer-ins",498,268,230,-2
214777,Pennsylvania State University-Main Campus,2013,"All students, Undergraduate, Other degree/certifcate-seeking, Continuing",30919,16674,14245,-2
214777,Pennsylvania State University-Main Campus,2013,"All students, Undergraduate, Non-degree/certificate-seeking",625,365,260,-2
214777,Pennsylvania State University-Main Campus,2013,"All students, Graduate",6530,3563,2967,-2
214786,Pennsylvania State University-Penn State Greater Allegheny,2013,All students total,623,338,285,-2
214786,Pennsylvania State University-Penn State Greater Allegheny,2013,"All students, Undergraduate total",623,338,285,-2
214786,Pennsylvania State University-Penn State Greater Allegheny,2013,"All students, Undergraduate, Degree/certificate-seeking total",588,319,269,-2
214786,Pennsylvania State University-Penn State Greater Allegheny,2013,"All students, Undergraduate, Degree/certificate-seeking, First-time",193,96,97,-2
214786,Pennsylvania State University-Penn State Greater Allegheny,2013,"All students, Undergraduate, Other degree/certificate-seeking",395,223,172,-2
214786,Pennsylvania State University-Penn State Greater Allegheny,2013,"All students, Undergraduate, Other degree/certifcate-seeking, Transfer-ins",39,25,14,-2
214786,Pennsylvania State University-Penn State Greater Allegheny,2013,"All students, Undergraduate, Other degree/certifcate-seeking, Continuing",356,198,158,-2
214786,Pennsylvania State University-Penn State Greater Allegheny,2013,"All students, Undergraduate, Non-degree/certificate-seeking",35,19,16,-2
214795,Pennsylvania State University-Penn State Mont Alto,2013,All students total,1023,409,614,-2
214795,Pennsylvania State University-Penn State Mont Alto,2013,"All students, Undergraduate total",1022,409,613,-2
214795,Pennsylvania State University-Penn State Mont Alto,2013,"All students, Undergraduate, Degree/certificate-seeking total",911,355,556,-2
214795,Pennsylvania State University-Penn State Mont Alto,2013,"All students, Undergraduate, Degree/certificate-seeking, First-time",321,129,192,-2
214795,Pennsylvania State University-Penn State Mont Alto,2013,"All students, Undergraduate, Other degree/certificate-seeking",590,226,364,-2
214795,Pennsylvania State University-Penn State Mont Alto,2013,"All students, Undergraduate, Other degree/certifcate-seeking, Transfer-ins",44,14,30,-2
214795,Pennsylvania State University-Penn State Mont Alto,2013,"All students, Undergraduate, Other degree/certifcate-seeking, Continuing",546,212,334,-2
214795,Pennsylvania State University-Penn State Mont Alto,2013,"All students, Undergraduate, Non-degree/certificate-seeking",111,54,57,-2
214795,Pennsylvania State University-Penn State Mont Alto,2013,"All students, Graduate",1,0,1,-2
214801,Pennsylvania State University-Penn State Abington,2013,All students total,3694,1752,1942,-2
214801,Pennsylvania State University-Penn State Abington,2013,"All students, Undergraduate total",3690,1752,1938,-2
214801,Pennsylvania State University-Penn State Abington,2013,"All students, Undergraduate, Degree/certificate-seeking total",3231,1605,1626,-2
214801,Pennsylvania State University-Penn State Abington,2013,"All students, Undergraduate, Degree/certificate-seeking, First-time",923,520,403,-2
214801,Pennsylvania State University-Penn State Abington,2013,"All students, Undergraduate, Other degree/certificate-seeking",2308,1085,1223,-2
214801,Pennsylvania State University-Penn State Abington,2013,"All students, Undergraduate, Other degree/certifcate-seeking, Transfer-ins",210,95,115,-2
214801,Pennsylvania State University-Penn State Abington,2013,"All students, Undergraduate, Other degree/certifcate-seeking, Continuing",2098,990,1108,-2
214801,Pennsylvania State University-Penn State Abington,2013,"All students, Undergraduate, Non-degree/certificate-seeking",459,147,312,-2
214801,Pennsylvania State University-Penn State Abington,2013,"All students, Graduate",4,0,4,-2
214810,Pennsylvania State University-Penn State Schuylkill,2013,All students total,837,328,509,-2
214810,Pennsylvania State University-Penn State Schuylkill,2013,"All students, Undergraduate total",837,328,509,-2
214810,Pennsylvania State University-Penn State Schuylkill,2013,"All students, Undergraduate, Degree/certificate-seeking total",796,308,488,-2
214810,Pennsylvania State University-Penn State Schuylkill,2013,"All students, Undergraduate, Degree/certificate-seeking, First-time",260,99,161,-2
214810,Pennsylvania State University-Penn State Schuylkill,2013,"All students, Undergraduate, Other degree/certificate-seeking",536,209,327,-2
214810,Pennsylvania State University-Penn State Schuylkill,2013,"All students, Undergraduate, Other degree/certifcate-seeking, Transfer-ins",49,16,33,-2
214810,Pennsylvania State University-Penn State Schuylkill,2013,"All students, Undergraduate, Other degree/certifcate-seeking, Continuing",487,193,294,-2
214810,Pennsylvania State University-Penn State Schuylkill,2013,"All students, Undergraduate, Non-degree/certificate-seeking",41,20,21,-2
214829,Pennsylvania State University-Penn State York,2013,All students total,1177,644,533,-2
214829,Pennsylvania State University-Penn State York,2013,"All students, Undergraduate total",1141,641,500,-2
214829,Pennsylvania State University-Penn State York,2013,"All students, Undergraduate, Degree/certificate-seeking total",943,547,396,-2
214829,Pennsylvania State University-Penn State York,2013,"All students, Undergraduate, Degree/certificate-seeking, First-time",292,167,125,-2
214829,Pennsylvania State University-Penn State York,2013,"All students, Undergraduate, Other degree/certificate-seeking",651,380,271,-2
214829,Pennsylvania State University-Penn State York,2013,"All students, Undergraduate, Other degree/certifcate-seeking, Transfer-ins",47,21,26,-2
214829,Pennsylvania State University-Penn State York,2013,"All students, Undergraduate, Other degree/certifcate-seeking, Continuing",604,359,245,-2
214829,Pennsylvania State University-Penn State York,2013,"All students, Undergraduate, Non-degree/certificate-seeking",198,94,104,-2
214829,Pennsylvania State University-Penn State York,2013,"All students, Graduate",36,3,33,-2
214883,Peirce College,2013,All students total,1796,495,1301,-2
214883,Peirce College,2013,"All students, Undergraduate total",1759,485,1274,-2
214883,Peirce College,2013,"All students, Undergraduate, Degree/certificate-seeking total",1754,484,1270,-2
214883,Peirce College,2013,"All students, Undergraduate, Degree/certificate-seeking, First-time",51,16,35,-2
214883,Peirce College,2013,"All students, Undergraduate, Other degree/certificate-seeking",1703,468,1235,-2
214883,Peirce College,2013,"All students, Undergraduate, Other degree/certifcate-seeking, Transfer-ins",200,71,129,-2
214883,Peirce College,2013,"All students, Undergraduate, Other degree/certifcate-seeking, Continuing",1503,397,1106,-2
214883,Peirce College,2013,"All students, Undergraduate, Non-degree/certificate-seeking",5,1,4,-2
214883,Peirce College,2013,"All students, Graduate",37,10,27,-2
214971,Pennsylvania Academy of the Fine Arts,2013,All students total,299,121,178,-2
214971,Pennsylvania Academy of the Fine Arts,2013,"All students, Undergraduate total",198,81,117,-2
214971,Pennsylvania Academy of the Fine Arts,2013,"All students, Undergraduate, Degree/certificate-seeking total",198,81,117,-2
214971,Pennsylvania Academy of the Fine Arts,2013,"All students, Undergraduate, Degree/certificate-seeking, First-time",39,16,23,-2
214971,Pennsylvania Academy of the Fine Arts,2013,"All students, Undergraduate, Other degree/certificate-seeking",159,65,94,-2
214971,Pennsylvania Academy of the Fine Arts,2013,"All students, Undergraduate, Other degree/certifcate-seeking, Transfer-ins",20,7,13,-2
214971,Pennsylvania Academy of the Fine Arts,2013,"All students, Undergraduate, Other degree/certifcate-seeking, Continuing",139,58,81,-2
214971,Pennsylvania Academy of the Fine Arts,2013,"All students, Graduate",101,40,61,-2
215053,Pennsylvania College of Art and Design,2013,All students total,223,69,154,-2
215053,Pennsylvania College of Art and Design,2013,"All students, Undergraduate total",223,69,154,-2
215053,Pennsylvania College of Art and Design,2013,"All students, Undergraduate, Degree/certificate-seeking total",222,69,153,-2
215053,Pennsylvania College of Art and Design,2013,"All students, Undergraduate, Degree/certificate-seeking, First-time",52,17,35,-2
215053,Pennsylvania College of Art and Design,2013,"All students, Undergraduate, Other degree/certificate-seeking",170,52,118,-2
215053,Pennsylvania College of Art and Design,2013,"All students, Undergraduate, Other degree/certifcate-seeking, Transfer-ins",12,3,9,-2
215053,Pennsylvania College of Art and Design,2013,"All students, Undergraduate, Other degree/certifcate-seeking, Continuing",158,49,109,-2
215053,Pennsylvania College of Art and Design,2013,"All students, Undergraduate, Non-degree/certificate-seeking",1,0,1,-2
215062,University of Pennsylvania,2013,All students total,24630,11698,12932,-2
215062,University of Pennsylvania,2013,"All students, Undergraduate total",11525,5578,5947,-2
215062,University of Pennsylvania,2013,"All students, Undergraduate, Degree/certificate-seeking total",10606,5190,5416,-2
215062,University of Pennsylvania,2013,"All students, Undergraduate, Degree/certificate-seeking, First-time",2410,1181,1229,-2
215062,University of Pennsylvania,2013,"All students, Undergraduate, Other degree/certificate-seeking",8196,4009,4187,-2
215062,University of Pennsylvania,2013,"All students, Undergraduate, Other degree/certifcate-seeking, Transfer-ins",248,86,162,-2
215062,University of Pennsylvania,2013,"All students, Undergraduate, Other degree/certifcate-seeking, Continuing",7948,3923,4025,-2
215062,University of Pennsylvania,2013,"All students, Undergraduate, Non-degree/certificate-seeking",919,388,531,-2
215062,University of Pennsylvania,2013,"All students, Graduate",13105,6120,6985,-2
215099,Philadelphia University,2013,All students total,3523,1209,2314,-2
215099,Philadelphia University,2013,"All students, Undergraduate total",2811,975,1836,-2
215099,Philadelphia University,2013,"All students, Undergraduate, Degree/certificate-seeking total",2791,970,1821,-2
215099,Philadelphia University,2013,"All students, Undergraduate, Degree/certificate-seeking, First-time",550,175,375,-2
215099,Philadelphia University,2013,"All students, Undergraduate, Other degree/certificate-seeking",2241,795,1446,-2
215099,Philadelphia University,2013,"All students, Undergraduate, Other degree/certifcate-seeking, Transfer-ins",257,72,185,-2
215099,Philadelphia University,2013,"All students, Undergraduate, Other degree/certifcate-seeking, Continuing",1984,723,1261,-2
215099,Philadelphia University,2013,"All students, Undergraduate, Non-degree/certificate-seeking",20,5,15,-2
215099,Philadelphia University,2013,"All students, Graduate",712,234,478,-2
215105,The University of the Arts,2013,All students total,2063,852,1211,-2
215105,The University of the Arts,2013,"All students, Undergraduate total",1890,800,1090,-2
215105,The University of the Arts,2013,"All students, Undergraduate, Degree/certificate-seeking total",1865,787,1078,-2
215105,The University of the Arts,2013,"All students, Undergraduate, Degree/certificate-seeking, First-time",457,181,276,-2
215105,The University of the Arts,2013,"All students, Undergraduate, Other degree/certificate-seeking",1408,606,802,-2
215105,The University of the Arts,2013,"All students, Undergraduate, Other degree/certifcate-seeking, Transfer-ins",106,53,53,-2
215105,The University of the Arts,2013,"All students, Undergraduate, Other degree/certifcate-seeking, Continuing",1302,553,749,-2
215105,The University of the Arts,2013,"All students, Undergraduate, Non-degree/certificate-seeking",25,13,12,-2
215105,The University of the Arts,2013,"All students, Graduate",173,52,121,-2
215114,Cairn University-Langhorne,2013,All students total,1093,492,601,-2
215114,Cairn University-Langhorne,2013,"All students, Undergraduate total",844,392,452,-2
215114,Cairn University-Langhorne,2013,"All students, Undergraduate, Degree/certificate-seeking total",840,392,448,-2
215114,Cairn University-Langhorne,2013,"All students, Undergraduate, Degree/certificate-seeking, First-time",139,59,80,-2
215114,Cairn University-Langhorne,2013,"All students, Undergraduate, Other degree/certificate-seeking",701,333,368,-2
215114,Cairn University-Langhorne,2013,"All students, Undergraduate, Other degree/certifcate-seeking, Transfer-ins",66,39,27,-2
215114,Cairn University-Langhorne,2013,"All students, Undergraduate, Other degree/certifcate-seeking, Continuing",635,294,341,-2
215114,Cairn University-Langhorne,2013,"All students, Undergraduate, Non-degree/certificate-seeking",4,0,4,-2
215114,Cairn University-Langhorne,2013,"All students, Graduate",249,100,149,-2
215123,Philadelphia College of Osteopathic Medicine,2013,All students total,2736,1204,1532,-2
215123,Philadelphia College of Osteopathic Medicine,2013,"All students, Graduate",2736,1204,1532,-2
215132,University of the Sciences,2013,All students total,2773,1081,1692,-2
215132,University of the Sciences,2013,"All students, Undergraduate total",1837,705,1132,-2
215132,University of the Sciences,2013,"All students, Undergraduate, Degree/certificate-seeking total",1830,703,1127,-2
215132,University of the Sciences,2013,"All students, Undergraduate, Degree/certificate-seeking, First-time",440,176,264,-2
215132,University of the Sciences,2013,"All students, Undergraduate, Other degree/certificate-seeking",1390,527,863,-2
215132,University of the Sciences,2013,"All students, Undergraduate, Other degree/certifcate-seeking, Transfer-ins",117,29,88,-2
215132,University of the Sciences,2013,"All students, Undergraduate, Other degree/certifcate-seeking, Continuing",1273,498,775,-2
215132,University of the Sciences,2013,"All students, Undergraduate, Non-degree/certificate-seeking",7,2,5,-2
215132,University of the Sciences,2013,"All students, Graduate",936,376,560,-2
215266,University of Pittsburgh-Bradford,2013,All students total,1481,671,810,-2
215266,University of Pittsburgh-Bradford,2013,"All students, Undergraduate total",1481,671,810,-2
215266,University of Pittsburgh-Bradford,2013,"All students, Undergraduate, Degree/certificate-seeking total",1456,664,792,-2
215266,University of Pittsburgh-Bradford,2013,"All students, Undergraduate, Degree/certificate-seeking, First-time",391,188,203,-2
215266,University of Pittsburgh-Bradford,2013,"All students, Undergraduate, Other degree/certificate-seeking",1065,476,589,-2
215266,University of Pittsburgh-Bradford,2013,"All students, Undergraduate, Other degree/certifcate-seeking, Transfer-ins",123,50,73,-2
215266,University of Pittsburgh-Bradford,2013,"All students, Undergraduate, Other degree/certifcate-seeking, Continuing",942,426,516,-2
215266,University of Pittsburgh-Bradford,2013,"All students, Undergraduate, Non-degree/certificate-seeking",25,7,18,-2
215275,University of Pittsburgh-Greensburg,2013,All students total,1677,848,829,-2
215275,University of Pittsburgh-Greensburg,2013,"All students, Undergraduate total",1677,848,829,-2
215275,University of Pittsburgh-Greensburg,2013,"All students, Undergraduate, Degree/certificate-seeking total",1677,848,829,-2
215275,University of Pittsburgh-Greensburg,2013,"All students, Undergraduate, Degree/certificate-seeking, First-time",386,183,203,-2
215275,University of Pittsburgh-Greensburg,2013,"All students, Undergraduate, Other degree/certificate-seeking",1291,665,626,-2
215275,University of Pittsburgh-Greensburg,2013,"All students, Undergraduate, Other degree/certifcate-seeking, Transfer-ins",154,88,66,-2
215275,University of Pittsburgh-Greensburg,2013,"All students, Undergraduate, Other degree/certifcate-seeking, Continuing",1137,577,560,-2
215284,University of Pittsburgh-Johnstown,2013,All students total,2840,1550,1290,-2
215284,University of Pittsburgh-Johnstown,2013,"All students, Undergraduate total",2840,1550,1290,-2
215284,University of Pittsburgh-Johnstown,2013,"All students, Undergraduate, Degree/certificate-seeking total",2837,1549,1288,-2
215284,University of Pittsburgh-Johnstown,2013,"All students, Undergraduate, Degree/certificate-seeking, First-time",688,375,313,-2
215284,University of Pittsburgh-Johnstown,2013,"All students, Undergraduate, Other degree/certificate-seeking",2149,1174,975,-2
215284,University of Pittsburgh-Johnstown,2013,"All students, Undergraduate, Other degree/certifcate-seeking, Transfer-ins",145,79,66,-2
215284,University of Pittsburgh-Johnstown,2013,"All students, Undergraduate, Other degree/certifcate-seeking, Continuing",2004,1095,909,-2
215284,University of Pittsburgh-Johnstown,2013,"All students, Undergraduate, Non-degree/certificate-seeking",3,1,2,-2
215293,University of Pittsburgh-Pittsburgh Campus,2013,All students total,28649,13873,14776,-2
215293,University of Pittsburgh-Pittsburgh Campus,2013,"All students, Undergraduate total",18615,9262,9353,-2
215293,University of Pittsburgh-Pittsburgh Campus,2013,"All students, Undergraduate, Degree/certificate-seeking total",18304,9146,9158,-2
215293,University of Pittsburgh-Pittsburgh Campus,2013,"All students, Undergraduate, Degree/certificate-seeking, First-time",3854,1825,2029,-2
215293,University of Pittsburgh-Pittsburgh Campus,2013,"All students, Undergraduate, Other degree/certificate-seeking",14450,7321,7129,-2
215293,University of Pittsburgh-Pittsburgh Campus,2013,"All students, Undergraduate, Other degree/certifcate-seeking, Transfer-ins",887,468,419,-2
215293,University of Pittsburgh-Pittsburgh Campus,2013,"All students, Undergraduate, Other degree/certifcate-seeking, Continuing",13563,6853,6710,-2
215293,University of Pittsburgh-Pittsburgh Campus,2013,"All students, Undergraduate, Non-degree/certificate-seeking",311,116,195,-2
215293,University of Pittsburgh-Pittsburgh Campus,2013,"All students, Graduate",10034,4611,5423,-2
215424,Pittsburgh Theological Seminary,2013,All students total,246,156,90,-2
215424,Pittsburgh Theological Seminary,2013,"All students, Graduate",246,156,90,-2
215442,Point Park University,2013,All students total,3841,1656,2185,-2
215442,Point Park University,2013,"All students, Undergraduate total",3226,1383,1843,-2
215442,Point Park University,2013,"All students, Undergraduate, Degree/certificate-seeking total",3164,1379,1785,-2
215442,Point Park University,2013,"All students, Undergraduate, Degree/certificate-seeking, First-time",548,197,351,-2
215442,Point Park University,2013,"All students, Undergraduate, Other degree/certificate-seeking",2616,1182,1434,-2
215442,Point Park University,2013,"All students, Undergraduate, Other degree/certifcate-seeking, Transfer-ins",469,229,240,-2
215442,Point Park University,2013,"All students, Undergraduate, Other degree/certifcate-seeking, Continuing",2147,953,1194,-2
215442,Point Park University,2013,"All students, Undergraduate, Non-degree/certificate-seeking",62,4,58,-2
215442,Point Park University,2013,"All students, Graduate",615,273,342,-2
215619,Reconstructionist Rabbinical College,2013,All students total,48,18,30,-2
215619,Reconstructionist Rabbinical College,2013,"All students, Graduate",48,18,30,-2
215628,Reformed Presbyterian Theological Seminary,2013,All students total,81,73,8,-2
215628,Reformed Presbyterian Theological Seminary,2013,"All students, Graduate",81,73,8,-2
215637,The Restaurant School at Walnut Hill College,2013,All students total,427,197,230,-2
215637,The Restaurant School at Walnut Hill College,2013,"All students, Undergraduate total",427,197,230,-2
215637,The Restaurant School at Walnut Hill College,2013,"All students, Undergraduate, Degree/certificate-seeking total",427,197,230,-2
215637,The Restaurant School at Walnut Hill College,2013,"All students, Undergraduate, Degree/certificate-seeking, First-time",333,147,186,-2
215637,The Restaurant School at Walnut Hill College,2013,"All students, Undergraduate, Other degree/certificate-seeking",94,50,44,-2
215637,The Restaurant School at Walnut Hill College,2013,"All students, Undergraduate, Other degree/certifcate-seeking, Transfer-ins",16,9,7,-2
215637,The Restaurant School at Walnut Hill College,2013,"All students, Undergraduate, Other degree/certifcate-seeking, Continuing",78,41,37,-2
215655,Robert Morris University,2013,All students total,5481,2926,2555,-2
215655,Robert Morris University,2013,"All students, Undergraduate total",4496,2435,2061,-2
215655,Robert Morris University,2013,"All students, Undergraduate, Degree/certificate-seeking total",4459,2425,2034,-2
215655,Robert Morris University,2013,"All students, Undergraduate, Degree/certificate-seeking, First-time",994,579,415,-2
215655,Robert Morris University,2013,"All students, Undergraduate, Other degree/certificate-seeking",3465,1846,1619,-2
215655,Robert Morris University,2013,"All students, Undergraduate, Other degree/certifcate-seeking, Transfer-ins",330,167,163,-2
215655,Robert Morris University,2013,"All students, Undergraduate, Other degree/certifcate-seeking, Continuing",3135,1679,1456,-2
215655,Robert Morris University,2013,"All students, Undergraduate, Non-degree/certificate-seeking",37,10,27,-2
215655,Robert Morris University,2013,"All students, Graduate",985,491,494,-2
215691,Rosemont College,2013,All students total,957,270,687,-2
215691,Rosemont College,2013,"All students, Undergraduate total",531,177,354,-2
215691,Rosemont College,2013,"All students, Undergraduate, Degree/certificate-seeking total",511,175,336,-2
215691,Rosemont College,2013,"All students, Undergraduate, Degree/certificate-seeking, First-time",112,41,71,-2
215691,Rosemont College,2013,"All students, Undergraduate, Other degree/certificate-seeking",399,134,265,-2
215691,Rosemont College,2013,"All students, Undergraduate, Other degree/certifcate-seeking, Transfer-ins",29,14,15,-2
215691,Rosemont College,2013,"All students, Undergraduate, Other degree/certifcate-seeking, Continuing",370,120,250,-2
215691,Rosemont College,2013,"All students, Undergraduate, Non-degree/certificate-seeking",20,2,18,-2
215691,Rosemont College,2013,"All students, Graduate",426,93,333,-2
215743,Saint Francis University,2013,All students total,2344,842,1502,-2
215743,Saint Francis University,2013,"All students, Undergraduate total",1694,645,1049,-2
215743,Saint Francis University,2013,"All students, Undergraduate, Degree/certificate-seeking total",1665,631,1034,-2
215743,Saint Francis University,2013,"All students, Undergraduate, Degree/certificate-seeking, First-time",403,157,246,-2
215743,Saint Francis University,2013,"All students, Undergraduate, Other degree/certificate-seeking",1262,474,788,-2
215743,Saint Francis University,2013,"All students, Undergraduate, Other degree/certifcate-seeking, Transfer-ins",1,1,0,-2
215743,Saint Francis University,2013,"All students, Undergraduate, Other degree/certifcate-seeking, Continuing",1261,473,788,-2
215743,Saint Francis University,2013,"All students, Undergraduate, Non-degree/certificate-seeking",29,14,15,-2
215743,Saint Francis University,2013,"All students, Graduate",650,197,453,-2
215770,Saint Joseph's University,2013,All students total,8954,3889,5065,-2
215770,Saint Joseph's University,2013,"All students, Undergraduate total",5374,2498,2876,-2
215770,Saint Joseph's University,2013,"All students, Undergraduate, Degree/certificate-seeking total",5265,2430,2835,-2
215770,Saint Joseph's University,2013,"All students, Undergraduate, Degree/certificate-seeking, First-time",1275,588,687,-2
215770,Saint Joseph's University,2013,"All students, Undergraduate, Other degree/certificate-seeking",3990,1842,2148,-2
215770,Saint Joseph's University,2013,"All students, Undergraduate, Other degree/certifcate-seeking, Transfer-ins",211,88,123,-2
215770,Saint Joseph's University,2013,"All students, Undergraduate, Other degree/certifcate-seeking, Continuing",3779,1754,2025,-2
215770,Saint Joseph's University,2013,"All students, Undergraduate, Non-degree/certificate-seeking",109,68,41,-2
215770,Saint Joseph's University,2013,"All students, Graduate",3580,1391,2189,-2
215798,Saint Vincent College,2013,All students total,1813,909,904,-2
215798,Saint Vincent College,2013,"All students, Undergraduate total",1596,822,774,-2
215798,Saint Vincent College,2013,"All students, Undergraduate, Degree/certificate-seeking total",1532,798,734,-2
215798,Saint Vincent College,2013,"All students, Undergraduate, Degree/certificate-seeking, First-time",472,234,238,-2
215798,Saint Vincent College,2013,"All students, Undergraduate, Other degree/certificate-seeking",1060,564,496,-2
215798,Saint Vincent College,2013,"All students, Undergraduate, Other degree/certifcate-seeking, Transfer-ins",43,28,15,-2
215798,Saint Vincent College,2013,"All students, Undergraduate, Other degree/certifcate-seeking, Continuing",1017,536,481,-2
215798,Saint Vincent College,2013,"All students, Undergraduate, Non-degree/certificate-seeking",64,24,40,-2
215798,Saint Vincent College,2013,"All students, Graduate",217,87,130,-2
215813,Saint Vincent Seminary,2013,All students total,56,55,1,-2
215813,Saint Vincent Seminary,2013,"All students, Graduate",56,55,1,-2
215929,University of Scranton,2013,All students total,5633,2444,3189,-2
215929,University of Scranton,2013,"All students, Undergraduate total",3942,1760,2182,-2
215929,University of Scranton,2013,"All students, Undergraduate, Degree/certificate-seeking total",3834,1705,2129,-2
215929,University of Scranton,2013,"All students, Undergraduate, Degree/certificate-seeking, First-time",881,348,533,-2
215929,University of Scranton,2013,"All students, Undergraduate, Other degree/certificate-seeking",2953,1357,1596,-2
215929,University of Scranton,2013,"All students, Undergraduate, Other degree/certifcate-seeking, Transfer-ins",102,46,56,-2
215929,University of Scranton,2013,"All students, Undergraduate, Other degree/certifcate-seeking, Continuing",2851,1311,1540,-2
215929,University of Scranton,2013,"All students, Undergraduate, Non-degree/certificate-seeking",108,55,53,-2
215929,University of Scranton,2013,"All students, Graduate",1691,684,1007,-2
215947,Seton Hill University,2013,All students total,2357,869,1488,-2
215947,Seton Hill University,2013,"All students, Undergraduate total",1958,731,1227,-2
215947,Seton Hill University,2013,"All students, Undergraduate, Degree/certificate-seeking total",1550,558,992,-2
215947,Seton Hill University,2013,"All students, Undergraduate, Degree/certificate-seeking, First-time",386,137,249,-2
215947,Seton Hill University,2013,"All students, Undergraduate, Other degree/certificate-seeking",1164,421,743,-2
215947,Seton Hill University,2013,"All students, Undergraduate, Other degree/certifcate-seeking, Transfer-ins",121,51,70,-2
215947,Seton Hill University,2013,"All students, Undergraduate, Other degree/certifcate-seeking, Continuing",1043,370,673,-2
215947,Seton Hill University,2013,"All students, Undergraduate, Non-degree/certificate-seeking",408,173,235,-2
215947,Seton Hill University,2013,"All students, Graduate",399,138,261,-2
216010,Shippensburg University of Pennsylvania,2013,All students total,7548,3700,3848,-2
216010,Shippensburg University of Pennsylvania,2013,"All students, Undergraduate total",6550,3299,3251,-2
216010,Shippensburg University of Pennsylvania,2013,"All students, Undergraduate, Degree/certificate-seeking total",6493,3269,3224,-2
216010,Shippensburg University of Pennsylvania,2013,"All students, Undergraduate, Degree/certificate-seeking, First-time",1522,775,747,-2
216010,Shippensburg University of Pennsylvania,2013,"All students, Undergraduate, Other degree/certificate-seeking",4971,2494,2477,-2
216010,Shippensburg University of Pennsylvania,2013,"All students, Undergraduate, Other degree/certifcate-seeking, Transfer-ins",387,197,190,-2
216010,Shippensburg University of Pennsylvania,2013,"All students, Undergraduate, Other degree/certifcate-seeking, Continuing",4584,2297,2287,-2
216010,Shippensburg University of Pennsylvania,2013,"All students, Undergraduate, Non-degree/certificate-seeking",57,30,27,-2
216010,Shippensburg University of Pennsylvania,2013,"All students, Graduate",998,401,597,-2
216038,Slippery Rock University of Pennsylvania,2013,All students total,8347,3529,4818,-2
216038,Slippery Rock University of Pennsylvania,2013,"All students, Undergraduate total",7595,3320,4275,-2
216038,Slippery Rock University of Pennsylvania,2013,"All students, Undergraduate, Degree/certificate-seeking total",7544,3295,4249,-2
216038,Slippery Rock University of Pennsylvania,2013,"All students, Undergraduate, Degree/certificate-seeking, First-time",1408,563,845,-2
216038,Slippery Rock University of Pennsylvania,2013,"All students, Undergraduate, Other degree/certificate-seeking",6136,2732,3404,-2
216038,Slippery Rock University of Pennsylvania,2013,"All students, Undergraduate, Other degree/certifcate-seeking, Transfer-ins",622,314,308,-2
216038,Slippery Rock University of Pennsylvania,2013,"All students, Undergraduate, Other degree/certifcate-seeking, Continuing",5514,2418,3096,-2
216038,Slippery Rock University of Pennsylvania,2013,"All students, Undergraduate, Non-degree/certificate-seeking",51,25,26,-2
216038,Slippery Rock University of Pennsylvania,2013,"All students, Graduate",752,209,543,-2
216047,Saint Charles Borromeo Seminary-Overbrook,2013,All students total,238,206,32,-2
216047,Saint Charles Borromeo Seminary-Overbrook,2013,"All students, Undergraduate total",84,78,6,-2
216047,Saint Charles Borromeo Seminary-Overbrook,2013,"All students, Undergraduate, Degree/certificate-seeking total",53,53,0,-2
216047,Saint Charles Borromeo Seminary-Overbrook,2013,"All students, Undergraduate, Degree/certificate-seeking, First-time",10,10,0,-2
216047,Saint Charles Borromeo Seminary-Overbrook,2013,"All students, Undergraduate, Other degree/certificate-seeking",43,43,0,-2
216047,Saint Charles Borromeo Seminary-Overbrook,2013,"All students, Undergraduate, Other degree/certifcate-seeking, Transfer-ins",8,8,0,-2
216047,Saint Charles Borromeo Seminary-Overbrook,2013,"All students, Undergraduate, Other degree/certifcate-seeking, Continuing",35,35,0,-2
216047,Saint Charles Borromeo Seminary-Overbrook,2013,"All students, Undergraduate, Non-degree/certificate-seeking",31,25,6,-2
216047,Saint Charles Borromeo Seminary-Overbrook,2013,"All students, Graduate",154,128,26,-2
216278,Susquehanna University,2013,All students total,2187,971,1216,-2
216278,Susquehanna University,2013,"All students, Undergraduate total",2187,971,1216,-2
216278,Susquehanna University,2013,"All students, Undergraduate, Degree/certificate-seeking total",2138,958,1180,-2
216278,Susquehanna University,2013,"All students, Undergraduate, Degree/certificate-seeking, First-time",589,260,329,-2
216278,Susquehanna University,2013,"All students, Undergraduate, Other degree/certificate-seeking",1549,698,851,-2
216278,Susquehanna University,2013,"All students, Undergraduate, Other degree/certifcate-seeking, Transfer-ins",30,17,13,-2
216278,Susquehanna University,2013,"All students, Undergraduate, Other degree/certifcate-seeking, Continuing",1519,681,838,-2
216278,Susquehanna University,2013,"All students, Undergraduate, Non-degree/certificate-seeking",49,13,36,-2
216287,Swarthmore College,2013,All students total,1534,753,781,-2
216287,Swarthmore College,2013,"All students, Undergraduate total",1534,753,781,-2
216287,Swarthmore College,2013,"All students, Undergraduate, Degree/certificate-seeking total",1524,750,774,-2
216287,Swarthmore College,2013,"All students, Undergraduate, Degree/certificate-seeking, First-time",388,194,194,-2
216287,Swarthmore College,2013,"All students, Undergraduate, Other degree/certificate-seeking",1136,556,580,-2
216287,Swarthmore College,2013,"All students, Undergraduate, Other degree/certifcate-seeking, Transfer-ins",11,6,5,-2
216287,Swarthmore College,2013,"All students, Undergraduate, Other degree/certifcate-seeking, Continuing",1125,550,575,-2
216287,Swarthmore College,2013,"All students, Undergraduate, Non-degree/certificate-seeking",10,3,7,-2
216311,Talmudical Yeshiva of Philadelphia,2013,All students total,124,124,0,-2
216311,Talmudical Yeshiva of Philadelphia,2013,"All students, Undergraduate total",124,124,0,-2
216311,Talmudical Yeshiva of Philadelphia,2013,"All students, Undergraduate, Degree/certificate-seeking total",124,124,0,-2
216311,Talmudical Yeshiva of Philadelphia,2013,"All students, Undergraduate, Degree/certificate-seeking, First-time",38,38,0,-2
216311,Talmudical Yeshiva of Philadelphia,2013,"All students, Undergraduate, Other degree/certificate-seeking",86,86,0,-2
216311,Talmudical Yeshiva of Philadelphia,2013,"All students, Undergraduate, Other degree/certifcate-seeking, Continuing",86,86,0,-2
216339,Temple University,2013,All students total,37270,17917,19353,-2
216339,Temple University,2013,"All students, Undergraduate total",28068,13811,14257,-2
216339,Temple University,2013,"All students, Undergraduate, Degree/certificate-seeking total",27511,13534,13977,-2
216339,Temple University,2013,"All students, Undergraduate, Degree/certificate-seeking, First-time",4390,2028,2362,-2
216339,Temple University,2013,"All students, Undergraduate, Other degree/certificate-seeking",23121,11506,11615,-2
216339,Temple University,2013,"All students, Undergraduate, Other degree/certifcate-seeking, Transfer-ins",2716,1378,1338,-2
216339,Temple University,2013,"All students, Undergraduate, Other degree/certifcate-seeking, Continuing",20405,10128,10277,-2
216339,Temple University,2013,"All students, Undergraduate, Non-degree/certificate-seeking",557,277,280,-2
216339,Temple University,2013,"All students, Graduate",9202,4106,5096,-2
216348,Theological Seminary of the Reformed Episcopal Church,2013,All students total,27,20,7,-2
216348,Theological Seminary of the Reformed Episcopal Church,2013,"All students, Graduate",27,20,7,-2
216357,Thiel College,2013,All students total,1100,549,551,-2
216357,Thiel College,2013,"All students, Undergraduate total",1100,549,551,-2
216357,Thiel College,2013,"All students, Undergraduate, Degree/certificate-seeking total",1045,541,504,-2
216357,Thiel College,2013,"All students, Undergraduate, Degree/certificate-seeking, First-time",303,155,148,-2
216357,Thiel College,2013,"All students, Undergraduate, Other degree/certificate-seeking",742,386,356,-2
216357,Thiel College,2013,"All students, Undergraduate, Other degree/certifcate-seeking, Transfer-ins",30,13,17,-2
216357,Thiel College,2013,"All students, Undergraduate, Other degree/certifcate-seeking, Continuing",712,373,339,-2
216357,Thiel College,2013,"All students, Undergraduate, Non-degree/certificate-seeking",55,8,47,-2
216366,Thomas Jefferson University,2013,All students total,3635,1170,2465,-2
216366,Thomas Jefferson University,2013,"All students, Undergraduate total",888,165,723,-2
216366,Thomas Jefferson University,2013,"All students, Undergraduate, Degree/certificate-seeking total",664,116,548,-2
216366,Thomas Jefferson University,2013,"All students, Undergraduate, Other degree/certificate-seeking",664,116,548,-2
216366,Thomas Jefferson University,2013,"All students, Undergraduate, Other degree/certifcate-seeking, Transfer-ins",392,74,318,-2
216366,Thomas Jefferson University,2013,"All students, Undergraduate, Other degree/certifcate-seeking, Continuing",272,42,230,-2
216366,Thomas Jefferson University,2013,"All students, Undergraduate, Non-degree/certificate-seeking",224,49,175,-2
216366,Thomas Jefferson University,2013,"All students, Graduate",2747,1005,1742,-2
216463,Trinity Episcopal School for Ministry,2013,All students total,154,102,52,-2
216463,Trinity Episcopal School for Ministry,2013,"All students, Graduate",154,102,52,-2
216524,Ursinus College,2013,All students total,1596,783,813,-2
216524,Ursinus College,2013,"All students, Undergraduate total",1596,783,813,-2
216524,Ursinus College,2013,"All students, Undergraduate, Degree/certificate-seeking total",1578,776,802,-2
216524,Ursinus College,2013,"All students, Undergraduate, Degree/certificate-seeking, First-time",425,208,217,-2
216524,Ursinus College,2013,"All students, Undergraduate, Other degree/certificate-seeking",1153,568,585,-2
216524,Ursinus College,2013,"All students, Undergraduate, Other degree/certifcate-seeking, Transfer-ins",8,7,1,-2
216524,Ursinus College,2013,"All students, Undergraduate, Other degree/certifcate-seeking, Continuing",1145,561,584,-2
216524,Ursinus College,2013,"All students, Undergraduate, Non-degree/certificate-seeking",18,7,11,-2
216542,Valley Forge Christian College,2013,All students total,1004,513,491,-2
216542,Valley Forge Christian College,2013,"All students, Undergraduate total",964,484,480,-2
216542,Valley Forge Christian College,2013,"All students, Undergraduate, Degree/certificate-seeking total",767,399,368,-2
216542,Valley Forge Christian College,2013,"All students, Undergraduate, Degree/certificate-seeking, First-time",134,65,69,-2
216542,Valley Forge Christian College,2013,"All students, Undergraduate, Other degree/certificate-seeking",633,334,299,-2
216542,Valley Forge Christian College,2013,"All students, Undergraduate, Other degree/certifcate-seeking, Transfer-ins",10,4,6,-2
216542,Valley Forge Christian College,2013,"All students, Undergraduate, Other degree/certifcate-seeking, Continuing",623,330,293,-2
216542,Valley Forge Christian College,2013,"All students, Undergraduate, Non-degree/certificate-seeking",197,85,112,-2
216542,Valley Forge Christian College,2013,"All students, Graduate",40,29,11,-2
216597,Villanova University,2013,All students total,10696,5236,5460,-2
216597,Villanova University,2013,"All students, Undergraduate total",7042,3415,3627,-2
216597,Villanova University,2013,"All students, Undergraduate, Degree/certificate-seeking total",6856,3319,3537,-2
216597,Villanova University,2013,"All students, Undergraduate, Degree/certificate-seeking, First-time",1660,794,866,-2
216597,Villanova University,2013,"All students, Undergraduate, Other degree/certificate-seeking",5196,2525,2671,-2
216597,Villanova University,2013,"All students, Undergraduate, Other degree/certifcate-seeking, Transfer-ins",115,34,81,-2
216597,Villanova University,2013,"All students, Undergraduate, Other degree/certifcate-seeking, Continuing",5081,2491,2590,-2
216597,Villanova University,2013,"All students, Undergraduate, Non-degree/certificate-seeking",186,96,90,-2
216597,Villanova University,2013,"All students, Graduate",3654,1821,1833,-2
216667,Washington & Jefferson College,2013,All students total,1328,654,674,-2
216667,Washington & Jefferson College,2013,"All students, Undergraduate total",1328,654,674,-2
216667,Washington & Jefferson College,2013,"All students, Undergraduate, Degree/certificate-seeking total",1300,641,659,-2
216667,Washington & Jefferson College,2013,"All students, Undergraduate, Degree/certificate-seeking, First-time",326,168,158,-2
216667,Washington & Jefferson College,2013,"All students, Undergraduate, Other degree/certificate-seeking",974,473,501,-2
216667,Washington & Jefferson College,2013,"All students, Undergraduate, Other degree/certifcate-seeking, Transfer-ins",11,6,5,-2
216667,Washington & Jefferson College,2013,"All students, Undergraduate, Other degree/certifcate-seeking, Continuing",963,467,496,-2
216667,Washington & Jefferson College,2013,"All students, Undergraduate, Non-degree/certificate-seeking",28,13,15,-2
216694,Waynesburg University,2013,All students total,2190,799,1391,-2
216694,Waynesburg University,2013,"All students, Undergraduate total",1598,618,980,-2
216694,Waynesburg University,2013,"All students, Undergraduate, Degree/certificate-seeking total",1559,613,946,-2
216694,Waynesburg University,2013,"All students, Undergraduate, Degree/certificate-seeking, First-time",407,170,237,-2
216694,Waynesburg University,2013,"All students, Undergraduate, Other degree/certificate-seeking",1152,443,709,-2
216694,Waynesburg University,2013,"All students, Undergraduate, Other degree/certifcate-seeking, Transfer-ins",41,15,26,-2
216694,Waynesburg University,2013,"All students, Undergraduate, Other degree/certifcate-seeking, Continuing",1111,428,683,-2
216694,Waynesburg University,2013,"All students, Undergraduate, Non-degree/certificate-seeking",39,5,34,-2
216694,Waynesburg University,2013,"All students, Graduate",592,181,411,-2
216764,West Chester University of Pennsylvania,2013,All students total,15845,6209,9636,-2
216764,West Chester University of Pennsylvania,2013,"All students, Undergraduate total",13711,5542,8169,-2
216764,West Chester University of Pennsylvania,2013,"All students, Undergraduate, Degree/certificate-seeking total",13456,5432,8024,-2
216764,West Chester University of Pennsylvania,2013,"All students, Undergraduate, Degree/certificate-seeking, First-time",2298,812,1486,-2
216764,West Chester University of Pennsylvania,2013,"All students, Undergraduate, Other degree/certificate-seeking",11158,4620,6538,-2
216764,West Chester University of Pennsylvania,2013,"All students, Undergraduate, Other degree/certifcate-seeking, Transfer-ins",1304,586,718,-2
216764,West Chester University of Pennsylvania,2013,"All students, Undergraduate, Other degree/certifcate-seeking, Continuing",9854,4034,5820,-2
216764,West Chester University of Pennsylvania,2013,"All students, Undergraduate, Non-degree/certificate-seeking",255,110,145,-2
216764,West Chester University of Pennsylvania,2013,"All students, Graduate",2134,667,1467,-2
216807,Westminster College,2013,All students total,1366,560,806,-2
216807,Westminster College,2013,"All students, Undergraduate total",1313,536,777,-2
216807,Westminster College,2013,"All students, Undergraduate, Degree/certificate-seeking total",1313,536,777,-2
216807,Westminster College,2013,"All students, Undergraduate, Degree/certificate-seeking, First-time",309,123,186,-2
216807,Westminster College,2013,"All students, Undergraduate, Other degree/certificate-seeking",1004,413,591,-2
216807,Westminster College,2013,"All students, Undergraduate, Other degree/certifcate-seeking, Continuing",1004,413,591,-2
216807,Westminster College,2013,"All students, Graduate",53,24,29,-2
216816,Westminster Theological Seminary,2013,All students total,588,454,134,-2
216816,Westminster Theological Seminary,2013,"All students, Graduate",588,454,134,-2
216852,Widener University-Main Campus,2013,All students total,5025,1948,3077,-2
216852,Widener University-Main Campus,2013,"All students, Undergraduate total",3424,1541,1883,-2
216852,Widener University-Main Campus,2013,"All students, Undergraduate, Degree/certificate-seeking total",3188,1431,1757,-2
216852,Widener University-Main Campus,2013,"All students, Undergraduate, Degree/certificate-seeking, First-time",828,415,413,-2
216852,Widener University-Main Campus,2013,"All students, Undergraduate, Other degree/certificate-seeking",2360,1016,1344,-2
216852,Widener University-Main Campus,2013,"All students, Undergraduate, Other degree/certifcate-seeking, Transfer-ins",152,61,91,-2
216852,Widener University-Main Campus,2013,"All students, Undergraduate, Other degree/certifcate-seeking, Continuing",2208,955,1253,-2
216852,Widener University-Main Campus,2013,"All students, Undergraduate, Non-degree/certificate-seeking",236,110,126,-2
216852,Widener University-Main Campus,2013,"All students, Graduate",1601,407,1194,-2
216931,Wilkes University,2013,All students total,4665,1970,2695,-2
216931,Wilkes University,2013,"All students, Undergraduate total",2388,1262,1126,-2
216931,Wilkes University,2013,"All students, Undergraduate, Degree/certificate-seeking total",2281,1206,1075,-2
216931,Wilkes University,2013,"All students, Undergraduate, Degree/certificate-seeking, First-time",586,306,280,-2
216931,Wilkes University,2013,"All students, Undergraduate, Other degree/certificate-seeking",1695,900,795,-2
216931,Wilkes University,2013,"All students, Undergraduate, Other degree/certifcate-seeking, Transfer-ins",166,90,76,-2
216931,Wilkes University,2013,"All students, Undergraduate, Other degree/certifcate-seeking, Continuing",1529,810,719,-2
216931,Wilkes University,2013,"All students, Undergraduate, Non-degree/certificate-seeking",107,56,51,-2
216931,Wilkes University,2013,"All students, Graduate",2277,708,1569,-2
217013,Wilson College,2013,All students total,662,80,582,-2
217013,Wilson College,2013,"All students, Undergraduate total",571,66,505,-2
217013,Wilson College,2013,"All students, Undergraduate, Degree/certificate-seeking total",468,34,434,-2
217013,Wilson College,2013,"All students, Undergraduate, Degree/certificate-seeking, First-time",71,2,69,-2
217013,Wilson College,2013,"All students, Undergraduate, Other degree/certificate-seeking",397,32,365,-2
217013,Wilson College,2013,"All students, Undergraduate, Other degree/certifcate-seeking, Transfer-ins",20,1,19,-2
217013,Wilson College,2013,"All students, Undergraduate, Other degree/certifcate-seeking, Continuing",377,31,346,-2
217013,Wilson College,2013,"All students, Undergraduate, Non-degree/certificate-seeking",103,32,71,-2
217013,Wilson College,2013,"All students, Graduate",91,14,77,-2
217040,Yeshivath Beth Moshe,2013,All students total,52,52,0,-2
217040,Yeshivath Beth Moshe,2013,"All students, Undergraduate total",52,52,0,-2
217040,Yeshivath Beth Moshe,2013,"All students, Undergraduate, Degree/certificate-seeking total",52,52,0,-2
217040,Yeshivath Beth Moshe,2013,"All students, Undergraduate, Degree/certificate-seeking, First-time",17,17,0,-2
217040,Yeshivath Beth Moshe,2013,"All students, Undergraduate, Other degree/certificate-seeking",35,35,0,-2
217040,Yeshivath Beth Moshe,2013,"All students, Undergraduate, Other degree/certifcate-seeking, Transfer-ins",1,1,0,-2
217040,Yeshivath Beth Moshe,2013,"All students, Undergraduate, Other degree/certifcate-seeking, Continuing",34,34,0,-2
217059,York College Pennsylvania,2013,All students total,5250,2356,2894,-2
217059,York College Pennsylvania,2013,"All students, Undergraduate total",5010,2265,2745,-2
217059,York College Pennsylvania,2013,"All students, Undergraduate, Degree/certificate-seeking total",4847,2191,2656,-2
217059,York College Pennsylvania,2013,"All students, Undergraduate, Degree/certificate-seeking, First-time",1071,496,575,-2
217059,York College Pennsylvania,2013,"All students, Undergraduate, Other degree/certificate-seeking",3776,1695,2081,-2
217059,York College Pennsylvania,2013,"All students, Undergraduate, Other degree/certifcate-seeking, Transfer-ins",236,101,135,-2
217059,York College Pennsylvania,2013,"All students, Undergraduate, Other degree/certifcate-seeking, Continuing",3540,1594,1946,-2
217059,York College Pennsylvania,2013,"All students, Undergraduate, Non-degree/certificate-seeking",163,74,89,-2
217059,York College Pennsylvania,2013,"All students, Graduate",240,91,149,-2
217156,Brown University,2013,All students total,8943,4347,4596,-2
217156,Brown University,2013,"All students, Undergraduate total",6455,3101,3354,-2
217156,Brown University,2013,"All students, Undergraduate, Degree/certificate-seeking total",6182,3002,3180,-2
217156,Brown University,2013,"All students, Undergraduate, Degree/certificate-seeking, First-time",1542,754,788,-2
217156,Brown University,2013,"All students, Undergraduate, Other degree/certificate-seeking",4640,2248,2392,-2
217156,Brown University,2013,"All students, Undergraduate, Other degree/certifcate-seeking, Transfer-ins",77,49,28,-2
217156,Brown University,2013,"All students, Undergraduate, Other degree/certifcate-seeking, Continuing",4563,2199,2364,-2
217156,Brown University,2013,"All students, Undergraduate, Non-degree/certificate-seeking",273,99,174,-2
217156,Brown University,2013,"All students, Graduate",2488,1246,1242,-2
217165,Bryant University,2013,All students total,3454,2014,1440,-2
217165,Bryant University,2013,"All students, Undergraduate total",3287,1922,1365,-2
217165,Bryant University,2013,"All students, Undergraduate, Degree/certificate-seeking total",3263,1910,1353,-2
217165,Bryant University,2013,"All students, Undergraduate, Degree/certificate-seeking, First-time",890,510,380,-2
217165,Bryant University,2013,"All students, Undergraduate, Other degree/certificate-seeking",2373,1400,973,-2
217165,Bryant University,2013,"All students, Undergraduate, Other degree/certifcate-seeking, Transfer-ins",91,56,35,-2
217165,Bryant University,2013,"All students, Undergraduate, Other degree/certifcate-seeking, Continuing",2282,1344,938,-2
217165,Bryant University,2013,"All students, Undergraduate, Non-degree/certificate-seeking",24,12,12,-2
217165,Bryant University,2013,"All students, Graduate",167,92,75,-2
217235,Johnson & Wales University-Providence,2013,All students total,10369,4321,6048,-2
217235,Johnson & Wales University-Providence,2013,"All students, Undergraduate total",9401,3943,5458,-2
217235,Johnson & Wales University-Providence,2013,"All students, Undergraduate, Degree/certificate-seeking total",9067,3763,5304,-2
217235,Johnson & Wales University-Providence,2013,"All students, Undergraduate, Degree/certificate-seeking, First-time",1995,743,1252,-2
217235,Johnson & Wales University-Providence,2013,"All students, Undergraduate, Other degree/certificate-seeking",7072,3020,4052,-2
217235,Johnson & Wales University-Providence,2013,"All students, Undergraduate, Other degree/certifcate-seeking, Transfer-ins",543,230,313,-2
217235,Johnson & Wales University-Providence,2013,"All students, Undergraduate, Other degree/certifcate-seeking, Continuing",6529,2790,3739,-2
217235,Johnson & Wales University-Providence,2013,"All students, Undergraduate, Non-degree/certificate-seeking",334,180,154,-2
217235,Johnson & Wales University-Providence,2013,"All students, Graduate",968,378,590,-2
217305,New England Institute of Technology,2013,All students total,2933,2010,923,-2
217305,New England Institute of Technology,2013,"All students, Undergraduate total",2860,1982,878,-2
217305,New England Institute of Technology,2013,"All students, Undergraduate, Degree/certificate-seeking total",2860,1982,878,-2
217305,New England Institute of Technology,2013,"All students, Undergraduate, Degree/certificate-seeking, First-time",498,393,105,-2
217305,New England Institute of Technology,2013,"All students, Undergraduate, Other degree/certificate-seeking",2362,1589,773,-2
217305,New England Institute of Technology,2013,"All students, Undergraduate, Other degree/certifcate-seeking, Transfer-ins",147,84,63,-2
217305,New England Institute of Technology,2013,"All students, Undergraduate, Other degree/certifcate-seeking, Continuing",2215,1505,710,-2
217305,New England Institute of Technology,2013,"All students, Graduate",73,28,45,-2
217402,Providence College,2013,All students total,4665,2026,2639,-2
217402,Providence College,2013,"All students, Undergraduate total",4135,1808,2327,-2
217402,Providence College,2013,"All students, Undergraduate, Degree/certificate-seeking total",3969,1743,2226,-2
217402,Providence College,2013,"All students, Undergraduate, Degree/certificate-seeking, First-time",1027,452,575,-2
217402,Providence College,2013,"All students, Undergraduate, Other degree/certificate-seeking",2942,1291,1651,-2
217402,Providence College,2013,"All students, Undergraduate, Other degree/certifcate-seeking, Transfer-ins",95,51,44,-2
217402,Providence College,2013,"All students, Undergraduate, Other degree/certifcate-seeking, Continuing",2847,1240,1607,-2
217402,Providence College,2013,"All students, Undergraduate, Non-degree/certificate-seeking",166,65,101,-2
217402,Providence College,2013,"All students, Graduate",530,218,312,-2
217420,Rhode Island College,2013,All students total,8700,2744,5956,-2
217420,Rhode Island College,2013,"All students, Undergraduate total",7505,2501,5004,-2
217420,Rhode Island College,2013,"All students, Undergraduate, Degree/certificate-seeking total",7253,2389,4864,-2
217420,Rhode Island College,2013,"All students, Undergraduate, Degree/certificate-seeking, First-time",1141,334,807,-2
217420,Rhode Island College,2013,"All students, Undergraduate, Other degree/certificate-seeking",6112,2055,4057,-2
217420,Rhode Island College,2013,"All students, Undergraduate, Other degree/certifcate-seeking, Transfer-ins",646,213,433,-2
217420,Rhode Island College,2013,"All students, Undergraduate, Other degree/certifcate-seeking, Continuing",5466,1842,3624,-2
217420,Rhode Island College,2013,"All students, Undergraduate, Non-degree/certificate-seeking",252,112,140,-2
217420,Rhode Island College,2013,"All students, Graduate",1195,243,952,-2
217484,University of Rhode Island,2013,All students total,16387,7455,8932,-2
217484,University of Rhode Island,2013,"All students, Undergraduate total",13354,6170,7184,-2
217484,University of Rhode Island,2013,"All students, Undergraduate, Degree/certificate-seeking total",13008,6008,7000,-2
217484,University of Rhode Island,2013,"All students, Undergraduate, Degree/certificate-seeking, First-time",2991,1320,1671,-2
217484,University of Rhode Island,2013,"All students, Undergraduate, Other degree/certificate-seeking",10017,4688,5329,-2
217484,University of Rhode Island,2013,"All students, Undergraduate, Other degree/certifcate-seeking, Transfer-ins",604,319,285,-2
217484,University of Rhode Island,2013,"All students, Undergraduate, Other degree/certifcate-seeking, Continuing",9413,4369,5044,-2
217484,University of Rhode Island,2013,"All students, Undergraduate, Non-degree/certificate-seeking",346,162,184,-2
217484,University of Rhode Island,2013,"All students, Graduate",3033,1285,1748,-2
217493,Rhode Island School of Design,2013,All students total,2420,837,1583,-2
217493,Rhode Island School of Design,2013,"All students, Undergraduate total",2005,687,1318,-2
217493,Rhode Island School of Design,2013,"All students, Undergraduate, Degree/certificate-seeking total",2005,687,1318,-2
217493,Rhode Island School of Design,2013,"All students, Undergraduate, Degree/certificate-seeking, First-time",455,144,311,-2
217493,Rhode Island School of Design,2013,"All students, Undergraduate, Other degree/certificate-seeking",1550,543,1007,-2
217493,Rhode Island School of Design,2013,"All students, Undergraduate, Other degree/certifcate-seeking, Transfer-ins",64,26,38,-2
217493,Rhode Island School of Design,2013,"All students, Undergraduate, Other degree/certifcate-seeking, Continuing",1486,517,969,-2
217493,Rhode Island School of Design,2013,"All students, Graduate",415,150,265,-2
217518,Roger Williams University,2013,All students total,4732,2369,2363,-2
217518,Roger Williams University,2013,"All students, Undergraduate total",4411,2225,2186,-2
217518,Roger Williams University,2013,"All students, Undergraduate, Degree/certificate-seeking total",4403,2222,2181,-2
217518,Roger Williams University,2013,"All students, Undergraduate, Degree/certificate-seeking, First-time",1116,496,620,-2
217518,Roger Williams University,2013,"All students, Undergraduate, Other degree/certificate-seeking",3287,1726,1561,-2
217518,Roger Williams University,2013,"All students, Undergraduate, Other degree/certifcate-seeking, Transfer-ins",182,91,91,-2
217518,Roger Williams University,2013,"All students, Undergraduate, Other degree/certifcate-seeking, Continuing",3105,1635,1470,-2
217518,Roger Williams University,2013,"All students, Undergraduate, Non-degree/certificate-seeking",8,3,5,-2
217518,Roger Williams University,2013,"All students, Graduate",321,144,177,-2
217536,Salve Regina University,2013,All students total,2603,824,1779,-2
217536,Salve Regina University,2013,"All students, Undergraduate total",2026,600,1426,-2
217536,Salve Regina University,2013,"All students, Undergraduate, Degree/certificate-seeking total",1989,583,1406,-2
217536,Salve Regina University,2013,"All students, Undergraduate, Degree/certificate-seeking, First-time",463,132,331,-2
217536,Salve Regina University,2013,"All students, Undergraduate, Other degree/certificate-seeking",1526,451,1075,-2
217536,Salve Regina University,2013,"All students, Undergraduate, Other degree/certifcate-seeking, Transfer-ins",41,18,23,-2
217536,Salve Regina University,2013,"All students, Undergraduate, Other degree/certifcate-seeking, Continuing",1485,433,1052,-2
217536,Salve Regina University,2013,"All students, Undergraduate, Non-degree/certificate-seeking",37,17,20,-2
217536,Salve Regina University,2013,"All students, Graduate",577,224,353,-2
217606,Northpoint Bible College,2013,All students total,409,229,180,-2
217606,Northpoint Bible College,2013,"All students, Undergraduate total",396,223,173,-2
217606,Northpoint Bible College,2013,"All students, Undergraduate, Degree/certificate-seeking total",358,212,146,-2
217606,Northpoint Bible College,2013,"All students, Undergraduate, Degree/certificate-seeking, First-time",45,25,20,-2
217606,Northpoint Bible College,2013,"All students, Undergraduate, Other degree/certificate-seeking",313,187,126,-2
217606,Northpoint Bible College,2013,"All students, Undergraduate, Other degree/certifcate-seeking, Transfer-ins",63,39,24,-2
217606,Northpoint Bible College,2013,"All students, Undergraduate, Other degree/certifcate-seeking, Continuing",250,148,102,-2
217606,Northpoint Bible College,2013,"All students, Undergraduate, Non-degree/certificate-seeking",38,11,27,-2
217606,Northpoint Bible College,2013,"All students, Graduate",13,6,7,-2
230047,Brigham Young University-Hawaii,2013,All students total,2882,1271,1611,-2
230047,Brigham Young University-Hawaii,2013,"All students, Undergraduate total",2882,1271,1611,-2
230047,Brigham Young University-Hawaii,2013,"All students, Undergraduate, Degree/certificate-seeking total",2664,1176,1488,-2
230047,Brigham Young University-Hawaii,2013,"All students, Undergraduate, Degree/certificate-seeking, First-time",515,140,375,-2
230047,Brigham Young University-Hawaii,2013,"All students, Undergraduate, Other degree/certificate-seeking",2149,1036,1113,-2
230047,Brigham Young University-Hawaii,2013,"All students, Undergraduate, Other degree/certifcate-seeking, Transfer-ins",176,93,83,-2
230047,Brigham Young University-Hawaii,2013,"All students, Undergraduate, Other degree/certifcate-seeking, Continuing",1973,943,1030,-2
230047,Brigham Young University-Hawaii,2013,"All students, Undergraduate, Non-degree/certificate-seeking",218,95,123,-2
230816,Bennington College,2013,All students total,738,240,498,-2
230816,Bennington College,2013,"All students, Undergraduate total",619,218,401,-2
230816,Bennington College,2013,"All students, Undergraduate, Degree/certificate-seeking total",613,216,397,-2
230816,Bennington College,2013,"All students, Undergraduate, Degree/certificate-seeking, First-time",140,41,99,-2
230816,Bennington College,2013,"All students, Undergraduate, Other degree/certificate-seeking",473,175,298,-2
230816,Bennington College,2013,"All students, Undergraduate, Other degree/certifcate-seeking, Transfer-ins",16,6,10,-2
230816,Bennington College,2013,"All students, Undergraduate, Other degree/certifcate-seeking, Continuing",457,169,288,-2
230816,Bennington College,2013,"All students, Undergraduate, Non-degree/certificate-seeking",6,2,4,-2
230816,Bennington College,2013,"All students, Graduate",119,22,97,-2
230825,Burlington College,2013,All students total,243,121,122,-2
230825,Burlington College,2013,"All students, Undergraduate total",220,114,106,-2
230825,Burlington College,2013,"All students, Undergraduate, Degree/certificate-seeking total",199,106,93,-2
230825,Burlington College,2013,"All students, Undergraduate, Degree/certificate-seeking, First-time",45,28,17,-2
230825,Burlington College,2013,"All students, Undergraduate, Other degree/certificate-seeking",154,78,76,-2
230825,Burlington College,2013,"All students, Undergraduate, Other degree/certifcate-seeking, Transfer-ins",28,19,9,-2
230825,Burlington College,2013,"All students, Undergraduate, Other degree/certifcate-seeking, Continuing",126,59,67,-2
230825,Burlington College,2013,"All students, Undergraduate, Non-degree/certificate-seeking",21,8,13,-2
230825,Burlington College,2013,"All students, Graduate",23,7,16,-2
230834,Castleton State College,2013,All students total,2175,1028,1147,-2
230834,Castleton State College,2013,"All students, Undergraduate total",2068,996,1072,-2
230834,Castleton State College,2013,"All students, Undergraduate, Degree/certificate-seeking total",2022,973,1049,-2
230834,Castleton State College,2013,"All students, Undergraduate, Degree/certificate-seeking, First-time",480,261,219,-2
230834,Castleton State College,2013,"All students, Undergraduate, Other degree/certificate-seeking",1542,712,830,-2
230834,Castleton State College,2013,"All students, Undergraduate, Other degree/certifcate-seeking, Transfer-ins",144,54,90,-2
230834,Castleton State College,2013,"All students, Undergraduate, Other degree/certifcate-seeking, Continuing",1398,658,740,-2
230834,Castleton State College,2013,"All students, Undergraduate, Non-degree/certificate-seeking",46,23,23,-2
230834,Castleton State College,2013,"All students, Graduate",107,32,75,-2
230852,Champlain College,2013,All students total,3305,1891,1414,-2
230852,Champlain College,2013,"All students, Undergraduate total",2898,1733,1165,-2
230852,Champlain College,2013,"All students, Undergraduate, Degree/certificate-seeking total",2851,1708,1143,-2
230852,Champlain College,2013,"All students, Undergraduate, Degree/certificate-seeking, First-time",594,361,233,-2
230852,Champlain College,2013,"All students, Undergraduate, Other degree/certificate-seeking",2257,1347,910,-2
230852,Champlain College,2013,"All students, Undergraduate, Other degree/certifcate-seeking, Transfer-ins",202,121,81,-2
230852,Champlain College,2013,"All students, Undergraduate, Other degree/certifcate-seeking, Continuing",2055,1226,829,-2
230852,Champlain College,2013,"All students, Undergraduate, Non-degree/certificate-seeking",47,25,22,-2
230852,Champlain College,2013,"All students, Graduate",407,158,249,-2
230889,Goddard College,2013,All students total,592,181,411,-2
230889,Goddard College,2013,"All students, Undergraduate total",209,73,136,-2
230889,Goddard College,2013,"All students, Undergraduate, Degree/certificate-seeking total",201,73,128,-2
230889,Goddard College,2013,"All students, Undergraduate, Degree/certificate-seeking, First-time",2,1,1,-2
230889,Goddard College,2013,"All students, Undergraduate, Other degree/certificate-seeking",199,72,127,-2
230889,Goddard College,2013,"All students, Undergraduate, Other degree/certifcate-seeking, Transfer-ins",53,16,37,-2
230889,Goddard College,2013,"All students, Undergraduate, Other degree/certifcate-seeking, Continuing",146,56,90,-2
230889,Goddard College,2013,"All students, Undergraduate, Non-degree/certificate-seeking",8,0,8,-2
230889,Goddard College,2013,"All students, Graduate",383,108,275,-2
230898,Green Mountain College,2013,All students total,840,349,491,-2
230898,Green Mountain College,2013,"All students, Undergraduate total",590,264,326,-2
230898,Green Mountain College,2013,"All students, Undergraduate, Degree/certificate-seeking total",578,258,320,-2
230898,Green Mountain College,2013,"All students, Undergraduate, Degree/certificate-seeking, First-time",135,59,76,-2
230898,Green Mountain College,2013,"All students, Undergraduate, Other degree/certificate-seeking",443,199,244,-2
230898,Green Mountain College,2013,"All students, Undergraduate, Other degree/certifcate-seeking, Transfer-ins",49,21,28,-2
230898,Green Mountain College,2013,"All students, Undergraduate, Other degree/certifcate-seeking, Continuing",394,178,216,-2
230898,Green Mountain College,2013,"All students, Undergraduate, Non-degree/certificate-seeking",12,6,6,-2
230898,Green Mountain College,2013,"All students, Graduate",250,85,165,-2
230913,Johnson State College,2013,All students total,1692,572,1120,-2
230913,Johnson State College,2013,"All students, Undergraduate total",1486,529,957,-2
230913,Johnson State College,2013,"All students, Undergraduate, Degree/certificate-seeking total",1433,508,925,-2
230913,Johnson State College,2013,"All students, Undergraduate, Degree/certificate-seeking, First-time",225,92,133,-2
230913,Johnson State College,2013,"All students, Undergraduate, Other degree/certificate-seeking",1208,416,792,-2
230913,Johnson State College,2013,"All students, Undergraduate, Other degree/certifcate-seeking, Transfer-ins",147,42,105,-2
230913,Johnson State College,2013,"All students, Undergraduate, Other degree/certifcate-seeking, Continuing",1061,374,687,-2
230913,Johnson State College,2013,"All students, Undergraduate, Non-degree/certificate-seeking",53,21,32,-2
230913,Johnson State College,2013,"All students, Graduate",206,43,163,-2
230931,Lyndon State College,2013,All students total,1519,806,713,-2
230931,Lyndon State College,2013,"All students, Undergraduate total",1415,793,622,-2
230931,Lyndon State College,2013,"All students, Undergraduate, Degree/certificate-seeking total",1363,780,583,-2
230931,Lyndon State College,2013,"All students, Undergraduate, Degree/certificate-seeking, First-time",365,222,143,-2
230931,Lyndon State College,2013,"All students, Undergraduate, Other degree/certificate-seeking",998,558,440,-2
230931,Lyndon State College,2013,"All students, Undergraduate, Other degree/certifcate-seeking, Transfer-ins",77,46,31,-2
230931,Lyndon State College,2013,"All students, Undergraduate, Other degree/certifcate-seeking, Continuing",921,512,409,-2
230931,Lyndon State College,2013,"All students, Undergraduate, Non-degree/certificate-seeking",52,13,39,-2
230931,Lyndon State College,2013,"All students, Graduate",104,13,91,-2
230940,Marlboro College,2013,All students total,260,132,128,-2
230940,Marlboro College,2013,"All students, Undergraduate total",260,132,128,-2
230940,Marlboro College,2013,"All students, Undergraduate, Degree/certificate-seeking total",230,123,107,-2
230940,Marlboro College,2013,"All students, Undergraduate, Degree/certificate-seeking, First-time",45,27,18,-2
230940,Marlboro College,2013,"All students, Undergraduate, Other degree/certificate-seeking",185,96,89,-2
230940,Marlboro College,2013,"All students, Undergraduate, Other degree/certifcate-seeking, Transfer-ins",16,11,5,-2
230940,Marlboro College,2013,"All students, Undergraduate, Other degree/certifcate-seeking, Continuing",169,85,84,-2
230940,Marlboro College,2013,"All students, Undergraduate, Non-degree/certificate-seeking",30,9,21,-2
230959,Middlebury College,2013,All students total,2495,1219,1276,-2
230959,Middlebury College,2013,"All students, Undergraduate total",2495,1219,1276,-2
230959,Middlebury College,2013,"All students, Undergraduate, Degree/certificate-seeking total",2466,1212,1254,-2
230959,Middlebury College,2013,"All students, Undergraduate, Degree/certificate-seeking, First-time",625,311,314,-2
230959,Middlebury College,2013,"All students, Undergraduate, Other degree/certificate-seeking",1841,901,940,-2
230959,Middlebury College,2013,"All students, Undergraduate, Other degree/certifcate-seeking, Transfer-ins",1,0,1,-2
230959,Middlebury College,2013,"All students, Undergraduate, Other degree/certifcate-seeking, Continuing",1840,901,939,-2
230959,Middlebury College,2013,"All students, Undergraduate, Non-degree/certificate-seeking",29,7,22,-2
230977,New England Culinary Institute,2013,All students total,462,255,207,-2
230977,New England Culinary Institute,2013,"All students, Undergraduate total",462,255,207,-2
230977,New England Culinary Institute,2013,"All students, Undergraduate, Degree/certificate-seeking total",425,235,190,-2
230977,New England Culinary Institute,2013,"All students, Undergraduate, Degree/certificate-seeking, First-time",79,39,40,-2
230977,New England Culinary Institute,2013,"All students, Undergraduate, Other degree/certificate-seeking",346,196,150,-2
230977,New England Culinary Institute,2013,"All students, Undergraduate, Other degree/certifcate-seeking, Transfer-ins",43,26,17,-2
230977,New England Culinary Institute,2013,"All students, Undergraduate, Other degree/certifcate-seeking, Continuing",303,170,133,-2
230977,New England Culinary Institute,2013,"All students, Undergraduate, Non-degree/certificate-seeking",37,20,17,-2
230995,Norwich University,2013,All students total,3417,2426,991,-2
230995,Norwich University,2013,"All students, Undergraduate total",2456,1776,680,-2
230995,Norwich University,2013,"All students, Undergraduate, Degree/certificate-seeking total",2432,1759,673,-2
230995,Norwich University,2013,"All students, Undergraduate, Degree/certificate-seeking, First-time",590,438,152,-2
230995,Norwich University,2013,"All students, Undergraduate, Other degree/certificate-seeking",1842,1321,521,-2
230995,Norwich University,2013,"All students, Undergraduate, Other degree/certifcate-seeking, Transfer-ins",68,40,28,-2
230995,Norwich University,2013,"All students, Undergraduate, Other degree/certifcate-seeking, Continuing",1774,1281,493,-2
230995,Norwich University,2013,"All students, Undergraduate, Non-degree/certificate-seeking",24,17,7,-2
230995,Norwich University,2013,"All students, Graduate",961,650,311,-2
231059,Saint Michael's College,2013,All students total,2378,1020,1358,-2
231059,Saint Michael's College,2013,"All students, Undergraduate total",1998,908,1090,-2
231059,Saint Michael's College,2013,"All students, Undergraduate, Degree/certificate-seeking total",1941,873,1068,-2
231059,Saint Michael's College,2013,"All students, Undergraduate, Degree/certificate-seeking, First-time",506,225,281,-2
231059,Saint Michael's College,2013,"All students, Undergraduate, Other degree/certificate-seeking",1435,648,787,-2
231059,Saint Michael's College,2013,"All students, Undergraduate, Other degree/certifcate-seeking, Transfer-ins",31,14,17,-2
231059,Saint Michael's College,2013,"All students, Undergraduate, Other degree/certifcate-seeking, Continuing",1404,634,770,-2
231059,Saint Michael's College,2013,"All students, Undergraduate, Non-degree/certificate-seeking",57,35,22,-2
231059,Saint Michael's College,2013,"All students, Graduate",380,112,268,-2
231068,SIT Graduate Institute,2013,All students total,443,132,311,-2
231068,SIT Graduate Institute,2013,"All students, Graduate",443,132,311,-2
231077,College of St Joseph,2013,All students total,271,110,161,-2
231077,College of St Joseph,2013,"All students, Undergraduate total",176,84,92,-2
231077,College of St Joseph,2013,"All students, Undergraduate, Degree/certificate-seeking total",158,75,83,-2
231077,College of St Joseph,2013,"All students, Undergraduate, Degree/certificate-seeking, First-time",33,13,20,-2
231077,College of St Joseph,2013,"All students, Undergraduate, Other degree/certificate-seeking",125,62,63,-2
231077,College of St Joseph,2013,"All students, Undergraduate, Other degree/certifcate-seeking, Transfer-ins",20,14,6,-2
231077,College of St Joseph,2013,"All students, Undergraduate, Other degree/certifcate-seeking, Continuing",105,48,57,-2
231077,College of St Joseph,2013,"All students, Undergraduate, Non-degree/certificate-seeking",18,9,9,-2
231077,College of St Joseph,2013,"All students, Graduate",95,26,69,-2
231086,Southern Vermont College,2013,All students total,480,184,296,-2
231086,Southern Vermont College,2013,"All students, Undergraduate total",480,184,296,-2
231086,Southern Vermont College,2013,"All students, Undergraduate, Degree/certificate-seeking total",470,179,291,-2
231086,Southern Vermont College,2013,"All students, Undergraduate, Degree/certificate-seeking, First-time",94,34,60,-2
231086,Southern Vermont College,2013,"All students, Undergraduate, Other degree/certificate-seeking",376,145,231,-2
231086,Southern Vermont College,2013,"All students, Undergraduate, Other degree/certifcate-seeking, Transfer-ins",38,10,28,-2
231086,Southern Vermont College,2013,"All students, Undergraduate, Other degree/certifcate-seeking, Continuing",338,135,203,-2
231086,Southern Vermont College,2013,"All students, Undergraduate, Non-degree/certificate-seeking",10,5,5,-2
231095,Sterling College,2013,All students total,116,60,56,-2
231095,Sterling College,2013,"All students, Undergraduate total",116,60,56,-2
231095,Sterling College,2013,"All students, Undergraduate, Degree/certificate-seeking total",114,59,55,-2
231095,Sterling College,2013,"All students, Undergraduate, Degree/certificate-seeking, First-time",18,9,9,-2
231095,Sterling College,2013,"All students, Undergraduate, Other degree/certificate-seeking",96,50,46,-2
231095,Sterling College,2013,"All students, Undergraduate, Other degree/certifcate-seeking, Transfer-ins",32,13,19,-2
231095,Sterling College,2013,"All students, Undergraduate, Other degree/certifcate-seeking, Continuing",64,37,27,-2
231095,Sterling College,2013,"All students, Undergraduate, Non-degree/certificate-seeking",2,1,1,-2
231147,Vermont Law School,2013,All students total,675,292,383,-2
231147,Vermont Law School,2013,"All students, Graduate",675,292,383,-2
231156,Vermont State Colleges-Office of the Chancellor,2013,,,,,-2
231165,Vermont Technical College,2013,All students total,1543,899,644,-2
231165,Vermont Technical College,2013,"All students, Undergraduate total",1543,899,644,-2
231165,Vermont Technical College,2013,"All students, Undergraduate, Degree/certificate-seeking total",1361,764,597,-2
231165,Vermont Technical College,2013,"All students, Undergraduate, Degree/certificate-seeking, First-time",194,138,56,-2
231165,Vermont Technical College,2013,"All students, Undergraduate, Other degree/certificate-seeking",1167,626,541,-2
231165,Vermont Technical College,2013,"All students, Undergraduate, Other degree/certifcate-seeking, Transfer-ins",244,63,181,-2
231165,Vermont Technical College,2013,"All students, Undergraduate, Other degree/certifcate-seeking, Continuing",923,563,360,-2
231165,Vermont Technical College,2013,"All students, Undergraduate, Non-degree/certificate-seeking",182,135,47,-2
231174,University of Vermont,2013,All students total,12723,5550,7173,-2
231174,University of Vermont,2013,"All students, Undergraduate total",10912,4771,6141,-2
231174,University of Vermont,2013,"All students, Undergraduate, Degree/certificate-seeking total",9970,4388,5582,-2
231174,University of Vermont,2013,"All students, Undergraduate, Degree/certificate-seeking, First-time",2495,1087,1408,-2
231174,University of Vermont,2013,"All students, Undergraduate, Other degree/certificate-seeking",7475,3301,4174,-2
231174,University of Vermont,2013,"All students, Undergraduate, Other degree/certifcate-seeking, Transfer-ins",407,193,214,-2
231174,University of Vermont,2013,"All students, Undergraduate, Other degree/certifcate-seeking, Continuing",7068,3108,3960,-2
231174,University of Vermont,2013,"All students, Undergraduate, Non-degree/certificate-seeking",942,383,559,-2
231174,University of Vermont,2013,"All students, Graduate",1811,779,1032,-2
231420,Averett University,2013,All students total,906,451,455,-2
231420,Averett University,2013,"All students, Undergraduate total",877,439,438,-2
231420,Averett University,2013,"All students, Undergraduate, Degree/certificate-seeking total",870,435,435,-2
231420,Averett University,2013,"All students, Undergraduate, Degree/certificate-seeking, First-time",237,144,93,-2
231420,Averett University,2013,"All students, Undergraduate, Other degree/certificate-seeking",633,291,342,-2
231420,Averett University,2013,"All students, Undergraduate, Other degree/certifcate-seeking, Transfer-ins",91,35,56,-2
231420,Averett University,2013,"All students, Undergraduate, Other degree/certifcate-seeking, Continuing",542,256,286,-2
231420,Averett University,2013,"All students, Undergraduate, Non-degree/certificate-seeking",7,4,3,-2
231420,Averett University,2013,"All students, Graduate",29,12,17,-2
231554,Bluefield College,2013,All students total,842,376,466,-2
231554,Bluefield College,2013,"All students, Undergraduate total",837,375,462,-2
231554,Bluefield College,2013,"All students, Undergraduate, Degree/certificate-seeking total",821,369,452,-2
231554,Bluefield College,2013,"All students, Undergraduate, Degree/certificate-seeking, First-time",123,73,50,-2
231554,Bluefield College,2013,"All students, Undergraduate, Other degree/certificate-seeking",698,296,402,-2
231554,Bluefield College,2013,"All students, Undergraduate, Other degree/certifcate-seeking, Transfer-ins",193,84,109,-2
231554,Bluefield College,2013,"All students, Undergraduate, Other degree/certifcate-seeking, Continuing",505,212,293,-2
231554,Bluefield College,2013,"All students, Undergraduate, Non-degree/certificate-seeking",16,6,10,-2
231554,Bluefield College,2013,"All students, Graduate",5,1,4,-2
231581,Bridgewater College,2013,All students total,1848,834,1014,-2
231581,Bridgewater College,2013,"All students, Undergraduate total",1848,834,1014,-2
231581,Bridgewater College,2013,"All students, Undergraduate, Degree/certificate-seeking total",1822,821,1001,-2
231581,Bridgewater College,2013,"All students, Undergraduate, Degree/certificate-seeking, First-time",536,241,295,-2
231581,Bridgewater College,2013,"All students, Undergraduate, Other degree/certificate-seeking",1286,580,706,-2
231581,Bridgewater College,2013,"All students, Undergraduate, Other degree/certifcate-seeking, Transfer-ins",59,31,28,-2
231581,Bridgewater College,2013,"All students, Undergraduate, Other degree/certifcate-seeking, Continuing",1227,549,678,-2
231581,Bridgewater College,2013,"All students, Undergraduate, Non-degree/certificate-seeking",26,13,13,-2
231624,College of William and Mary,2013,All students total,8376,3789,4587,-2
231624,College of William and Mary,2013,"All students, Undergraduate total",6271,2814,3457,-2
231624,College of William and Mary,2013,"All students, Undergraduate, Degree/certificate-seeking total",6235,2799,3436,-2
231624,College of William and Mary,2013,"All students, Undergraduate, Degree/certificate-seeking, First-time",1479,652,827,-2
231624,College of William and Mary,2013,"All students, Undergraduate, Other degree/certificate-seeking",4756,2147,2609,-2
231624,College of William and Mary,2013,"All students, Undergraduate, Other degree/certifcate-seeking, Transfer-ins",185,79,106,-2
231624,College of William and Mary,2013,"All students, Undergraduate, Other degree/certifcate-seeking, Continuing",4571,2068,2503,-2
231624,College of William and Mary,2013,"All students, Undergraduate, Non-degree/certificate-seeking",36,15,21,-2
231624,College of William and Mary,2013,"All students, Graduate",2105,975,1130,-2
231651,Regent University,2013,All students total,5693,2303,3390,-2
231651,Regent University,2013,"All students, Undergraduate total",2400,940,1460,-2
231651,Regent University,2013,"All students, Undergraduate, Degree/certificate-seeking total",2286,902,1384,-2
231651,Regent University,2013,"All students, Undergraduate, Degree/certificate-seeking, First-time",230,88,142,-2
231651,Regent University,2013,"All students, Undergraduate, Other degree/certificate-seeking",2056,814,1242,-2
231651,Regent University,2013,"All students, Undergraduate, Other degree/certifcate-seeking, Transfer-ins",339,123,216,-2
231651,Regent University,2013,"All students, Undergraduate, Other degree/certifcate-seeking, Continuing",1717,691,1026,-2
231651,Regent University,2013,"All students, Undergraduate, Non-degree/certificate-seeking",114,38,76,-2
231651,Regent University,2013,"All students, Graduate",3293,1363,1930,-2
231712,Christopher Newport University,2013,All students total,5232,2248,2984,-2
231712,Christopher Newport University,2013,"All students, Undergraduate total",5094,2203,2891,-2
231712,Christopher Newport University,2013,"All students, Undergraduate, Degree/certificate-seeking total",5083,2198,2885,-2
231712,Christopher Newport University,2013,"All students, Undergraduate, Degree/certificate-seeking, First-time",1276,545,731,-2
231712,Christopher Newport University,2013,"All students, Undergraduate, Other degree/certificate-seeking",3807,1653,2154,-2
231712,Christopher Newport University,2013,"All students, Undergraduate, Other degree/certifcate-seeking, Transfer-ins",191,81,110,-2
231712,Christopher Newport University,2013,"All students, Undergraduate, Other degree/certifcate-seeking, Continuing",3616,1572,2044,-2
231712,Christopher Newport University,2013,"All students, Undergraduate, Non-degree/certificate-seeking",11,5,6,-2
231712,Christopher Newport University,2013,"All students, Graduate",138,45,93,-2
231785,Bryant & Stratton College-Virginia Beach,2013,All students total,728,161,567,-2
231785,Bryant & Stratton College-Virginia Beach,2013,"All students, Undergraduate total",728,161,567,-2
231785,Bryant & Stratton College-Virginia Beach,2013,"All students, Undergraduate, Degree/certificate-seeking total",728,161,567,-2
231785,Bryant & Stratton College-Virginia Beach,2013,"All students, Undergraduate, Degree/certificate-seeking, First-time",92,34,58,-2
231785,Bryant & Stratton College-Virginia Beach,2013,"All students, Undergraduate, Other degree/certificate-seeking",636,127,509,-2
231785,Bryant & Stratton College-Virginia Beach,2013,"All students, Undergraduate, Other degree/certifcate-seeking, Transfer-ins",128,30,98,-2
231785,Bryant & Stratton College-Virginia Beach,2013,"All students, Undergraduate, Other degree/certifcate-seeking, Continuing",508,97,411,-2
231828,Bryant & Stratton College-Richmond,2013,All students total,906,123,783,-2
231828,Bryant & Stratton College-Richmond,2013,"All students, Undergraduate total",906,123,783,-2
231828,Bryant & Stratton College-Richmond,2013,"All students, Undergraduate, Degree/certificate-seeking total",906,123,783,-2
231828,Bryant & Stratton College-Richmond,2013,"All students, Undergraduate, Degree/certificate-seeking, First-time",108,20,88,-2
231828,Bryant & Stratton College-Richmond,2013,"All students, Undergraduate, Other degree/certificate-seeking",798,103,695,-2
231828,Bryant & Stratton College-Richmond,2013,"All students, Undergraduate, Other degree/certifcate-seeking, Transfer-ins",196,17,179,-2
231828,Bryant & Stratton College-Richmond,2013,"All students, Undergraduate, Other degree/certifcate-seeking, Continuing",602,86,516,-2
231837,Jefferson College of Health Sciences,2013,All students total,1039,203,836,-2
231837,Jefferson College of Health Sciences,2013,"All students, Undergraduate total",813,155,658,-2
231837,Jefferson College of Health Sciences,2013,"All students, Undergraduate, Degree/certificate-seeking total",810,155,655,-2
231837,Jefferson College of Health Sciences,2013,"All students, Undergraduate, Degree/certificate-seeking, First-time",66,15,51,-2
231837,Jefferson College of Health Sciences,2013,"All students, Undergraduate, Other degree/certificate-seeking",744,140,604,-2
231837,Jefferson College of Health Sciences,2013,"All students, Undergraduate, Other degree/certifcate-seeking, Transfer-ins",182,38,144,-2
231837,Jefferson College of Health Sciences,2013,"All students, Undergraduate, Other degree/certifcate-seeking, Continuing",562,102,460,-2
231837,Jefferson College of Health Sciences,2013,"All students, Undergraduate, Non-degree/certificate-seeking",3,0,3,-2
231837,Jefferson College of Health Sciences,2013,"All students, Graduate",226,48,178,-2
231970,Eastern Virginia Medical School,2013,All students total,1017,439,578,-2
231970,Eastern Virginia Medical School,2013,"All students, Graduate",1017,439,578,-2
232016,Centura College-Virginia Beach,2013,All students total,477,84,393,-2
232016,Centura College-Virginia Beach,2013,"All students, Undergraduate total",477,84,393,-2
232016,Centura College-Virginia Beach,2013,"All students, Undergraduate, Degree/certificate-seeking total",477,84,393,-2
232016,Centura College-Virginia Beach,2013,"All students, Undergraduate, Degree/certificate-seeking, First-time",24,4,20,-2
232016,Centura College-Virginia Beach,2013,"All students, Undergraduate, Other degree/certificate-seeking",453,80,373,-2
232016,Centura College-Virginia Beach,2013,"All students, Undergraduate, Other degree/certifcate-seeking, Continuing",453,80,373,-2
232025,Emory & Henry College,2013,All students total,959,490,469,-2
232025,Emory & Henry College,2013,"All students, Undergraduate total",936,484,452,-2
232025,Emory & Henry College,2013,"All students, Undergraduate, Degree/certificate-seeking total",907,472,435,-2
232025,Emory & Henry College,2013,"All students, Undergraduate, Degree/certificate-seeking, First-time",267,149,118,-2
232025,Emory & Henry College,2013,"All students, Undergraduate, Other degree/certificate-seeking",640,323,317,-2
232025,Emory & Henry College,2013,"All students, Undergraduate, Other degree/certifcate-seeking, Transfer-ins",50,22,28,-2
232025,Emory & Henry College,2013,"All students, Undergraduate, Other degree/certifcate-seeking, Continuing",590,301,289,-2
232025,Emory & Henry College,2013,"All students, Undergraduate, Non-degree/certificate-seeking",29,12,17,-2
232025,Emory & Henry College,2013,"All students, Graduate",23,6,17,-2
232043,Eastern Mennonite University,2013,All students total,1640,570,1070,-2
232043,Eastern Mennonite University,2013,"All students, Undergraduate total",1184,415,769,-2
232043,Eastern Mennonite University,2013,"All students, Undergraduate, Degree/certificate-seeking total",1148,389,759,-2
232043,Eastern Mennonite University,2013,"All students, Undergraduate, Degree/certificate-seeking, First-time",232,106,126,-2
232043,Eastern Mennonite University,2013,"All students, Undergraduate, Other degree/certificate-seeking",916,283,633,-2
232043,Eastern Mennonite University,2013,"All students, Undergraduate, Other degree/certifcate-seeking, Transfer-ins",157,35,122,-2
232043,Eastern Mennonite University,2013,"All students, Undergraduate, Other degree/certifcate-seeking, Continuing",759,248,511,-2
232043,Eastern Mennonite University,2013,"All students, Undergraduate, Non-degree/certificate-seeking",36,26,10,-2
232043,Eastern Mennonite University,2013,"All students, Graduate",456,155,301,-2
232089,Ferrum College,2013,All students total,1512,857,655,-2
232089,Ferrum College,2013,"All students, Undergraduate total",1512,857,655,-2
232089,Ferrum College,2013,"All students, Undergraduate, Degree/certificate-seeking total",1506,855,651,-2
232089,Ferrum College,2013,"All students, Undergraduate, Degree/certificate-seeking, First-time",554,349,205,-2
232089,Ferrum College,2013,"All students, Undergraduate, Other degree/certificate-seeking",952,506,446,-2
232089,Ferrum College,2013,"All students, Undergraduate, Other degree/certifcate-seeking, Transfer-ins",67,42,25,-2
232089,Ferrum College,2013,"All students, Undergraduate, Other degree/certifcate-seeking, Continuing",885,464,421,-2
232089,Ferrum College,2013,"All students, Undergraduate, Non-degree/certificate-seeking",6,2,4,-2
232186,George Mason University,2013,All students total,33917,15601,18316,-2
232186,George Mason University,2013,"All students, Undergraduate total",21990,10663,11327,-2
232186,George Mason University,2013,"All students, Undergraduate, Degree/certificate-seeking total",21324,10355,10969,-2
232186,George Mason University,2013,"All students, Undergraduate, Degree/certificate-seeking, First-time",3011,1420,1591,-2
232186,George Mason University,2013,"All students, Undergraduate, Other degree/certificate-seeking",18313,8935,9378,-2
232186,George Mason University,2013,"All students, Undergraduate, Other degree/certifcate-seeking, Transfer-ins",2659,1213,1446,-2
232186,George Mason University,2013,"All students, Undergraduate, Other degree/certifcate-seeking, Continuing",15654,7722,7932,-2
232186,George Mason University,2013,"All students, Undergraduate, Non-degree/certificate-seeking",666,308,358,-2
232186,George Mason University,2013,"All students, Graduate",11927,4938,6989,-2
232256,Hampden-Sydney College,2013,All students total,1070,1069,1,-2
232256,Hampden-Sydney College,2013,"All students, Undergraduate total",1070,1069,1,-2
232256,Hampden-Sydney College,2013,"All students, Undergraduate, Degree/certificate-seeking total",1070,1069,1,-2
232256,Hampden-Sydney College,2013,"All students, Undergraduate, Degree/certificate-seeking, First-time",292,292,0,-2
232256,Hampden-Sydney College,2013,"All students, Undergraduate, Other degree/certificate-seeking",778,777,1,-2
232256,Hampden-Sydney College,2013,"All students, Undergraduate, Other degree/certifcate-seeking, Transfer-ins",16,16,0,-2
232256,Hampden-Sydney College,2013,"All students, Undergraduate, Other degree/certifcate-seeking, Continuing",762,761,1,-2
232265,Hampton University,2013,All students total,4622,1652,2970,-2
232265,Hampton University,2013,"All students, Undergraduate total",3742,1362,2380,-2
232265,Hampton University,2013,"All students, Undergraduate, Degree/certificate-seeking total",3529,1270,2259,-2
232265,Hampton University,2013,"All students, Undergraduate, Degree/certificate-seeking, First-time",1004,325,679,-2
232265,Hampton University,2013,"All students, Undergraduate, Other degree/certificate-seeking",2525,945,1580,-2
232265,Hampton University,2013,"All students, Undergraduate, Other degree/certifcate-seeking, Transfer-ins",177,84,93,-2
232265,Hampton University,2013,"All students, Undergraduate, Other degree/certifcate-seeking, Continuing",2348,861,1487,-2
232265,Hampton University,2013,"All students, Undergraduate, Non-degree/certificate-seeking",213,92,121,-2
232265,Hampton University,2013,"All students, Graduate",880,290,590,-2
232308,Hollins University,2013,All students total,750,38,712,-2
232308,Hollins University,2013,"All students, Undergraduate total",580,4,576,-2
232308,Hollins University,2013,"All students, Undergraduate, Degree/certificate-seeking total",568,0,568,-2
232308,Hollins University,2013,"All students, Undergraduate, Degree/certificate-seeking, First-time",146,0,146,-2
232308,Hollins University,2013,"All students, Undergraduate, Other degree/certificate-seeking",422,0,422,-2
232308,Hollins University,2013,"All students, Undergraduate, Other degree/certifcate-seeking, Transfer-ins",39,0,39,-2
232308,Hollins University,2013,"All students, Undergraduate, Other degree/certifcate-seeking, Continuing",383,0,383,-2
232308,Hollins University,2013,"All students, Undergraduate, Non-degree/certificate-seeking",12,4,8,-2
232308,Hollins University,2013,"All students, Graduate",170,34,136,-2
232423,James Madison University,2013,All students total,20181,8063,12118,-2
232423,James Madison University,2013,"All students, Undergraduate total",18431,7526,10905,-2
232423,James Madison University,2013,"All students, Undergraduate, Degree/certificate-seeking total",18127,7380,10747,-2
232423,James Madison University,2013,"All students, Undergraduate, Degree/certificate-seeking, First-time",4202,1588,2614,-2
232423,James Madison University,2013,"All students, Undergraduate, Other degree/certificate-seeking",13925,5792,8133,-2
232423,James Madison University,2013,"All students, Undergraduate, Other degree/certifcate-seeking, Transfer-ins",621,302,319,-2
232423,James Madison University,2013,"All students, Undergraduate, Other degree/certifcate-seeking, Continuing",13304,5490,7814,-2
232423,James Madison University,2013,"All students, Undergraduate, Non-degree/certificate-seeking",304,146,158,-2
232423,James Madison University,2013,"All students, Graduate",1750,537,1213,-2
232557,Liberty University,2013,All students total,77338,31395,45943,-2
232557,Liberty University,2013,"All students, Undergraduate total",47464,19572,27892,-2
232557,Liberty University,2013,"All students, Undergraduate, Degree/certificate-seeking total",47079,19379,27700,-2
232557,Liberty University,2013,"All students, Undergraduate, Degree/certificate-seeking, First-time",4686,2018,2668,-2
232557,Liberty University,2013,"All students, Undergraduate, Other degree/certificate-seeking",42393,17361,25032,-2
232557,Liberty University,2013,"All students, Undergraduate, Other degree/certifcate-seeking, Transfer-ins",6469,2388,4081,-2
232557,Liberty University,2013,"All students, Undergraduate, Other degree/certifcate-seeking, Continuing",35924,14973,20951,-2
232557,Liberty University,2013,"All students, Undergraduate, Non-degree/certificate-seeking",385,193,192,-2
232557,Liberty University,2013,"All students, Graduate",29874,11823,18051,-2
232566,Longwood University,2013,All students total,4960,1591,3369,-2
232566,Longwood University,2013,"All students, Undergraduate total",4497,1534,2963,-2
232566,Longwood University,2013,"All students, Undergraduate, Degree/certificate-seeking total",4357,1494,2863,-2
232566,Longwood University,2013,"All students, Undergraduate, Degree/certificate-seeking, First-time",1106,368,738,-2
232566,Longwood University,2013,"All students, Undergraduate, Other degree/certificate-seeking",3251,1126,2125,-2
232566,Longwood University,2013,"All students, Undergraduate, Other degree/certifcate-seeking, Transfer-ins",214,89,125,-2
232566,Longwood University,2013,"All students, Undergraduate, Other degree/certifcate-seeking, Continuing",3037,1037,2000,-2
232566,Longwood University,2013,"All students, Undergraduate, Non-degree/certificate-seeking",140,40,100,-2
232566,Longwood University,2013,"All students, Graduate",463,57,406,-2
232609,Lynchburg College,2013,All students total,2713,1065,1648,-2
232609,Lynchburg College,2013,"All students, Undergraduate total",2178,873,1305,-2
232609,Lynchburg College,2013,"All students, Undergraduate, Degree/certificate-seeking total",2140,864,1276,-2
232609,Lynchburg College,2013,"All students, Undergraduate, Degree/certificate-seeking, First-time",512,211,301,-2
232609,Lynchburg College,2013,"All students, Undergraduate, Other degree/certificate-seeking",1628,653,975,-2
232609,Lynchburg College,2013,"All students, Undergraduate, Other degree/certifcate-seeking, Transfer-ins",125,49,76,-2
232609,Lynchburg College,2013,"All students, Undergraduate, Other degree/certifcate-seeking, Continuing",1503,604,899,-2
232609,Lynchburg College,2013,"All students, Undergraduate, Non-degree/certificate-seeking",38,9,29,-2
232609,Lynchburg College,2013,"All students, Graduate",535,192,343,-2
232672,Mary Baldwin College,2013,All students total,1711,129,1582,-2
232672,Mary Baldwin College,2013,"All students, Undergraduate total",1441,92,1349,-2
232672,Mary Baldwin College,2013,"All students, Undergraduate, Degree/certificate-seeking total",1307,75,1232,-2
232672,Mary Baldwin College,2013,"All students, Undergraduate, Degree/certificate-seeking, First-time",217,0,217,-2
232672,Mary Baldwin College,2013,"All students, Undergraduate, Other degree/certificate-seeking",1090,75,1015,-2
232672,Mary Baldwin College,2013,"All students, Undergraduate, Other degree/certifcate-seeking, Transfer-ins",124,15,109,-2
232672,Mary Baldwin College,2013,"All students, Undergraduate, Other degree/certifcate-seeking, Continuing",966,60,906,-2
232672,Mary Baldwin College,2013,"All students, Undergraduate, Non-degree/certificate-seeking",134,17,117,-2
232672,Mary Baldwin College,2013,"All students, Graduate",270,37,233,-2
232681,University of Mary Washington,2013,All students total,4831,1709,3122,-2
232681,University of Mary Washington,2013,"All students, Undergraduate total",4383,1568,2815,-2
232681,University of Mary Washington,2013,"All students, Undergraduate, Degree/certificate-seeking total",4303,1545,2758,-2
232681,University of Mary Washington,2013,"All students, Undergraduate, Degree/certificate-seeking, First-time",944,314,630,-2
232681,University of Mary Washington,2013,"All students, Undergraduate, Other degree/certificate-seeking",3359,1231,2128,-2
232681,University of Mary Washington,2013,"All students, Undergraduate, Other degree/certifcate-seeking, Transfer-ins",308,121,187,-2
232681,University of Mary Washington,2013,"All students, Undergraduate, Other degree/certifcate-seeking, Continuing",3051,1110,1941,-2
232681,University of Mary Washington,2013,"All students, Undergraduate, Non-degree/certificate-seeking",80,23,57,-2
232681,University of Mary Washington,2013,"All students, Graduate",448,141,307,-2
232706,Marymount University,2013,All students total,3486,1031,2455,-2
232706,Marymount University,2013,"All students, Undergraduate total",2396,772,1624,-2
232706,Marymount University,2013,"All students, Undergraduate, Degree/certificate-seeking total",2371,762,1609,-2
232706,Marymount University,2013,"All students, Undergraduate, Degree/certificate-seeking, First-time",400,151,249,-2
232706,Marymount University,2013,"All students, Undergraduate, Other degree/certificate-seeking",1971,611,1360,-2
232706,Marymount University,2013,"All students, Undergraduate, Other degree/certifcate-seeking, Transfer-ins",281,85,196,-2
232706,Marymount University,2013,"All students, Undergraduate, Other degree/certifcate-seeking, Continuing",1690,526,1164,-2
232706,Marymount University,2013,"All students, Undergraduate, Non-degree/certificate-seeking",25,10,15,-2
232706,Marymount University,2013,"All students, Graduate",1090,259,831,-2
232797,American National University,2013,All students total,1857,434,1423,-2
232797,American National University,2013,"All students, Undergraduate total",1821,423,1398,-2
232797,American National University,2013,"All students, Undergraduate, Degree/certificate-seeking total",1804,423,1381,-2
232797,American National University,2013,"All students, Undergraduate, Degree/certificate-seeking, First-time",106,25,81,-2
232797,American National University,2013,"All students, Undergraduate, Other degree/certificate-seeking",1698,398,1300,-2
232797,American National University,2013,"All students, Undergraduate, Other degree/certifcate-seeking, Transfer-ins",232,53,179,-2
232797,American National University,2013,"All students, Undergraduate, Other degree/certifcate-seeking, Continuing",1466,345,1121,-2
232797,American National University,2013,"All students, Undergraduate, Non-degree/certificate-seeking",17,0,17,-2
232797,American National University,2013,"All students, Graduate",36,11,25,-2
232885,Sentara College of Health Sciences,2013,All students total,360,26,334,-2
232885,Sentara College of Health Sciences,2013,"All students, Undergraduate total",360,26,334,-2
232885,Sentara College of Health Sciences,2013,"All students, Undergraduate, Degree/certificate-seeking total",285,18,267,-2
232885,Sentara College of Health Sciences,2013,"All students, Undergraduate, Other degree/certificate-seeking",285,18,267,-2
232885,Sentara College of Health Sciences,2013,"All students, Undergraduate, Other degree/certifcate-seeking, Transfer-ins",21,1,20,-2
232885,Sentara College of Health Sciences,2013,"All students, Undergraduate, Other degree/certifcate-seeking, Continuing",264,17,247,-2
232885,Sentara College of Health Sciences,2013,"All students, Undergraduate, Non-degree/certificate-seeking",75,8,67,-2
232937,Norfolk State University,2013,All students total,6728,2365,4363,-2
232937,Norfolk State University,2013,"All students, Undergraduate total",6021,2159,3862,-2
232937,Norfolk State University,2013,"All students, Undergraduate, Degree/certificate-seeking total",5955,2122,3833,-2
232937,Norfolk State University,2013,"All students, Undergraduate, Degree/certificate-seeking, First-time",820,318,502,-2
232937,Norfolk State University,2013,"All students, Undergraduate, Other degree/certificate-seeking",5135,1804,3331,-2
232937,Norfolk State University,2013,"All students, Undergraduate, Other degree/certifcate-seeking, Transfer-ins",542,175,367,-2
232937,Norfolk State University,2013,"All students, Undergraduate, Other degree/certifcate-seeking, Continuing",4593,1629,2964,-2
232937,Norfolk State University,2013,"All students, Undergraduate, Non-degree/certificate-seeking",66,37,29,-2
232937,Norfolk State University,2013,"All students, Graduate",707,206,501,-2
232982,Old Dominion University,2013,All students total,24828,11199,13629,-2
232982,Old Dominion University,2013,"All students, Undergraduate total",19819,9117,10702,-2
232982,Old Dominion University,2013,"All students, Undergraduate, Degree/certificate-seeking total",19483,8958,10525,-2
232982,Old Dominion University,2013,"All students, Undergraduate, Degree/certificate-seeking, First-time",2942,1432,1510,-2
232982,Old Dominion University,2013,"All students, Undergraduate, Other degree/certificate-seeking",16541,7526,9015,-2
232982,Old Dominion University,2013,"All students, Undergraduate, Other degree/certifcate-seeking, Transfer-ins",2105,874,1231,-2
232982,Old Dominion University,2013,"All students, Undergraduate, Other degree/certifcate-seeking, Continuing",14436,6652,7784,-2
232982,Old Dominion University,2013,"All students, Undergraduate, Non-degree/certificate-seeking",336,159,177,-2
232982,Old Dominion University,2013,"All students, Graduate",5009,2082,2927,-2
233277,Radford University,2013,All students total,9928,4207,5721,-2
233277,Radford University,2013,"All students, Undergraduate total",8913,3941,4972,-2
233277,Radford University,2013,"All students, Undergraduate, Degree/certificate-seeking total",8866,3918,4948,-2
233277,Radford University,2013,"All students, Undergraduate, Degree/certificate-seeking, First-time",1986,860,1126,-2
233277,Radford University,2013,"All students, Undergraduate, Other degree/certificate-seeking",6880,3058,3822,-2
233277,Radford University,2013,"All students, Undergraduate, Other degree/certifcate-seeking, Transfer-ins",770,402,368,-2
233277,Radford University,2013,"All students, Undergraduate, Other degree/certifcate-seeking, Continuing",6110,2656,3454,-2
233277,Radford University,2013,"All students, Undergraduate, Non-degree/certificate-seeking",47,23,24,-2
233277,Radford University,2013,"All students, Graduate",1015,266,749,-2
233295,Randolph-Macon College,2013,All students total,1315,623,692,-2
233295,Randolph-Macon College,2013,"All students, Undergraduate total",1315,623,692,-2
233295,Randolph-Macon College,2013,"All students, Undergraduate, Degree/certificate-seeking total",1294,619,675,-2
233295,Randolph-Macon College,2013,"All students, Undergraduate, Degree/certificate-seeking, First-time",382,196,186,-2
233295,Randolph-Macon College,2013,"All students, Undergraduate, Other degree/certificate-seeking",912,423,489,-2
233295,Randolph-Macon College,2013,"All students, Undergraduate, Other degree/certifcate-seeking, Transfer-ins",28,12,16,-2
233295,Randolph-Macon College,2013,"All students, Undergraduate, Other degree/certifcate-seeking, Continuing",884,411,473,-2
233295,Randolph-Macon College,2013,"All students, Undergraduate, Non-degree/certificate-seeking",21,4,17,-2
233301,Randolph College,2013,All students total,682,243,439,-2
233301,Randolph College,2013,"All students, Undergraduate total",665,238,427,-2
233301,Randolph College,2013,"All students, Undergraduate, Degree/certificate-seeking total",651,232,419,-2
233301,Randolph College,2013,"All students, Undergraduate, Degree/certificate-seeking, First-time",216,72,144,-2
233301,Randolph College,2013,"All students, Undergraduate, Other degree/certificate-seeking",435,160,275,-2
233301,Randolph College,2013,"All students, Undergraduate, Other degree/certifcate-seeking, Transfer-ins",24,11,13,-2
233301,Randolph College,2013,"All students, Undergraduate, Other degree/certifcate-seeking, Continuing",411,149,262,-2
233301,Randolph College,2013,"All students, Undergraduate, Non-degree/certificate-seeking",14,6,8,-2
233301,Randolph College,2013,"All students, Graduate",17,5,12,-2
233356,Bon Secours Memorial College of Nursing,2013,All students total,408,26,382,-2
233356,Bon Secours Memorial College of Nursing,2013,"All students, Undergraduate total",408,26,382,-2
233356,Bon Secours Memorial College of Nursing,2013,"All students, Undergraduate, Degree/certificate-seeking total",408,26,382,-2
233356,Bon Secours Memorial College of Nursing,2013,"All students, Undergraduate, Degree/certificate-seeking, First-time",4,0,4,-2
233356,Bon Secours Memorial College of Nursing,2013,"All students, Undergraduate, Other degree/certificate-seeking",404,26,378,-2
233356,Bon Secours Memorial College of Nursing,2013,"All students, Undergraduate, Other degree/certifcate-seeking, Continuing",404,26,378,-2
233374,University of Richmond,2013,All students total,4140,1896,2244,-2
233374,University of Richmond,2013,"All students, Undergraduate total",3215,1512,1703,-2
233374,University of Richmond,2013,"All students, Undergraduate, Degree/certificate-seeking total",3107,1463,1644,-2
233374,University of Richmond,2013,"All students, Undergraduate, Degree/certificate-seeking, First-time",807,393,414,-2
233374,University of Richmond,2013,"All students, Undergraduate, Other degree/certificate-seeking",2300,1070,1230,-2
233374,University of Richmond,2013,"All students, Undergraduate, Other degree/certifcate-seeking, Transfer-ins",101,42,59,-2
233374,University of Richmond,2013,"All students, Undergraduate, Other degree/certifcate-seeking, Continuing",2199,1028,1171,-2
233374,University of Richmond,2013,"All students, Undergraduate, Non-degree/certificate-seeking",108,49,59,-2
233374,University of Richmond,2013,"All students, Graduate",925,384,541,-2
233426,Roanoke College,2013,All students total,2029,841,1188,-2
233426,Roanoke College,2013,"All students, Undergraduate total",2029,841,1188,-2
233426,Roanoke College,2013,"All students, Undergraduate, Degree/certificate-seeking total",1980,819,1161,-2
233426,Roanoke College,2013,"All students, Undergraduate, Degree/certificate-seeking, First-time",542,222,320,-2
233426,Roanoke College,2013,"All students, Undergraduate, Other degree/certificate-seeking",1438,597,841,-2
233426,Roanoke College,2013,"All students, Undergraduate, Other degree/certifcate-seeking, Transfer-ins",74,39,35,-2
233426,Roanoke College,2013,"All students, Undergraduate, Other degree/certifcate-seeking, Continuing",1364,558,806,-2
233426,Roanoke College,2013,"All students, Undergraduate, Non-degree/certificate-seeking",49,22,27,-2
233499,Saint Pauls College,2013,,,,,-2
233541,Shenandoah University,2013,All students total,4003,1381,2622,-2
233541,Shenandoah University,2013,"All students, Undergraduate total",2150,848,1302,-2
233541,Shenandoah University,2013,"All students, Undergraduate, Degree/certificate-seeking total",1859,803,1056,-2
233541,Shenandoah University,2013,"All students, Undergraduate, Degree/certificate-seeking, First-time",418,189,229,-2
233541,Shenandoah University,2013,"All students, Undergraduate, Other degree/certificate-seeking",1441,614,827,-2
233541,Shenandoah University,2013,"All students, Undergraduate, Other degree/certifcate-seeking, Transfer-ins",130,59,71,-2
233541,Shenandoah University,2013,"All students, Undergraduate, Other degree/certifcate-seeking, Continuing",1311,555,756,-2
233541,Shenandoah University,2013,"All students, Undergraduate, Non-degree/certificate-seeking",291,45,246,-2
233541,Shenandoah University,2013,"All students, Graduate",1853,533,1320,-2
233611,Southern Virginia University,2013,All students total,662,309,353,-2
233611,Southern Virginia University,2013,"All students, Undergraduate total",662,309,353,-2
233611,Southern Virginia University,2013,"All students, Undergraduate, Degree/certificate-seeking total",658,308,350,-2
233611,Southern Virginia University,2013,"All students, Undergraduate, Degree/certificate-seeking, First-time",224,90,134,-2
233611,Southern Virginia University,2013,"All students, Undergraduate, Other degree/certificate-seeking",434,218,216,-2
233611,Southern Virginia University,2013,"All students, Undergraduate, Other degree/certifcate-seeking, Transfer-ins",65,36,29,-2
233611,Southern Virginia University,2013,"All students, Undergraduate, Other degree/certifcate-seeking, Continuing",369,182,187,-2
233611,Southern Virginia University,2013,"All students, Undergraduate, Non-degree/certificate-seeking",4,1,3,-2
233684,Strayer University-Virginia,2013,All students total,7649,3539,4110,-2
233684,Strayer University-Virginia,2013,"All students, Undergraduate total",4943,2404,2539,-2
233684,Strayer University-Virginia,2013,"All students, Undergraduate, Degree/certificate-seeking total",4837,2344,2493,-2
233684,Strayer University-Virginia,2013,"All students, Undergraduate, Degree/certificate-seeking, First-time",306,150,156,-2
233684,Strayer University-Virginia,2013,"All students, Undergraduate, Other degree/certificate-seeking",4531,2194,2337,-2
233684,Strayer University-Virginia,2013,"All students, Undergraduate, Other degree/certifcate-seeking, Transfer-ins",450,215,235,-2
233684,Strayer University-Virginia,2013,"All students, Undergraduate, Other degree/certifcate-seeking, Continuing",4081,1979,2102,-2
233684,Strayer University-Virginia,2013,"All students, Undergraduate, Non-degree/certificate-seeking",106,60,46,-2
233684,Strayer University-Virginia,2013,"All students, Graduate",2706,1135,1571,-2
233718,Sweet Briar College,2013,All students total,710,16,694,-2
233718,Sweet Briar College,2013,"All students, Undergraduate total",703,16,687,-2
233718,Sweet Briar College,2013,"All students, Undergraduate, Degree/certificate-seeking total",599,0,599,-2
233718,Sweet Briar College,2013,"All students, Undergraduate, Degree/certificate-seeking, First-time",197,0,197,-2
233718,Sweet Briar College,2013,"All students, Undergraduate, Other degree/certificate-seeking",402,0,402,-2
233718,Sweet Briar College,2013,"All students, Undergraduate, Other degree/certifcate-seeking, Transfer-ins",11,0,11,-2
233718,Sweet Briar College,2013,"All students, Undergraduate, Other degree/certifcate-seeking, Continuing",391,0,391,-2
233718,Sweet Briar College,2013,"All students, Undergraduate, Non-degree/certificate-seeking",104,16,88,-2
233718,Sweet Briar College,2013,"All students, Graduate",7,0,7,-2
233842,Union Presbyterian Seminary,2013,All students total,205,94,111,-2
233842,Union Presbyterian Seminary,2013,"All students, Graduate",205,94,111,-2
233897,The University of Virginia's College at Wise,2013,All students total,2291,954,1337,-2
233897,The University of Virginia's College at Wise,2013,"All students, Undergraduate total",2291,954,1337,-2
233897,The University of Virginia's College at Wise,2013,"All students, Undergraduate, Degree/certificate-seeking total",1585,799,786,-2
233897,The University of Virginia's College at Wise,2013,"All students, Undergraduate, Degree/certificate-seeking, First-time",335,174,161,-2
233897,The University of Virginia's College at Wise,2013,"All students, Undergraduate, Other degree/certificate-seeking",1250,625,625,-2
233897,The University of Virginia's College at Wise,2013,"All students, Undergraduate, Other degree/certifcate-seeking, Transfer-ins",123,56,67,-2
233897,The University of Virginia's College at Wise,2013,"All students, Undergraduate, Other degree/certifcate-seeking, Continuing",1127,569,558,-2
233897,The University of Virginia's College at Wise,2013,"All students, Undergraduate, Non-degree/certificate-seeking",706,155,551,-2
233912,Virginia Intermont College,2013,All students total,378,128,250,-2
233912,Virginia Intermont College,2013,"All students, Undergraduate total",378,128,250,-2
233912,Virginia Intermont College,2013,"All students, Undergraduate, Degree/certificate-seeking total",352,120,232,-2
233912,Virginia Intermont College,2013,"All students, Undergraduate, Degree/certificate-seeking, First-time",46,14,32,-2
233912,Virginia Intermont College,2013,"All students, Undergraduate, Other degree/certificate-seeking",306,106,200,-2
233912,Virginia Intermont College,2013,"All students, Undergraduate, Other degree/certifcate-seeking, Transfer-ins",40,17,23,-2
233912,Virginia Intermont College,2013,"All students, Undergraduate, Other degree/certifcate-seeking, Continuing",266,89,177,-2
233912,Virginia Intermont College,2013,"All students, Undergraduate, Non-degree/certificate-seeking",26,8,18,-2
233921,Virginia Polytechnic Institute and State University,2013,All students total,31205,18094,13111,-2
233921,Virginia Polytechnic Institute and State University,2013,"All students, Undergraduate total",24034,14101,9933,-2
233921,Virginia Polytechnic Institute and State University,2013,"All students, Undergraduate, Degree/certificate-seeking total",23928,14035,9893,-2
233921,Virginia Polytechnic Institute and State University,2013,"All students, Undergraduate, Degree/certificate-seeking, First-time",5364,3008,2356,-2
233921,Virginia Polytechnic Institute and State University,2013,"All students, Undergraduate, Other degree/certificate-seeking",18564,11027,7537,-2
233921,Virginia Polytechnic Institute and State University,2013,"All students, Undergraduate, Other degree/certifcate-seeking, Transfer-ins",995,677,318,-2
233921,Virginia Polytechnic Institute and State University,2013,"All students, Undergraduate, Other degree/certifcate-seeking, Continuing",17569,10350,7219,-2
233921,Virginia Polytechnic Institute and State University,2013,"All students, Undergraduate, Non-degree/certificate-seeking",106,66,40,-2
233921,Virginia Polytechnic Institute and State University,2013,"All students, Graduate",7171,3993,3178,-2
234030,Virginia Commonwealth University,2013,All students total,30974,13091,17883,-2
234030,Virginia Commonwealth University,2013,"All students, Undergraduate total",23356,10155,13201,-2
234030,Virginia Commonwealth University,2013,"All students, Undergraduate, Degree/certificate-seeking total",22049,9534,12515,-2
234030,Virginia Commonwealth University,2013,"All students, Undergraduate, Degree/certificate-seeking, First-time",3526,1447,2079,-2
234030,Virginia Commonwealth University,2013,"All students, Undergraduate, Other degree/certificate-seeking",18523,8087,10436,-2
234030,Virginia Commonwealth University,2013,"All students, Undergraduate, Other degree/certifcate-seeking, Transfer-ins",2093,885,1208,-2
234030,Virginia Commonwealth University,2013,"All students, Undergraduate, Other degree/certifcate-seeking, Continuing",16430,7202,9228,-2
234030,Virginia Commonwealth University,2013,"All students, Undergraduate, Non-degree/certificate-seeking",1307,621,686,-2
234030,Virginia Commonwealth University,2013,"All students, Graduate",7618,2936,4682,-2
234076,University of Virginia-Main Campus,2013,All students total,23464,10754,12710,-2
234076,University of Virginia-Main Campus,2013,"All students, Undergraduate total",16087,7142,8945,-2
234076,University of Virginia-Main Campus,2013,"All students, Undergraduate, Degree/certificate-seeking total",15020,6833,8187,-2
234076,University of Virginia-Main Campus,2013,"All students, Undergraduate, Degree/certificate-seeking, First-time",3534,1566,1968,-2
234076,University of Virginia-Main Campus,2013,"All students, Undergraduate, Other degree/certificate-seeking",11486,5267,6219,-2
234076,University of Virginia-Main Campus,2013,"All students, Undergraduate, Other degree/certifcate-seeking, Transfer-ins",671,337,334,-2
234076,University of Virginia-Main Campus,2013,"All students, Undergraduate, Other degree/certifcate-seeking, Continuing",10815,4930,5885,-2
234076,University of Virginia-Main Campus,2013,"All students, Undergraduate, Non-degree/certificate-seeking",1067,309,758,-2
234076,University of Virginia-Main Campus,2013,"All students, Graduate",7377,3612,3765,-2
234085,Virginia Military Institute,2013,All students total,1675,1499,176,-2
234085,Virginia Military Institute,2013,"All students, Undergraduate total",1675,1499,176,-2
234085,Virginia Military Institute,2013,"All students, Undergraduate, Degree/certificate-seeking total",1675,1499,176,-2
234085,Virginia Military Institute,2013,"All students, Undergraduate, Degree/certificate-seeking, First-time",421,378,43,-2
234085,Virginia Military Institute,2013,"All students, Undergraduate, Other degree/certificate-seeking",1254,1121,133,-2
234085,Virginia Military Institute,2013,"All students, Undergraduate, Other degree/certifcate-seeking, Transfer-ins",45,35,10,-2
234085,Virginia Military Institute,2013,"All students, Undergraduate, Other degree/certifcate-seeking, Continuing",1209,1086,123,-2
234137,Virginia University of Lynchburg,2013,All students total,582,287,295,-2
234137,Virginia University of Lynchburg,2013,"All students, Undergraduate total",493,241,252,-2
234137,Virginia University of Lynchburg,2013,"All students, Undergraduate, Degree/certificate-seeking total",493,241,252,-2
234137,Virginia University of Lynchburg,2013,"All students, Undergraduate, Degree/certificate-seeking, First-time",126,68,58,-2
234137,Virginia University of Lynchburg,2013,"All students, Undergraduate, Other degree/certificate-seeking",367,173,194,-2
234137,Virginia University of Lynchburg,2013,"All students, Undergraduate, Other degree/certifcate-seeking, Continuing",367,173,194,-2
234137,Virginia University of Lynchburg,2013,"All students, Graduate",89,46,43,-2
234155,Virginia State University,2013,All students total,5763,2317,3446,-2
234155,Virginia State University,2013,"All students, Undergraduate total",5073,2033,3040,-2
234155,Virginia State University,2013,"All students, Undergraduate, Degree/certificate-seeking total",5023,2007,3016,-2
234155,Virginia State University,2013,"All students, Undergraduate, Degree/certificate-seeking, First-time",1137,445,692,-2
234155,Virginia State University,2013,"All students, Undergraduate, Other degree/certificate-seeking",3886,1562,2324,-2
234155,Virginia State University,2013,"All students, Undergraduate, Other degree/certifcate-seeking, Transfer-ins",372,153,219,-2
234155,Virginia State University,2013,"All students, Undergraduate, Other degree/certifcate-seeking, Continuing",3514,1409,2105,-2
234155,Virginia State University,2013,"All students, Undergraduate, Non-degree/certificate-seeking",50,26,24,-2
234155,Virginia State University,2013,"All students, Graduate",690,284,406,-2
234164,Virginia Union University,2013,All students total,1749,806,943,-2
234164,Virginia Union University,2013,"All students, Undergraduate total",1359,611,748,-2
234164,Virginia Union University,2013,"All students, Undergraduate, Degree/certificate-seeking total",1359,611,748,-2
234164,Virginia Union University,2013,"All students, Undergraduate, Degree/certificate-seeking, First-time",404,179,225,-2
234164,Virginia Union University,2013,"All students, Undergraduate, Other degree/certificate-seeking",955,432,523,-2
234164,Virginia Union University,2013,"All students, Undergraduate, Other degree/certifcate-seeking, Transfer-ins",83,48,35,-2
234164,Virginia Union University,2013,"All students, Undergraduate, Other degree/certifcate-seeking, Continuing",872,384,488,-2
234164,Virginia Union University,2013,"All students, Graduate",390,195,195,-2
234173,Virginia Wesleyan College,2013,All students total,1459,562,897,-2
234173,Virginia Wesleyan College,2013,"All students, Undergraduate total",1459,562,897,-2
234173,Virginia Wesleyan College,2013,"All students, Undergraduate, Degree/certificate-seeking total",1436,554,882,-2
234173,Virginia Wesleyan College,2013,"All students, Undergraduate, Degree/certificate-seeking, First-time",453,183,270,-2
234173,Virginia Wesleyan College,2013,"All students, Undergraduate, Other degree/certificate-seeking",983,371,612,-2
234173,Virginia Wesleyan College,2013,"All students, Undergraduate, Other degree/certifcate-seeking, Transfer-ins",63,28,35,-2
234173,Virginia Wesleyan College,2013,"All students, Undergraduate, Other degree/certifcate-seeking, Continuing",920,343,577,-2
234173,Virginia Wesleyan College,2013,"All students, Undergraduate, Non-degree/certificate-seeking",23,8,15,-2
234207,Washington and Lee University,2013,All students total,2277,1155,1122,-2
234207,Washington and Lee University,2013,"All students, Undergraduate total",1855,936,919,-2
234207,Washington and Lee University,2013,"All students, Undergraduate, Degree/certificate-seeking total",1846,934,912,-2
234207,Washington and Lee University,2013,"All students, Undergraduate, Degree/certificate-seeking, First-time",480,245,235,-2
234207,Washington and Lee University,2013,"All students, Undergraduate, Other degree/certificate-seeking",1366,689,677,-2
234207,Washington and Lee University,2013,"All students, Undergraduate, Other degree/certifcate-seeking, Continuing",1366,689,677,-2
234207,Washington and Lee University,2013,"All students, Undergraduate, Non-degree/certificate-seeking",9,2,7,-2
234207,Washington and Lee University,2013,"All students, Graduate",422,219,203,-2
234216,Sanford-Brown College-Tysons Corner,2013,All students total,231,49,182,-2
234216,Sanford-Brown College-Tysons Corner,2013,"All students, Undergraduate total",231,49,182,-2
234216,Sanford-Brown College-Tysons Corner,2013,"All students, Undergraduate, Degree/certificate-seeking total",231,49,182,-2
234216,Sanford-Brown College-Tysons Corner,2013,"All students, Undergraduate, Other degree/certificate-seeking",231,49,182,-2
234216,Sanford-Brown College-Tysons Corner,2013,"All students, Undergraduate, Other degree/certifcate-seeking, Continuing",231,49,182,-2
244154,ITT Technical Institute-Westminster,2013,All students total,218,194,24,-2
244154,ITT Technical Institute-Westminster,2013,"All students, Undergraduate total",218,194,24,-2
244154,ITT Technical Institute-Westminster,2013,"All students, Undergraduate, Degree/certificate-seeking total",218,194,24,-2
244154,ITT Technical Institute-Westminster,2013,"All students, Undergraduate, Degree/certificate-seeking, First-time",37,33,4,-2
244154,ITT Technical Institute-Westminster,2013,"All students, Undergraduate, Other degree/certificate-seeking",181,161,20,-2
244154,ITT Technical Institute-Westminster,2013,"All students, Undergraduate, Other degree/certifcate-seeking, Transfer-ins",3,1,2,-2
244154,ITT Technical Institute-Westminster,2013,"All students, Undergraduate, Other degree/certifcate-seeking, Continuing",178,160,18,-2
245731,Yeshiva and Kollel Harbotzas Torah,2013,All students total,46,46,0,-2
245731,Yeshiva and Kollel Harbotzas Torah,2013,"All students, Undergraduate total",25,25,0,-2
245731,Yeshiva and Kollel Harbotzas Torah,2013,"All students, Undergraduate, Degree/certificate-seeking total",25,25,0,-2
245731,Yeshiva and Kollel Harbotzas Torah,2013,"All students, Undergraduate, Other degree/certificate-seeking",25,25,0,-2
245731,Yeshiva and Kollel Harbotzas Torah,2013,"All students, Undergraduate, Other degree/certifcate-seeking, Transfer-ins",10,10,0,-2
245731,Yeshiva and Kollel Harbotzas Torah,2013,"All students, Undergraduate, Other degree/certifcate-seeking, Continuing",15,15,0,-2
245731,Yeshiva and Kollel Harbotzas Torah,2013,"All students, Graduate",21,21,0,-2
245777,Bais Medrash Elyon,2013,All students total,54,54,0,-2
245777,Bais Medrash Elyon,2013,"All students, Undergraduate total",27,27,0,-2
245777,Bais Medrash Elyon,2013,"All students, Undergraduate, Degree/certificate-seeking total",27,27,0,-2
245777,Bais Medrash Elyon,2013,"All students, Undergraduate, Other degree/certificate-seeking",27,27,0,-2
245777,Bais Medrash Elyon,2013,"All students, Undergraduate, Other degree/certifcate-seeking, Transfer-ins",22,22,0,-2
245777,Bais Medrash Elyon,2013,"All students, Undergraduate, Other degree/certifcate-seeking, Continuing",5,5,0,-2
245777,Bais Medrash Elyon,2013,"All students, Graduate",27,27,0,-2
245865,Antioch University-New England,2013,All students total,725,157,568,-2
245865,Antioch University-New England,2013,"All students, Graduate",725,157,568,-2
245892,Antioch University-Midwest,2013,All students total,310,92,218,-2
245892,Antioch University-Midwest,2013,"All students, Undergraduate total",116,34,82,-2
245892,Antioch University-Midwest,2013,"All students, Undergraduate, Degree/certificate-seeking total",116,34,82,-2
245892,Antioch University-Midwest,2013,"All students, Undergraduate, Other degree/certificate-seeking",116,34,82,-2
245892,Antioch University-Midwest,2013,"All students, Undergraduate, Other degree/certifcate-seeking, Transfer-ins",42,12,30,-2
245892,Antioch University-Midwest,2013,"All students, Undergraduate, Other degree/certifcate-seeking, Continuing",74,22,52,-2
245892,Antioch University-Midwest,2013,"All students, Graduate",194,58,136,-2
246789,Unification Theological Seminary,2013,All students total,114,75,39,-2
246789,Unification Theological Seminary,2013,"All students, Undergraduate total",19,10,9,-2
246789,Unification Theological Seminary,2013,"All students, Undergraduate, Degree/certificate-seeking total",18,9,9,-2
246789,Unification Theological Seminary,2013,"All students, Undergraduate, Degree/certificate-seeking, First-time",5,2,3,-2
246789,Unification Theological Seminary,2013,"All students, Undergraduate, Other degree/certificate-seeking",13,7,6,-2
246789,Unification Theological Seminary,2013,"All students, Undergraduate, Other degree/certifcate-seeking, Transfer-ins",13,7,6,-2
246789,Unification Theological Seminary,2013,"All students, Undergraduate, Non-degree/certificate-seeking",1,1,0,-2
246789,Unification Theological Seminary,2013,"All students, Graduate",95,65,30,-2
247162,Ecumenical Theological Seminary,2013,All students total,81,29,52,-2
247162,Ecumenical Theological Seminary,2013,"All students, Undergraduate total",16,5,11,-2
247162,Ecumenical Theological Seminary,2013,"All students, Undergraduate, Degree/certificate-seeking total",16,5,11,-2
247162,Ecumenical Theological Seminary,2013,"All students, Undergraduate, Degree/certificate-seeking, First-time",8,3,5,-2
247162,Ecumenical Theological Seminary,2013,"All students, Undergraduate, Other degree/certificate-seeking",8,2,6,-2
247162,Ecumenical Theological Seminary,2013,"All students, Undergraduate, Other degree/certifcate-seeking, Continuing",8,2,6,-2
247162,Ecumenical Theological Seminary,2013,"All students, Graduate",65,24,41,-2
247649,Landmark College,2013,All students total,494,360,134,-2
247649,Landmark College,2013,"All students, Undergraduate total",494,360,134,-2
247649,Landmark College,2013,"All students, Undergraduate, Degree/certificate-seeking total",491,357,134,-2
247649,Landmark College,2013,"All students, Undergraduate, Degree/certificate-seeking, First-time",138,115,23,-2
247649,Landmark College,2013,"All students, Undergraduate, Other degree/certificate-seeking",353,242,111,-2
247649,Landmark College,2013,"All students, Undergraduate, Other degree/certifcate-seeking, Transfer-ins",98,76,22,-2
247649,Landmark College,2013,"All students, Undergraduate, Other degree/certifcate-seeking, Continuing",255,166,89,-2
247649,Landmark College,2013,"All students, Undergraduate, Non-degree/certificate-seeking",3,3,0,-2
247773,Yeshiva Gedolah of Greater Detroit,2013,All students total,74,74,0,-2
247773,Yeshiva Gedolah of Greater Detroit,2013,"All students, Undergraduate total",58,58,0,-2
247773,Yeshiva Gedolah of Greater Detroit,2013,"All students, Undergraduate, Degree/certificate-seeking total",58,58,0,-2
247773,Yeshiva Gedolah of Greater Detroit,2013,"All students, Undergraduate, Degree/certificate-seeking, First-time",15,15,0,-2
247773,Yeshiva Gedolah of Greater Detroit,2013,"All students, Undergraduate, Other degree/certificate-seeking",43,43,0,-2
247773,Yeshiva Gedolah of Greater Detroit,2013,"All students, Undergraduate, Other degree/certifcate-seeking, Transfer-ins",3,3,0,-2
247773,Yeshiva Gedolah of Greater Detroit,2013,"All students, Undergraduate, Other degree/certifcate-seeking, Continuing",40,40,0,-2
247773,Yeshiva Gedolah of Greater Detroit,2013,"All students, Graduate",16,16,0,-2
248934,ECPI University,2013,All students total,10845,4796,6049,-2
248934,ECPI University,2013,"All students, Undergraduate total",10803,4760,6043,-2
248934,ECPI University,2013,"All students, Undergraduate, Degree/certificate-seeking total",10241,4533,5708,-2
248934,ECPI University,2013,"All students, Undergraduate, Degree/certificate-seeking, First-time",948,395,553,-2
248934,ECPI University,2013,"All students, Undergraduate, Other degree/certificate-seeking",9293,4138,5155,-2
248934,ECPI University,2013,"All students, Undergraduate, Other degree/certifcate-seeking, Transfer-ins",975,340,635,-2
248934,ECPI University,2013,"All students, Undergraduate, Other degree/certifcate-seeking, Continuing",8318,3798,4520,-2
248934,ECPI University,2013,"All students, Undergraduate, Non-degree/certificate-seeking",562,227,335,-2
248934,ECPI University,2013,"All students, Graduate",42,36,6,-2
260813,Platt College-Aurora,2013,All students total,209,27,182,-2
260813,Platt College-Aurora,2013,"All students, Undergraduate total",209,27,182,-2
260813,Platt College-Aurora,2013,"All students, Undergraduate, Degree/certificate-seeking total",209,27,182,-2
260813,Platt College-Aurora,2013,"All students, Undergraduate, Degree/certificate-seeking, First-time",2,0,2,-2
260813,Platt College-Aurora,2013,"All students, Undergraduate, Other degree/certificate-seeking",207,27,180,-2
260813,Platt College-Aurora,2013,"All students, Undergraduate, Other degree/certifcate-seeking, Transfer-ins",21,2,19,-2
260813,Platt College-Aurora,2013,"All students, Undergraduate, Other degree/certifcate-seeking, Continuing",186,25,161,-2
260901,Kaplan University-Davenport Campus,2013,All students total,52407,12838,39569,-2
260901,Kaplan University-Davenport Campus,2013,"All students, Undergraduate total",40349,9830,30519,-2
260901,Kaplan University-Davenport Campus,2013,"All students, Undergraduate, Degree/certificate-seeking total",40209,9745,30464,-2
260901,Kaplan University-Davenport Campus,2013,"All students, Undergraduate, Degree/certificate-seeking, First-time",4984,1175,3809,-2
260901,Kaplan University-Davenport Campus,2013,"All students, Undergraduate, Other degree/certificate-seeking",35225,8570,26655,-2
260901,Kaplan University-Davenport Campus,2013,"All students, Undergraduate, Other degree/certifcate-seeking, Transfer-ins",8818,2264,6554,-2
260901,Kaplan University-Davenport Campus,2013,"All students, Undergraduate, Other degree/certifcate-seeking, Continuing",26407,6306,20101,-2
260901,Kaplan University-Davenport Campus,2013,"All students, Undergraduate, Non-degree/certificate-seeking",140,85,55,-2
260901,Kaplan University-Davenport Campus,2013,"All students, Graduate",12058,3008,9050,-2
260910,Kaplan University-Cedar Falls Campus,2013,All students total,449,92,357,-2
260910,Kaplan University-Cedar Falls Campus,2013,"All students, Undergraduate total",386,77,309,-2
260910,Kaplan University-Cedar Falls Campus,2013,"All students, Undergraduate, Degree/certificate-seeking total",386,77,309,-2
260910,Kaplan University-Cedar Falls Campus,2013,"All students, Undergraduate, Degree/certificate-seeking, First-time",28,5,23,-2
260910,Kaplan University-Cedar Falls Campus,2013,"All students, Undergraduate, Other degree/certificate-seeking",358,72,286,-2
260910,Kaplan University-Cedar Falls Campus,2013,"All students, Undergraduate, Other degree/certifcate-seeking, Transfer-ins",108,20,88,-2
260910,Kaplan University-Cedar Falls Campus,2013,"All students, Undergraduate, Other degree/certifcate-seeking, Continuing",250,52,198,-2
260910,Kaplan University-Cedar Falls Campus,2013,"All students, Graduate",63,15,48,-2
261472,ITT Technical Institute-Troy,2013,All students total,581,462,119,-2
261472,ITT Technical Institute-Troy,2013,"All students, Undergraduate total",581,462,119,-2
261472,ITT Technical Institute-Troy,2013,"All students, Undergraduate, Degree/certificate-seeking total",581,462,119,-2
261472,ITT Technical Institute-Troy,2013,"All students, Undergraduate, Degree/certificate-seeking, First-time",66,51,15,-2
261472,ITT Technical Institute-Troy,2013,"All students, Undergraduate, Other degree/certificate-seeking",515,411,104,-2
261472,ITT Technical Institute-Troy,2013,"All students, Undergraduate, Other degree/certifcate-seeking, Transfer-ins",8,5,3,-2
261472,ITT Technical Institute-Troy,2013,"All students, Undergraduate, Other degree/certifcate-seeking, Continuing",507,406,101,-2
261931,Skyline College-Roanoke,2013,All students total,195,55,140,-2
261931,Skyline College-Roanoke,2013,"All students, Undergraduate total",195,55,140,-2
261931,Skyline College-Roanoke,2013,"All students, Undergraduate, Degree/certificate-seeking total",193,53,140,-2
261931,Skyline College-Roanoke,2013,"All students, Undergraduate, Degree/certificate-seeking, First-time",14,4,10,-2
261931,Skyline College-Roanoke,2013,"All students, Undergraduate, Other degree/certificate-seeking",179,49,130,-2
261931,Skyline College-Roanoke,2013,"All students, Undergraduate, Other degree/certifcate-seeking, Transfer-ins",28,2,26,-2
261931,Skyline College-Roanoke,2013,"All students, Undergraduate, Other degree/certifcate-seeking, Continuing",151,47,104,-2
261931,Skyline College-Roanoke,2013,"All students, Undergraduate, Non-degree/certificate-seeking",2,2,0,-2
365426,Mayo Graduate School,2013,All students total,322,151,171,-2
365426,Mayo Graduate School,2013,"All students, Graduate",322,151,171,-2
366252,Pennsylvania College of Technology,2013,All students total,5678,3575,2103,-2
366252,Pennsylvania College of Technology,2013,"All students, Undergraduate total",5678,3575,2103,-2
366252,Pennsylvania College of Technology,2013,"All students, Undergraduate, Degree/certificate-seeking total",5615,3548,2067,-2
366252,Pennsylvania College of Technology,2013,"All students, Undergraduate, Degree/certificate-seeking, First-time",1418,975,443,-2
366252,Pennsylvania College of Technology,2013,"All students, Undergraduate, Other degree/certificate-seeking",4197,2573,1624,-2
366252,Pennsylvania College of Technology,2013,"All students, Undergraduate, Other degree/certifcate-seeking, Transfer-ins",435,240,195,-2
366252,Pennsylvania College of Technology,2013,"All students, Undergraduate, Other degree/certifcate-seeking, Continuing",3762,2333,1429,-2
366252,Pennsylvania College of Technology,2013,"All students, Undergraduate, Non-degree/certificate-seeking",63,27,36,-2
366368,New York Academy of Art,2013,All students total,104,54,50,-2
366368,New York Academy of Art,2013,"All students, Graduate",104,54,50,-2
366580,ITT Technical Institute-Norwood,2013,All students total,478,425,53,-2
366580,ITT Technical Institute-Norwood,2013,"All students, Undergraduate total",478,425,53,-2
366580,ITT Technical Institute-Norwood,2013,"All students, Undergraduate, Degree/certificate-seeking total",478,425,53,-2
366580,ITT Technical Institute-Norwood,2013,"All students, Undergraduate, Degree/certificate-seeking, First-time",50,43,7,-2
366580,ITT Technical Institute-Norwood,2013,"All students, Undergraduate, Other degree/certificate-seeking",428,382,46,-2
366580,ITT Technical Institute-Norwood,2013,"All students, Undergraduate, Other degree/certifcate-seeking, Transfer-ins",9,7,2,-2
366580,ITT Technical Institute-Norwood,2013,"All students, Undergraduate, Other degree/certifcate-seeking, Continuing",419,375,44,-2
366748,Argosy University-Hawaii,2013,All students total,795,285,510,-2
366748,Argosy University-Hawaii,2013,"All students, Undergraduate total",326,138,188,-2
366748,Argosy University-Hawaii,2013,"All students, Undergraduate, Degree/certificate-seeking total",311,133,178,-2
366748,Argosy University-Hawaii,2013,"All students, Undergraduate, Degree/certificate-seeking, First-time",15,5,10,-2
366748,Argosy University-Hawaii,2013,"All students, Undergraduate, Other degree/certificate-seeking",296,128,168,-2
366748,Argosy University-Hawaii,2013,"All students, Undergraduate, Other degree/certifcate-seeking, Transfer-ins",120,45,75,-2
366748,Argosy University-Hawaii,2013,"All students, Undergraduate, Other degree/certifcate-seeking, Continuing",176,83,93,-2
366748,Argosy University-Hawaii,2013,"All students, Undergraduate, Non-degree/certificate-seeking",15,5,10,-2
366748,Argosy University-Hawaii,2013,"All students, Graduate",469,147,322,-2
366793,Baptist Theological Seminary at Richmond,2013,All students total,77,36,41,-2
366793,Baptist Theological Seminary at Richmond,2013,"All students, Graduate",77,36,41,-2
367024,Kaplan University-Des Moines Campus,2013,All students total,875,240,635,-2
367024,Kaplan University-Des Moines Campus,2013,"All students, Undergraduate total",780,210,570,-2
367024,Kaplan University-Des Moines Campus,2013,"All students, Undergraduate, Degree/certificate-seeking total",779,210,569,-2
367024,Kaplan University-Des Moines Campus,2013,"All students, Undergraduate, Degree/certificate-seeking, First-time",91,28,63,-2
367024,Kaplan University-Des Moines Campus,2013,"All students, Undergraduate, Other degree/certificate-seeking",688,182,506,-2
367024,Kaplan University-Des Moines Campus,2013,"All students, Undergraduate, Other degree/certifcate-seeking, Transfer-ins",231,67,164,-2
367024,Kaplan University-Des Moines Campus,2013,"All students, Undergraduate, Other degree/certifcate-seeking, Continuing",457,115,342,-2
367024,Kaplan University-Des Moines Campus,2013,"All students, Undergraduate, Non-degree/certificate-seeking",1,0,1,-2
367024,Kaplan University-Des Moines Campus,2013,"All students, Graduate",95,30,65,-2
367194,McNally Smith College of Music,2013,All students total,596,445,151,-2
367194,McNally Smith College of Music,2013,"All students, Undergraduate total",576,430,146,-2
367194,McNally Smith College of Music,2013,"All students, Undergraduate, Degree/certificate-seeking total",556,419,137,-2
367194,McNally Smith College of Music,2013,"All students, Undergraduate, Degree/certificate-seeking, First-time",101,74,27,-2
367194,McNally Smith College of Music,2013,"All students, Undergraduate, Other degree/certificate-seeking",455,345,110,-2
367194,McNally Smith College of Music,2013,"All students, Undergraduate, Other degree/certifcate-seeking, Transfer-ins",94,69,25,-2
367194,McNally Smith College of Music,2013,"All students, Undergraduate, Other degree/certifcate-seeking, Continuing",361,276,85,-2
367194,McNally Smith College of Music,2013,"All students, Undergraduate, Non-degree/certificate-seeking",20,11,9,-2
367194,McNally Smith College of Music,2013,"All students, Graduate",20,15,5,-2
367839,Colorado Heights University,2013,All students total,375,153,222,-2
367839,Colorado Heights University,2013,"All students, Undergraduate total",343,145,198,-2
367839,Colorado Heights University,2013,"All students, Undergraduate, Degree/certificate-seeking total",343,145,198,-2
367839,Colorado Heights University,2013,"All students, Undergraduate, Degree/certificate-seeking, First-time",35,18,17,-2
367839,Colorado Heights University,2013,"All students, Undergraduate, Other degree/certificate-seeking",308,127,181,-2
367839,Colorado Heights University,2013,"All students, Undergraduate, Other degree/certifcate-seeking, Transfer-ins",33,9,24,-2
367839,Colorado Heights University,2013,"All students, Undergraduate, Other degree/certifcate-seeking, Continuing",275,118,157,-2
367839,Colorado Heights University,2013,"All students, Graduate",32,8,24,-2
368601,ITT Technical Institute-Norfolk,2013,All students total,720,507,213,-2
368601,ITT Technical Institute-Norfolk,2013,"All students, Undergraduate total",720,507,213,-2
368601,ITT Technical Institute-Norfolk,2013,"All students, Undergraduate, Degree/certificate-seeking total",720,507,213,-2
368601,ITT Technical Institute-Norfolk,2013,"All students, Undergraduate, Degree/certificate-seeking, First-time",114,72,42,-2
368601,ITT Technical Institute-Norfolk,2013,"All students, Undergraduate, Other degree/certificate-seeking",606,435,171,-2
368601,ITT Technical Institute-Norfolk,2013,"All students, Undergraduate, Other degree/certifcate-seeking, Transfer-ins",15,10,5,-2
368601,ITT Technical Institute-Norfolk,2013,"All students, Undergraduate, Other degree/certifcate-seeking, Continuing",591,425,166,-2
369002,Massachusetts School of Law,2013,All students total,529,262,267,-2
369002,Massachusetts School of Law,2013,"All students, Graduate",529,262,267,-2
369817,Bethel Seminary of the East,2013,All students total,81,50,31,-2
369817,Bethel Seminary of the East,2013,"All students, Graduate",81,50,31,-2
369905,Bryant & Stratton College-Eastlake,2013,All students total,614,104,510,-2
369905,Bryant & Stratton College-Eastlake,2013,"All students, Undergraduate total",614,104,510,-2
369905,Bryant & Stratton College-Eastlake,2013,"All students, Undergraduate, Degree/certificate-seeking total",613,103,510,-2
369905,Bryant & Stratton College-Eastlake,2013,"All students, Undergraduate, Degree/certificate-seeking, First-time",32,10,22,-2
369905,Bryant & Stratton College-Eastlake,2013,"All students, Undergraduate, Other degree/certificate-seeking",581,93,488,-2
369905,Bryant & Stratton College-Eastlake,2013,"All students, Undergraduate, Other degree/certifcate-seeking, Transfer-ins",93,10,83,-2
369905,Bryant & Stratton College-Eastlake,2013,"All students, Undergraduate, Other degree/certifcate-seeking, Continuing",488,83,405,-2
369905,Bryant & Stratton College-Eastlake,2013,"All students, Undergraduate, Non-degree/certificate-seeking",1,1,0,-2
372958,Remington College-Honolulu Campus,2013,All students total,495,118,377,-2
372958,Remington College-Honolulu Campus,2013,"All students, Undergraduate total",495,118,377,-2
372958,Remington College-Honolulu Campus,2013,"All students, Undergraduate, Degree/certificate-seeking total",495,118,377,-2
372958,Remington College-Honolulu Campus,2013,"All students, Undergraduate, Degree/certificate-seeking, First-time",144,28,116,-2
372958,Remington College-Honolulu Campus,2013,"All students, Undergraduate, Other degree/certificate-seeking",351,90,261,-2
372958,Remington College-Honolulu Campus,2013,"All students, Undergraduate, Other degree/certifcate-seeking, Transfer-ins",1,0,1,-2
372958,Remington College-Honolulu Campus,2013,"All students, Undergraduate, Other degree/certifcate-seeking, Continuing",350,90,260,-2
373827,New England School of Communications,2013,All students total,457,356,101,-2
373827,New England School of Communications,2013,"All students, Undergraduate total",457,356,101,-2
373827,New England School of Communications,2013,"All students, Undergraduate, Degree/certificate-seeking total",456,355,101,-2
373827,New England School of Communications,2013,"All students, Undergraduate, Degree/certificate-seeking, First-time",94,74,20,-2
373827,New England School of Communications,2013,"All students, Undergraduate, Other degree/certificate-seeking",362,281,81,-2
373827,New England School of Communications,2013,"All students, Undergraduate, Other degree/certifcate-seeking, Transfer-ins",22,20,2,-2
373827,New England School of Communications,2013,"All students, Undergraduate, Other degree/certifcate-seeking, Continuing",340,261,79,-2
373827,New England School of Communications,2013,"All students, Undergraduate, Non-degree/certificate-seeking",1,1,0,-2
374024,Adler Graduate School,2013,All students total,380,80,300,-2
374024,Adler Graduate School,2013,"All students, Graduate",380,80,300,-2
374972,Bryant & Stratton College-Southtowns,2013,All students total,570,160,410,-2
374972,Bryant & Stratton College-Southtowns,2013,"All students, Undergraduate total",570,160,410,-2
374972,Bryant & Stratton College-Southtowns,2013,"All students, Undergraduate, Degree/certificate-seeking total",499,129,370,-2
374972,Bryant & Stratton College-Southtowns,2013,"All students, Undergraduate, Degree/certificate-seeking, First-time",51,19,32,-2
374972,Bryant & Stratton College-Southtowns,2013,"All students, Undergraduate, Other degree/certificate-seeking",448,110,338,-2
374972,Bryant & Stratton College-Southtowns,2013,"All students, Undergraduate, Other degree/certifcate-seeking, Transfer-ins",84,26,58,-2
374972,Bryant & Stratton College-Southtowns,2013,"All students, Undergraduate, Other degree/certifcate-seeking, Continuing",364,84,280,-2
374972,Bryant & Stratton College-Southtowns,2013,"All students, Undergraduate, Non-degree/certificate-seeking",71,31,40,-2
375230,Yeshiva Gedolah Imrei Yosef D'spinka,2013,All students total,125,125,0,-2
375230,Yeshiva Gedolah Imrei Yosef D'spinka,2013,"All students, Undergraduate total",125,125,0,-2
375230,Yeshiva Gedolah Imrei Yosef D'spinka,2013,"All students, Undergraduate, Degree/certificate-seeking total",125,125,0,-2
375230,Yeshiva Gedolah Imrei Yosef D'spinka,2013,"All students, Undergraduate, Degree/certificate-seeking, First-time",10,10,0,-2
375230,Yeshiva Gedolah Imrei Yosef D'spinka,2013,"All students, Undergraduate, Other degree/certificate-seeking",115,115,0,-2
375230,Yeshiva Gedolah Imrei Yosef D'spinka,2013,"All students, Undergraduate, Other degree/certifcate-seeking, Transfer-ins",40,40,0,-2
375230,Yeshiva Gedolah Imrei Yosef D'spinka,2013,"All students, Undergraduate, Other degree/certifcate-seeking, Continuing",75,75,0,-2
375489,Brown Mackie College-Findlay,2013,All students total,448,64,384,-2
375489,Brown Mackie College-Findlay,2013,"All students, Undergraduate total",448,64,384,-2
375489,Brown Mackie College-Findlay,2013,"All students, Undergraduate, Degree/certificate-seeking total",448,64,384,-2
375489,Brown Mackie College-Findlay,2013,"All students, Undergraduate, Degree/certificate-seeking, First-time",86,11,75,-2
375489,Brown Mackie College-Findlay,2013,"All students, Undergraduate, Other degree/certificate-seeking",362,53,309,-2
375489,Brown Mackie College-Findlay,2013,"All students, Undergraduate, Other degree/certifcate-seeking, Transfer-ins",24,3,21,-2
375489,Brown Mackie College-Findlay,2013,"All students, Undergraduate, Other degree/certifcate-seeking, Continuing",338,50,288,-2
381352,Colorado School of Traditional Chinese Medicine,2013,All students total,136,36,100,-2
381352,Colorado School of Traditional Chinese Medicine,2013,"All students, Graduate",136,36,100,-2
381617,Baker College of Port Huron,2013,All students total,1039,275,764,-2
381617,Baker College of Port Huron,2013,"All students, Undergraduate total",1039,275,764,-2
381617,Baker College of Port Huron,2013,"All students, Undergraduate, Degree/certificate-seeking total",1036,274,762,-2
381617,Baker College of Port Huron,2013,"All students, Undergraduate, Degree/certificate-seeking, First-time",170,71,99,-2
381617,Baker College of Port Huron,2013,"All students, Undergraduate, Other degree/certificate-seeking",866,203,663,-2
381617,Baker College of Port Huron,2013,"All students, Undergraduate, Other degree/certifcate-seeking, Transfer-ins",64,15,49,-2
381617,Baker College of Port Huron,2013,"All students, Undergraduate, Other degree/certifcate-seeking, Continuing",802,188,614,-2
381617,Baker College of Port Huron,2013,"All students, Undergraduate, Non-degree/certificate-seeking",3,1,2,-2
381787,Westwood College-Denver South,2013,All students total,275,121,154,-2
381787,Westwood College-Denver South,2013,"All students, Undergraduate total",275,121,154,-2
381787,Westwood College-Denver South,2013,"All students, Undergraduate, Degree/certificate-seeking total",275,121,154,-2
381787,Westwood College-Denver South,2013,"All students, Undergraduate, Degree/certificate-seeking, First-time",20,12,8,-2
381787,Westwood College-Denver South,2013,"All students, Undergraduate, Other degree/certificate-seeking",255,109,146,-2
381787,Westwood College-Denver South,2013,"All students, Undergraduate, Other degree/certifcate-seeking, Transfer-ins",1,0,1,-2
381787,Westwood College-Denver South,2013,"All students, Undergraduate, Other degree/certifcate-seeking, Continuing",254,109,145,-2
384421,Rabbi Jacob Joseph School,2013,All students total,86,86,0,-2
384421,Rabbi Jacob Joseph School,2013,"All students, Undergraduate total",86,86,0,-2
384421,Rabbi Jacob Joseph School,2013,"All students, Undergraduate, Degree/certificate-seeking total",86,86,0,-2
384421,Rabbi Jacob Joseph School,2013,"All students, Undergraduate, Degree/certificate-seeking, First-time",32,32,0,-2
384421,Rabbi Jacob Joseph School,2013,"All students, Undergraduate, Other degree/certificate-seeking",54,54,0,-2
384421,Rabbi Jacob Joseph School,2013,"All students, Undergraduate, Other degree/certifcate-seeking, Transfer-ins",1,1,0,-2
384421,Rabbi Jacob Joseph School,2013,"All students, Undergraduate, Other degree/certifcate-seeking, Continuing",53,53,0,-2
402828,Widener University-Harrisburg Campus,2013,All students total,381,164,217,-2
402828,Widener University-Harrisburg Campus,2013,"All students, Graduate",381,164,217,-2
404073,Baker College of Auburn Hills,2013,All students total,3105,861,2244,-2
404073,Baker College of Auburn Hills,2013,"All students, Undergraduate total",3082,851,2231,-2
404073,Baker College of Auburn Hills,2013,"All students, Undergraduate, Degree/certificate-seeking total",3066,844,2222,-2
404073,Baker College of Auburn Hills,2013,"All students, Undergraduate, Degree/certificate-seeking, First-time",315,108,207,-2
404073,Baker College of Auburn Hills,2013,"All students, Undergraduate, Other degree/certificate-seeking",2751,736,2015,-2
404073,Baker College of Auburn Hills,2013,"All students, Undergraduate, Other degree/certifcate-seeking, Transfer-ins",384,100,284,-2
404073,Baker College of Auburn Hills,2013,"All students, Undergraduate, Other degree/certifcate-seeking, Continuing",2367,636,1731,-2
404073,Baker College of Auburn Hills,2013,"All students, Undergraduate, Non-degree/certificate-seeking",16,7,9,-2
404073,Baker College of Auburn Hills,2013,"All students, Graduate",23,10,13,-2
404082,Baker College of Clinton Township,2013,All students total,4383,1374,3009,-2
404082,Baker College of Clinton Township,2013,"All students, Undergraduate total",4358,1367,2991,-2
404082,Baker College of Clinton Township,2013,"All students, Undergraduate, Degree/certificate-seeking total",4345,1363,2982,-2
404082,Baker College of Clinton Township,2013,"All students, Undergraduate, Degree/certificate-seeking, First-time",715,264,451,-2
404082,Baker College of Clinton Township,2013,"All students, Undergraduate, Other degree/certificate-seeking",3630,1099,2531,-2
404082,Baker College of Clinton Township,2013,"All students, Undergraduate, Other degree/certifcate-seeking, Transfer-ins",327,98,229,-2
404082,Baker College of Clinton Township,2013,"All students, Undergraduate, Other degree/certifcate-seeking, Continuing",3303,1001,2302,-2
404082,Baker College of Clinton Township,2013,"All students, Undergraduate, Non-degree/certificate-seeking",13,4,9,-2
404082,Baker College of Clinton Township,2013,"All students, Graduate",25,7,18,-2
404480,University System of Maryland-Research Centers,2013,,,,,-2
404648,Baker College of Cadillac,2013,All students total,1549,503,1046,-2
404648,Baker College of Cadillac,2013,"All students, Undergraduate total",1545,503,1042,-2
404648,Baker College of Cadillac,2013,"All students, Undergraduate, Degree/certificate-seeking total",1534,501,1033,-2
404648,Baker College of Cadillac,2013,"All students, Undergraduate, Degree/certificate-seeking, First-time",302,129,173,-2
404648,Baker College of Cadillac,2013,"All students, Undergraduate, Other degree/certificate-seeking",1232,372,860,-2
404648,Baker College of Cadillac,2013,"All students, Undergraduate, Other degree/certifcate-seeking, Transfer-ins",101,32,69,-2
404648,Baker College of Cadillac,2013,"All students, Undergraduate, Other degree/certifcate-seeking, Continuing",1131,340,791,-2
404648,Baker College of Cadillac,2013,"All students, Undergraduate, Non-degree/certificate-seeking",11,2,9,-2
404648,Baker College of Cadillac,2013,"All students, Graduate",4,0,4,-2
405058,Yeshivas Novominsk,2013,All students total,118,118,0,-2
405058,Yeshivas Novominsk,2013,"All students, Undergraduate total",118,118,0,-2
405058,Yeshivas Novominsk,2013,"All students, Undergraduate, Degree/certificate-seeking total",118,118,0,-2
405058,Yeshivas Novominsk,2013,"All students, Undergraduate, Degree/certificate-seeking, First-time",42,42,0,-2
405058,Yeshivas Novominsk,2013,"All students, Undergraduate, Other degree/certificate-seeking",76,76,0,-2
405058,Yeshivas Novominsk,2013,"All students, Undergraduate, Other degree/certifcate-seeking, Continuing",76,76,0,-2
405854,Rabbinical College of Ohr Shimon Yisroel,2013,All students total,155,155,0,-2
405854,Rabbinical College of Ohr Shimon Yisroel,2013,"All students, Undergraduate total",155,155,0,-2
405854,Rabbinical College of Ohr Shimon Yisroel,2013,"All students, Undergraduate, Degree/certificate-seeking total",155,155,0,-2
405854,Rabbinical College of Ohr Shimon Yisroel,2013,"All students, Undergraduate, Degree/certificate-seeking, First-time",27,27,0,-2
405854,Rabbinical College of Ohr Shimon Yisroel,2013,"All students, Undergraduate, Other degree/certificate-seeking",128,128,0,-2
405854,Rabbinical College of Ohr Shimon Yisroel,2013,"All students, Undergraduate, Other degree/certifcate-seeking, Continuing",128,128,0,-2
405988,University of Phoenix-Colorado Campus,2013,All students total,2106,920,1186,405988
405988,University of Phoenix-Colorado Campus,2013,"All students, Undergraduate total",1662,761,901,405988
405988,University of Phoenix-Colorado Campus,2013,"All students, Undergraduate, Degree/certificate-seeking total",1661,761,900,405988
405988,University of Phoenix-Colorado Campus,2013,"All students, Undergraduate, Degree/certificate-seeking, First-time",19,10,9,405988
405988,University of Phoenix-Colorado Campus,2013,"All students, Undergraduate, Other degree/certificate-seeking",1642,751,891,405988
405988,University of Phoenix-Colorado Campus,2013,"All students, Undergraduate, Other degree/certifcate-seeking, Transfer-ins",129,55,74,405988
405988,University of Phoenix-Colorado Campus,2013,"All students, Undergraduate, Other degree/certifcate-seeking, Continuing",1513,696,817,405988
405988,University of Phoenix-Colorado Campus,2013,"All students, Undergraduate, Non-degree/certificate-seeking",1,0,1,405988
405988,University of Phoenix-Colorado Campus,2013,"All students, Graduate",444,159,285,405988
407285,Minnesota School of Business-Brooklyn Center,2013,All students total,169,58,111,-2
407285,Minnesota School of Business-Brooklyn Center,2013,"All students, Undergraduate total",169,58,111,-2
407285,Minnesota School of Business-Brooklyn Center,2013,"All students, Undergraduate, Degree/certificate-seeking total",162,55,107,-2
407285,Minnesota School of Business-Brooklyn Center,2013,"All students, Undergraduate, Degree/certificate-seeking, First-time",12,6,6,-2
407285,Minnesota School of Business-Brooklyn Center,2013,"All students, Undergraduate, Other degree/certificate-seeking",150,49,101,-2
407285,Minnesota School of Business-Brooklyn Center,2013,"All students, Undergraduate, Other degree/certifcate-seeking, Transfer-ins",31,9,22,-2
407285,Minnesota School of Business-Brooklyn Center,2013,"All students, Undergraduate, Other degree/certifcate-seeking, Continuing",119,40,79,-2
407285,Minnesota School of Business-Brooklyn Center,2013,"All students, Undergraduate, Non-degree/certificate-seeking",7,3,4,-2
407319,ITT Technical Institute-Omaha,2013,All students total,505,330,175,-2
407319,ITT Technical Institute-Omaha,2013,"All students, Undergraduate total",505,330,175,-2
407319,ITT Technical Institute-Omaha,2013,"All students, Undergraduate, Degree/certificate-seeking total",505,330,175,-2
407319,ITT Technical Institute-Omaha,2013,"All students, Undergraduate, Degree/certificate-seeking, First-time",79,46,33,-2
407319,ITT Technical Institute-Omaha,2013,"All students, Undergraduate, Other degree/certificate-seeking",426,284,142,-2
407319,ITT Technical Institute-Omaha,2013,"All students, Undergraduate, Other degree/certifcate-seeking, Transfer-ins",22,11,11,-2
407319,ITT Technical Institute-Omaha,2013,"All students, Undergraduate, Other degree/certifcate-seeking, Continuing",404,273,131,-2
407629,Lake Erie College of Osteopathic Medicine,2013,All students total,3594,1947,1647,-2
407629,Lake Erie College of Osteopathic Medicine,2013,"All students, Graduate",3594,1947,1647,-2
409616,Roger Williams University School of Law,2013,All students total,420,206,214,-2
409616,Roger Williams University School of Law,2013,"All students, Graduate",420,206,214,-2
413413,Capella University,2013,All students total,34007,8527,25480,-2
413413,Capella University,2013,"All students, Undergraduate total",7947,2586,5361,-2
413413,Capella University,2013,"All students, Undergraduate, Degree/certificate-seeking total",7935,2582,5353,-2
413413,Capella University,2013,"All students, Undergraduate, Degree/certificate-seeking, First-time",142,57,85,-2
413413,Capella University,2013,"All students, Undergraduate, Other degree/certificate-seeking",7793,2525,5268,-2
413413,Capella University,2013,"All students, Undergraduate, Other degree/certifcate-seeking, Transfer-ins",512,133,379,-2
413413,Capella University,2013,"All students, Undergraduate, Other degree/certifcate-seeking, Continuing",7281,2392,4889,-2
413413,Capella University,2013,"All students, Undergraduate, Non-degree/certificate-seeking",12,4,8,-2
413413,Capella University,2013,"All students, Graduate",26060,5941,20119,-2
414160,Baker College of Jackson,2013,All students total,2257,597,1660,-2
414160,Baker College of Jackson,2013,"All students, Undergraduate total",2239,592,1647,-2
414160,Baker College of Jackson,2013,"All students, Undergraduate, Degree/certificate-seeking total",2202,581,1621,-2
414160,Baker College of Jackson,2013,"All students, Undergraduate, Degree/certificate-seeking, First-time",286,105,181,-2
414160,Baker College of Jackson,2013,"All students, Undergraduate, Other degree/certificate-seeking",1916,476,1440,-2
414160,Baker College of Jackson,2013,"All students, Undergraduate, Other degree/certifcate-seeking, Transfer-ins",230,73,157,-2
414160,Baker College of Jackson,2013,"All students, Undergraduate, Other degree/certifcate-seeking, Continuing",1686,403,1283,-2
414160,Baker College of Jackson,2013,"All students, Undergraduate, Non-degree/certificate-seeking",37,11,26,-2
414160,Baker College of Jackson,2013,"All students, Graduate",18,5,13,-2
414595,Pacific College of Oriental Medicine-New York,2013,All students total,602,160,442,-2
414595,Pacific College of Oriental Medicine-New York,2013,"All students, Undergraduate total",145,39,106,-2
414595,Pacific College of Oriental Medicine-New York,2013,"All students, Undergraduate, Degree/certificate-seeking total",139,38,101,-2
414595,Pacific College of Oriental Medicine-New York,2013,"All students, Undergraduate, Degree/certificate-seeking, First-time",15,5,10,-2
414595,Pacific College of Oriental Medicine-New York,2013,"All students, Undergraduate, Other degree/certificate-seeking",124,33,91,-2
414595,Pacific College of Oriental Medicine-New York,2013,"All students, Undergraduate, Other degree/certifcate-seeking, Transfer-ins",11,3,8,-2
414595,Pacific College of Oriental Medicine-New York,2013,"All students, Undergraduate, Other degree/certifcate-seeking, Continuing",113,30,83,-2
414595,Pacific College of Oriental Medicine-New York,2013,"All students, Undergraduate, Non-degree/certificate-seeking",6,1,5,-2
414595,Pacific College of Oriental Medicine-New York,2013,"All students, Graduate",457,121,336,-2
414708,Baker College Center for Graduate Studies,2013,All students total,5270,1815,3455,-2
414708,Baker College Center for Graduate Studies,2013,"All students, Undergraduate total",4513,1560,2953,-2
414708,Baker College Center for Graduate Studies,2013,"All students, Undergraduate, Degree/certificate-seeking total",4449,1537,2912,-2
414708,Baker College Center for Graduate Studies,2013,"All students, Undergraduate, Degree/certificate-seeking, First-time",195,78,117,-2
414708,Baker College Center for Graduate Studies,2013,"All students, Undergraduate, Other degree/certificate-seeking",4254,1459,2795,-2
414708,Baker College Center for Graduate Studies,2013,"All students, Undergraduate, Other degree/certifcate-seeking, Transfer-ins",357,116,241,-2
414708,Baker College Center for Graduate Studies,2013,"All students, Undergraduate, Other degree/certifcate-seeking, Continuing",3897,1343,2554,-2
414708,Baker College Center for Graduate Studies,2013,"All students, Undergraduate, Non-degree/certificate-seeking",64,23,41,-2
414708,Baker College Center for Graduate Studies,2013,"All students, Graduate",757,255,502,-2
418126,New York College of Health Professions,2013,All students total,782,231,551,-2
418126,New York College of Health Professions,2013,"All students, Undergraduate total",537,159,378,-2
418126,New York College of Health Professions,2013,"All students, Undergraduate, Degree/certificate-seeking total",529,158,371,-2
418126,New York College of Health Professions,2013,"All students, Undergraduate, Degree/certificate-seeking, First-time",64,14,50,-2
418126,New York College of Health Professions,2013,"All students, Undergraduate, Other degree/certificate-seeking",465,144,321,-2
418126,New York College of Health Professions,2013,"All students, Undergraduate, Other degree/certifcate-seeking, Transfer-ins",82,25,57,-2
418126,New York College of Health Professions,2013,"All students, Undergraduate, Other degree/certifcate-seeking, Continuing",383,119,264,-2
418126,New York College of Health Professions,2013,"All students, Undergraduate, Non-degree/certificate-seeking",8,1,7,-2
418126,New York College of Health Professions,2013,"All students, Graduate",245,72,173,-2
419457,Argosy University-Washington DC,2013,All students total,925,220,705,-2
419457,Argosy University-Washington DC,2013,"All students, Undergraduate total",134,47,87,-2
419457,Argosy University-Washington DC,2013,"All students, Undergraduate, Degree/certificate-seeking total",126,45,81,-2
419457,Argosy University-Washington DC,2013,"All students, Undergraduate, Degree/certificate-seeking, First-time",19,5,14,-2
419457,Argosy University-Washington DC,2013,"All students, Undergraduate, Other degree/certificate-seeking",107,40,67,-2
419457,Argosy University-Washington DC,2013,"All students, Undergraduate, Other degree/certifcate-seeking, Transfer-ins",18,7,11,-2
419457,Argosy University-Washington DC,2013,"All students, Undergraduate, Other degree/certifcate-seeking, Continuing",89,33,56,-2
419457,Argosy University-Washington DC,2013,"All students, Undergraduate, Non-degree/certificate-seeking",8,2,6,-2
419457,Argosy University-Washington DC,2013,"All students, Graduate",791,173,618,-2
420042,University of Phoenix-Hawaii Campus,2013,All students total,1454,828,626,-2
420042,University of Phoenix-Hawaii Campus,2013,"All students, Undergraduate total",1281,730,551,-2
420042,University of Phoenix-Hawaii Campus,2013,"All students, Undergraduate, Degree/certificate-seeking total",1281,730,551,-2
420042,University of Phoenix-Hawaii Campus,2013,"All students, Undergraduate, Degree/certificate-seeking, First-time",19,5,14,-2
420042,University of Phoenix-Hawaii Campus,2013,"All students, Undergraduate, Other degree/certificate-seeking",1262,725,537,-2
420042,University of Phoenix-Hawaii Campus,2013,"All students, Undergraduate, Other degree/certifcate-seeking, Transfer-ins",121,75,46,-2
420042,University of Phoenix-Hawaii Campus,2013,"All students, Undergraduate, Other degree/certifcate-seeking, Continuing",1141,650,491,-2
420042,University of Phoenix-Hawaii Campus,2013,"All students, Graduate",173,98,75,-2
420325,Yeshiva D'monsey Rabbinical College,2013,All students total,53,53,0,-2
420325,Yeshiva D'monsey Rabbinical College,2013,"All students, Undergraduate total",48,48,0,-2
420325,Yeshiva D'monsey Rabbinical College,2013,"All students, Undergraduate, Degree/certificate-seeking total",48,48,0,-2
420325,Yeshiva D'monsey Rabbinical College,2013,"All students, Undergraduate, Degree/certificate-seeking, First-time",8,8,0,-2
420325,Yeshiva D'monsey Rabbinical College,2013,"All students, Undergraduate, Other degree/certificate-seeking",40,40,0,-2
420325,Yeshiva D'monsey Rabbinical College,2013,"All students, Undergraduate, Other degree/certifcate-seeking, Transfer-ins",2,2,0,-2
420325,Yeshiva D'monsey Rabbinical College,2013,"All students, Undergraduate, Other degree/certifcate-seeking, Continuing",38,38,0,-2
420325,Yeshiva D'monsey Rabbinical College,2013,"All students, Graduate",5,5,0,-2
421018,University of Phoenix-Detroit Campus,2013,All students total,1249,345,904,-2
421018,University of Phoenix-Detroit Campus,2013,"All students, Undergraduate total",980,273,707,-2
421018,University of Phoenix-Detroit Campus,2013,"All students, Undergraduate, Degree/certificate-seeking total",980,273,707,-2
421018,University of Phoenix-Detroit Campus,2013,"All students, Undergraduate, Degree/certificate-seeking, First-time",70,20,50,-2
421018,University of Phoenix-Detroit Campus,2013,"All students, Undergraduate, Other degree/certificate-seeking",910,253,657,-2
421018,University of Phoenix-Detroit Campus,2013,"All students, Undergraduate, Other degree/certifcate-seeking, Transfer-ins",87,19,68,-2
421018,University of Phoenix-Detroit Campus,2013,"All students, Undergraduate, Other degree/certifcate-seeking, Continuing",823,234,589,-2
421018,University of Phoenix-Detroit Campus,2013,"All students, Graduate",269,72,197,-2
430087,Colorado Technical University-Greenwood Village,2013,All students total,869,460,409,-2
430087,Colorado Technical University-Greenwood Village,2013,"All students, Undergraduate total",645,343,302,-2
430087,Colorado Technical University-Greenwood Village,2013,"All students, Undergraduate, Degree/certificate-seeking total",644,342,302,-2
430087,Colorado Technical University-Greenwood Village,2013,"All students, Undergraduate, Degree/certificate-seeking, First-time",34,5,29,-2
430087,Colorado Technical University-Greenwood Village,2013,"All students, Undergraduate, Other degree/certificate-seeking",610,337,273,-2
430087,Colorado Technical University-Greenwood Village,2013,"All students, Undergraduate, Other degree/certifcate-seeking, Transfer-ins",69,7,62,-2
430087,Colorado Technical University-Greenwood Village,2013,"All students, Undergraduate, Other degree/certifcate-seeking, Continuing",541,330,211,-2
430087,Colorado Technical University-Greenwood Village,2013,"All students, Undergraduate, Non-degree/certificate-seeking",1,1,0,-2
430087,Colorado Technical University-Greenwood Village,2013,"All students, Graduate",224,117,107,-2
430184,Strayer University-Maryland,2013,All students total,3074,1098,1976,-2
430184,Strayer University-Maryland,2013,"All students, Undergraduate total",2062,732,1330,-2
430184,Strayer University-Maryland,2013,"All students, Undergraduate, Degree/certificate-seeking total",2038,724,1314,-2
430184,Strayer University-Maryland,2013,"All students, Undergraduate, Degree/certificate-seeking, First-time",214,66,148,-2
430184,Strayer University-Maryland,2013,"All students, Undergraduate, Other degree/certificate-seeking",1824,658,1166,-2
430184,Strayer University-Maryland,2013,"All students, Undergraduate, Other degree/certifcate-seeking, Transfer-ins",145,64,81,-2
430184,Strayer University-Maryland,2013,"All students, Undergraduate, Other degree/certifcate-seeking, Continuing",1679,594,1085,-2
430184,Strayer University-Maryland,2013,"All students, Undergraduate, Non-degree/certificate-seeking",24,8,16,-2
430184,Strayer University-Maryland,2013,"All students, Graduate",1012,366,646,-2
430379,ITT Technical Institute-Norwood,2013,All students total,419,277,142,-2
430379,ITT Technical Institute-Norwood,2013,"All students, Undergraduate total",419,277,142,-2
430379,ITT Technical Institute-Norwood,2013,"All students, Undergraduate, Degree/certificate-seeking total",419,277,142,-2
430379,ITT Technical Institute-Norwood,2013,"All students, Undergraduate, Degree/certificate-seeking, First-time",60,42,18,-2
430379,ITT Technical Institute-Norwood,2013,"All students, Undergraduate, Other degree/certificate-seeking",359,235,124,-2
430379,ITT Technical Institute-Norwood,2013,"All students, Undergraduate, Other degree/certifcate-seeking, Transfer-ins",8,5,3,-2
430379,ITT Technical Institute-Norwood,2013,"All students, Undergraduate, Other degree/certifcate-seeking, Continuing",351,230,121,-2
430388,ITT Technical Institute-Strongsville,2013,All students total,391,249,142,-2
430388,ITT Technical Institute-Strongsville,2013,"All students, Undergraduate total",391,249,142,-2
430388,ITT Technical Institute-Strongsville,2013,"All students, Undergraduate, Degree/certificate-seeking total",391,249,142,-2
430388,ITT Technical Institute-Strongsville,2013,"All students, Undergraduate, Degree/certificate-seeking, First-time",52,32,20,-2
430388,ITT Technical Institute-Strongsville,2013,"All students, Undergraduate, Other degree/certificate-seeking",339,217,122,-2
430388,ITT Technical Institute-Strongsville,2013,"All students, Undergraduate, Other degree/certifcate-seeking, Transfer-ins",16,6,10,-2
430388,ITT Technical Institute-Strongsville,2013,"All students, Undergraduate, Other degree/certifcate-seeking, Continuing",323,211,112,-2
430485,The Creative Center,2013,All students total,86,31,55,-2
430485,The Creative Center,2013,"All students, Undergraduate total",86,31,55,-2
430485,The Creative Center,2013,"All students, Undergraduate, Degree/certificate-seeking total",86,31,55,-2
430485,The Creative Center,2013,"All students, Undergraduate, Degree/certificate-seeking, First-time",23,8,15,-2
430485,The Creative Center,2013,"All students, Undergraduate, Other degree/certificate-seeking",63,23,40,-2
430485,The Creative Center,2013,"All students, Undergraduate, Other degree/certifcate-seeking, Transfer-ins",6,3,3,-2
430485,The Creative Center,2013,"All students, Undergraduate, Other degree/certifcate-seeking, Continuing",57,20,37,-2
430810,New Hampshire Institute of Art,2013,All students total,506,149,357,-2
430810,New Hampshire Institute of Art,2013,"All students, Undergraduate total",470,131,339,-2
430810,New Hampshire Institute of Art,2013,"All students, Undergraduate, Degree/certificate-seeking total",470,131,339,-2
430810,New Hampshire Institute of Art,2013,"All students, Undergraduate, Degree/certificate-seeking, First-time",107,30,77,-2
430810,New Hampshire Institute of Art,2013,"All students, Undergraduate, Other degree/certificate-seeking",363,101,262,-2
430810,New Hampshire Institute of Art,2013,"All students, Undergraduate, Other degree/certifcate-seeking, Transfer-ins",25,10,15,-2
430810,New Hampshire Institute of Art,2013,"All students, Undergraduate, Other degree/certifcate-seeking, Continuing",338,91,247,-2
430810,New Hampshire Institute of Art,2013,"All students, Graduate",36,18,18,-2
431594,Massachusetts General Hospital Dietetic Internship,2013,All students total,20,0,20,-2
431594,Massachusetts General Hospital Dietetic Internship,2013,"All students, Graduate",20,0,20,-2
431983,Yeshiva of the Telshe Alumni,2013,All students total,126,126,0,-2
431983,Yeshiva of the Telshe Alumni,2013,"All students, Undergraduate total",126,126,0,-2
431983,Yeshiva of the Telshe Alumni,2013,"All students, Undergraduate, Degree/certificate-seeking total",126,126,0,-2
431983,Yeshiva of the Telshe Alumni,2013,"All students, Undergraduate, Degree/certificate-seeking, First-time",37,37,0,-2
431983,Yeshiva of the Telshe Alumni,2013,"All students, Undergraduate, Other degree/certificate-seeking",89,89,0,-2
431983,Yeshiva of the Telshe Alumni,2013,"All students, Undergraduate, Other degree/certifcate-seeking, Transfer-ins",2,2,0,-2
431983,Yeshiva of the Telshe Alumni,2013,"All students, Undergraduate, Other degree/certifcate-seeking, Continuing",87,87,0,-2
432199,DeVry College of New York,2013,,,,,-2
432348,Appalachian School of Law,2013,All students total,219,133,86,-2
432348,Appalachian School of Law,2013,"All students, Graduate",219,133,86,-2
432357,LIU Hudson at Westchester,2013,All students total,205,34,171,-2
432357,LIU Hudson at Westchester,2013,"All students, Graduate",205,34,171,-2
434034,National Labor College,2013,All students total,623,430,193,-2
434034,National Labor College,2013,"All students, Undergraduate total",623,430,193,-2
434034,National Labor College,2013,"All students, Undergraduate, Degree/certificate-seeking total",498,352,146,-2
434034,National Labor College,2013,"All students, Undergraduate, Degree/certificate-seeking, First-time",10,6,4,-2
434034,National Labor College,2013,"All students, Undergraduate, Other degree/certificate-seeking",488,346,142,-2
434034,National Labor College,2013,"All students, Undergraduate, Other degree/certifcate-seeking, Transfer-ins",119,78,41,-2
434034,National Labor College,2013,"All students, Undergraduate, Other degree/certifcate-seeking, Continuing",369,268,101,-2
434034,National Labor College,2013,"All students, Undergraduate, Non-degree/certificate-seeking",125,78,47,-2
434414,Michigan Jewish Institute,2013,All students total,1662,749,913,-2
434414,Michigan Jewish Institute,2013,"All students, Undergraduate total",1662,749,913,-2
434414,Michigan Jewish Institute,2013,"All students, Undergraduate, Degree/certificate-seeking total",1642,744,898,-2
434414,Michigan Jewish Institute,2013,"All students, Undergraduate, Degree/certificate-seeking, First-time",661,244,417,-2
434414,Michigan Jewish Institute,2013,"All students, Undergraduate, Other degree/certificate-seeking",981,500,481,-2
434414,Michigan Jewish Institute,2013,"All students, Undergraduate, Other degree/certifcate-seeking, Transfer-ins",301,142,159,-2
434414,Michigan Jewish Institute,2013,"All students, Undergraduate, Other degree/certifcate-seeking, Continuing",680,358,322,-2
434414,Michigan Jewish Institute,2013,"All students, Undergraduate, Non-degree/certificate-seeking",20,5,15,-2
434937,Yeshiva College of the Nations Capital,2013,All students total,45,45,0,-2
434937,Yeshiva College of the Nations Capital,2013,"All students, Undergraduate total",45,45,0,-2
434937,Yeshiva College of the Nations Capital,2013,"All students, Undergraduate, Degree/certificate-seeking total",23,23,0,-2
434937,Yeshiva College of the Nations Capital,2013,"All students, Undergraduate, Degree/certificate-seeking, First-time",1,1,0,-2
434937,Yeshiva College of the Nations Capital,2013,"All students, Undergraduate, Other degree/certificate-seeking",22,22,0,-2
434937,Yeshiva College of the Nations Capital,2013,"All students, Undergraduate, Other degree/certifcate-seeking, Transfer-ins",8,8,0,-2
434937,Yeshiva College of the Nations Capital,2013,"All students, Undergraduate, Other degree/certifcate-seeking, Continuing",14,14,0,-2
434937,Yeshiva College of the Nations Capital,2013,"All students, Undergraduate, Non-degree/certificate-seeking",22,22,0,-2
434973,University of Phoenix-Maryland Campus,2013,All students total,560,326,234,-2
434973,University of Phoenix-Maryland Campus,2013,"All students, Undergraduate total",479,284,195,-2
434973,University of Phoenix-Maryland Campus,2013,"All students, Undergraduate, Degree/certificate-seeking total",479,284,195,-2
434973,University of Phoenix-Maryland Campus,2013,"All students, Undergraduate, Degree/certificate-seeking, First-time",7,4,3,-2
434973,University of Phoenix-Maryland Campus,2013,"All students, Undergraduate, Other degree/certificate-seeking",472,280,192,-2
434973,University of Phoenix-Maryland Campus,2013,"All students, Undergraduate, Other degree/certifcate-seeking, Transfer-ins",38,25,13,-2
434973,University of Phoenix-Maryland Campus,2013,"All students, Undergraduate, Other degree/certifcate-seeking, Continuing",434,255,179,-2
434973,University of Phoenix-Maryland Campus,2013,"All students, Graduate",81,42,39,-2
436261,Southwest Acupuncture College-Boulder,2013,All students total,138,42,96,-2
436261,Southwest Acupuncture College-Boulder,2013,"All students, Graduate",138,42,96,-2
436377,Watson School of Biological Sciences at Cold Spring Harbor Laboratory,2013,,,,,-2
436483,National American University-Bloomington,2013,All students total,509,160,349,-2
436483,National American University-Bloomington,2013,"All students, Undergraduate total",509,160,349,-2
436483,National American University-Bloomington,2013,"All students, Undergraduate, Degree/certificate-seeking total",509,160,349,-2
436483,National American University-Bloomington,2013,"All students, Undergraduate, Degree/certificate-seeking, First-time",30,11,19,-2
436483,National American University-Bloomington,2013,"All students, Undergraduate, Other degree/certificate-seeking",479,149,330,-2
436483,National American University-Bloomington,2013,"All students, Undergraduate, Other degree/certifcate-seeking, Transfer-ins",109,38,71,-2
436483,National American University-Bloomington,2013,"All students, Undergraduate, Other degree/certifcate-seeking, Continuing",370,111,259,-2
436818,University of Connecticut-Tri-Campus,2013,All students total,2518,1176,1342,-2
436818,University of Connecticut-Tri-Campus,2013,"All students, Undergraduate total",2518,1176,1342,-2
436818,University of Connecticut-Tri-Campus,2013,"All students, Undergraduate, Degree/certificate-seeking total",2382,1097,1285,-2
436818,University of Connecticut-Tri-Campus,2013,"All students, Undergraduate, Degree/certificate-seeking, First-time",661,333,328,-2
436818,University of Connecticut-Tri-Campus,2013,"All students, Undergraduate, Other degree/certificate-seeking",1721,764,957,-2
436818,University of Connecticut-Tri-Campus,2013,"All students, Undergraduate, Other degree/certifcate-seeking, Transfer-ins",165,70,95,-2
436818,University of Connecticut-Tri-Campus,2013,"All students, Undergraduate, Other degree/certifcate-seeking, Continuing",1556,694,862,-2
436818,University of Connecticut-Tri-Campus,2013,"All students, Undergraduate, Non-degree/certificate-seeking",136,79,57,-2
436827,University of Connecticut-Avery Point,2013,All students total,682,342,340,-2
436827,University of Connecticut-Avery Point,2013,"All students, Undergraduate total",682,342,340,-2
436827,University of Connecticut-Avery Point,2013,"All students, Undergraduate, Degree/certificate-seeking total",645,320,325,-2
436827,University of Connecticut-Avery Point,2013,"All students, Undergraduate, Degree/certificate-seeking, First-time",212,122,90,-2
436827,University of Connecticut-Avery Point,2013,"All students, Undergraduate, Other degree/certificate-seeking",433,198,235,-2
436827,University of Connecticut-Avery Point,2013,"All students, Undergraduate, Other degree/certifcate-seeking, Transfer-ins",57,30,27,-2
436827,University of Connecticut-Avery Point,2013,"All students, Undergraduate, Other degree/certifcate-seeking, Continuing",376,168,208,-2
436827,University of Connecticut-Avery Point,2013,"All students, Undergraduate, Non-degree/certificate-seeking",37,22,15,-2
436836,University of Connecticut-Stamford,2013,All students total,1363,635,728,-2
436836,University of Connecticut-Stamford,2013,"All students, Undergraduate total",1363,635,728,-2
436836,University of Connecticut-Stamford,2013,"All students, Undergraduate, Degree/certificate-seeking total",1224,548,676,-2
436836,University of Connecticut-Stamford,2013,"All students, Undergraduate, Degree/certificate-seeking, First-time",231,113,118,-2
436836,University of Connecticut-Stamford,2013,"All students, Undergraduate, Other degree/certificate-seeking",993,435,558,-2
436836,University of Connecticut-Stamford,2013,"All students, Undergraduate, Other degree/certifcate-seeking, Transfer-ins",119,40,79,-2
436836,University of Connecticut-Stamford,2013,"All students, Undergraduate, Other degree/certifcate-seeking, Continuing",874,395,479,-2
436836,University of Connecticut-Stamford,2013,"All students, Undergraduate, Non-degree/certificate-seeking",139,87,52,-2
437051,ITT Technical Institute-Richmond,2013,All students total,573,434,139,-2
437051,ITT Technical Institute-Richmond,2013,"All students, Undergraduate total",573,434,139,-2
437051,ITT Technical Institute-Richmond,2013,"All students, Undergraduate, Degree/certificate-seeking total",573,434,139,-2
437051,ITT Technical Institute-Richmond,2013,"All students, Undergraduate, Degree/certificate-seeking, First-time",96,69,27,-2
437051,ITT Technical Institute-Richmond,2013,"All students, Undergraduate, Other degree/certificate-seeking",477,365,112,-2
437051,ITT Technical Institute-Richmond,2013,"All students, Undergraduate, Other degree/certifcate-seeking, Transfer-ins",11,9,2,-2
437051,ITT Technical Institute-Richmond,2013,"All students, Undergraduate, Other degree/certifcate-seeking, Continuing",466,356,110,-2
437097,University of Management and Technology,2013,All students total,1044,768,276,-2
437097,University of Management and Technology,2013,"All students, Undergraduate total",785,567,218,-2
437097,University of Management and Technology,2013,"All students, Undergraduate, Degree/certificate-seeking total",781,563,218,-2
437097,University of Management and Technology,2013,"All students, Undergraduate, Degree/certificate-seeking, First-time",5,2,3,-2
437097,University of Management and Technology,2013,"All students, Undergraduate, Other degree/certificate-seeking",776,561,215,-2
437097,University of Management and Technology,2013,"All students, Undergraduate, Other degree/certifcate-seeking, Transfer-ins",160,118,42,-2
437097,University of Management and Technology,2013,"All students, Undergraduate, Other degree/certifcate-seeking, Continuing",616,443,173,-2
437097,University of Management and Technology,2013,"All students, Undergraduate, Non-degree/certificate-seeking",4,4,0,-2
437097,University of Management and Technology,2013,"All students, Graduate",259,201,58,-2
437343,DeVry University's Keller Graduate School of Management-Virginia,2013,,,,,-2
438382,University of Phoenix-Southern Colorado Campus,2013,,,,,405988
438416,University of Phoenix-West Michigan Campus,2013,All students total,306,88,218,-2
438416,University of Phoenix-West Michigan Campus,2013,"All students, Undergraduate total",271,77,194,-2
438416,University of Phoenix-West Michigan Campus,2013,"All students, Undergraduate, Degree/certificate-seeking total",271,77,194,-2
438416,University of Phoenix-West Michigan Campus,2013,"All students, Undergraduate, Other degree/certificate-seeking",271,77,194,-2
438416,University of Phoenix-West Michigan Campus,2013,"All students, Undergraduate, Other degree/certifcate-seeking, Continuing",271,77,194,-2
438416,University of Phoenix-West Michigan Campus,2013,"All students, Graduate",35,11,24,-2
438498,Stratford University,2013,All students total,2825,1037,1788,-2
438498,Stratford University,2013,"All students, Undergraduate total",2279,778,1501,-2
438498,Stratford University,2013,"All students, Undergraduate, Degree/certificate-seeking total",2271,774,1497,-2
438498,Stratford University,2013,"All students, Undergraduate, Degree/certificate-seeking, First-time",211,81,130,-2
438498,Stratford University,2013,"All students, Undergraduate, Other degree/certificate-seeking",2060,693,1367,-2
438498,Stratford University,2013,"All students, Undergraduate, Other degree/certifcate-seeking, Transfer-ins",137,34,103,-2
438498,Stratford University,2013,"All students, Undergraduate, Other degree/certifcate-seeking, Continuing",1923,659,1264,-2
438498,Stratford University,2013,"All students, Undergraduate, Non-degree/certificate-seeking",8,4,4,-2
438498,Stratford University,2013,"All students, Graduate",546,259,287,-2
438610,University of Phoenix-Philadelphia Campus,2013,All students total,739,237,502,-2
438610,University of Phoenix-Philadelphia Campus,2013,"All students, Undergraduate total",713,224,489,-2
438610,University of Phoenix-Philadelphia Campus,2013,"All students, Undergraduate, Degree/certificate-seeking total",713,224,489,-2
438610,University of Phoenix-Philadelphia Campus,2013,"All students, Undergraduate, Degree/certificate-seeking, First-time",46,12,34,-2
438610,University of Phoenix-Philadelphia Campus,2013,"All students, Undergraduate, Other degree/certificate-seeking",667,212,455,-2
438610,University of Phoenix-Philadelphia Campus,2013,"All students, Undergraduate, Other degree/certifcate-seeking, Transfer-ins",40,13,27,-2
438610,University of Phoenix-Philadelphia Campus,2013,"All students, Undergraduate, Other degree/certifcate-seeking, Continuing",627,199,428,-2
438610,University of Phoenix-Philadelphia Campus,2013,"All students, Graduate",26,13,13,-2
438629,University of Phoenix-Pittsburgh Campus,2013,All students total,43,18,25,-2
438629,University of Phoenix-Pittsburgh Campus,2013,"All students, Undergraduate total",37,14,23,-2
438629,University of Phoenix-Pittsburgh Campus,2013,"All students, Undergraduate, Degree/certificate-seeking total",37,14,23,-2
438629,University of Phoenix-Pittsburgh Campus,2013,"All students, Undergraduate, Other degree/certificate-seeking",37,14,23,-2
438629,University of Phoenix-Pittsburgh Campus,2013,"All students, Undergraduate, Other degree/certifcate-seeking, Continuing",37,14,23,-2
438629,University of Phoenix-Pittsburgh Campus,2013,"All students, Graduate",6,4,2,-2
439136,ITT Technical Institute-Wilmington,2013,All students total,403,368,35,-2
439136,ITT Technical Institute-Wilmington,2013,"All students, Undergraduate total",403,368,35,-2
439136,ITT Technical Institute-Wilmington,2013,"All students, Undergraduate, Degree/certificate-seeking total",403,368,35,-2
439136,ITT Technical Institute-Wilmington,2013,"All students, Undergraduate, Degree/certificate-seeking, First-time",62,56,6,-2
439136,ITT Technical Institute-Wilmington,2013,"All students, Undergraduate, Other degree/certificate-seeking",341,312,29,-2
439136,ITT Technical Institute-Wilmington,2013,"All students, Undergraduate, Other degree/certifcate-seeking, Continuing",341,312,29,-2
439288,Johnson & Wales University-Denver,2013,All students total,1529,621,908,-2
439288,Johnson & Wales University-Denver,2013,"All students, Undergraduate total",1506,617,889,-2
439288,Johnson & Wales University-Denver,2013,"All students, Undergraduate, Degree/certificate-seeking total",1506,617,889,-2
439288,Johnson & Wales University-Denver,2013,"All students, Undergraduate, Degree/certificate-seeking, First-time",337,124,213,-2
439288,Johnson & Wales University-Denver,2013,"All students, Undergraduate, Other degree/certificate-seeking",1169,493,676,-2
439288,Johnson & Wales University-Denver,2013,"All students, Undergraduate, Other degree/certifcate-seeking, Transfer-ins",132,59,73,-2
439288,Johnson & Wales University-Denver,2013,"All students, Undergraduate, Other degree/certifcate-seeking, Continuing",1037,434,603,-2
439288,Johnson & Wales University-Denver,2013,"All students, Graduate",23,4,19,-2
439297,University of Phoenix-Cleveland Campus,2013,All students total,385,102,283,-2
439297,University of Phoenix-Cleveland Campus,2013,"All students, Undergraduate total",333,88,245,-2
439297,University of Phoenix-Cleveland Campus,2013,"All students, Undergraduate, Degree/certificate-seeking total",333,88,245,-2
439297,University of Phoenix-Cleveland Campus,2013,"All students, Undergraduate, Degree/certificate-seeking, First-time",18,6,12,-2
439297,University of Phoenix-Cleveland Campus,2013,"All students, Undergraduate, Other degree/certificate-seeking",315,82,233,-2
439297,University of Phoenix-Cleveland Campus,2013,"All students, Undergraduate, Other degree/certifcate-seeking, Transfer-ins",31,3,28,-2
439297,University of Phoenix-Cleveland Campus,2013,"All students, Undergraduate, Other degree/certifcate-seeking, Continuing",284,79,205,-2
439297,University of Phoenix-Cleveland Campus,2013,"All students, Graduate",52,14,38,-2
439330,DeVry University-Maryland,2013,,,,,-2
439783,New York College of Traditional Chinese Medicine,2013,All students total,150,75,75,-2
439783,New York College of Traditional Chinese Medicine,2013,"All students, Undergraduate total",81,34,47,-2
439783,New York College of Traditional Chinese Medicine,2013,"All students, Undergraduate, Degree/certificate-seeking total",64,27,37,-2
439783,New York College of Traditional Chinese Medicine,2013,"All students, Undergraduate, Other degree/certificate-seeking",64,27,37,-2
439783,New York College of Traditional Chinese Medicine,2013,"All students, Undergraduate, Other degree/certifcate-seeking, Transfer-ins",25,10,15,-2
439783,New York College of Traditional Chinese Medicine,2013,"All students, Undergraduate, Other degree/certifcate-seeking, Continuing",39,17,22,-2
439783,New York College of Traditional Chinese Medicine,2013,"All students, Undergraduate, Non-degree/certificate-seeking",17,7,10,-2
439783,New York College of Traditional Chinese Medicine,2013,"All students, Graduate",69,41,28,-2
439817,Northeastern Seminary,2013,All students total,170,101,69,-2
439817,Northeastern Seminary,2013,"All students, Graduate",170,101,69,-2
440004,Upper Valley Educators Institute,2013,All students total,35,13,22,-2
440004,Upper Valley Educators Institute,2013,"All students, Graduate",35,13,22,-2
440138,Antioch University-System Administration,2013,,,,,-2
440341,The Art Institute of Washington,2013,All students total,1499,816,683,-2
440341,The Art Institute of Washington,2013,"All students, Undergraduate total",1499,816,683,-2
440341,The Art Institute of Washington,2013,"All students, Undergraduate, Degree/certificate-seeking total",1485,805,680,-2
440341,The Art Institute of Washington,2013,"All students, Undergraduate, Degree/certificate-seeking, First-time",405,223,182,-2
440341,The Art Institute of Washington,2013,"All students, Undergraduate, Other degree/certificate-seeking",1080,582,498,-2
440341,The Art Institute of Washington,2013,"All students, Undergraduate, Other degree/certifcate-seeking, Transfer-ins",211,103,108,-2
440341,The Art Institute of Washington,2013,"All students, Undergraduate, Other degree/certifcate-seeking, Continuing",869,479,390,-2
440341,The Art Institute of Washington,2013,"All students, Undergraduate, Non-degree/certificate-seeking",14,11,3,-2
440396,New Saint Andrews College,2013,All students total,178,76,102,-2
440396,New Saint Andrews College,2013,"All students, Undergraduate total",154,61,93,-2
440396,New Saint Andrews College,2013,"All students, Undergraduate, Degree/certificate-seeking total",150,60,90,-2
440396,New Saint Andrews College,2013,"All students, Undergraduate, Degree/certificate-seeking, First-time",44,20,24,-2
440396,New Saint Andrews College,2013,"All students, Undergraduate, Other degree/certificate-seeking",106,40,66,-2
440396,New Saint Andrews College,2013,"All students, Undergraduate, Other degree/certifcate-seeking, Transfer-ins",4,0,4,-2
440396,New Saint Andrews College,2013,"All students, Undergraduate, Other degree/certifcate-seeking, Continuing",102,40,62,-2
440396,New Saint Andrews College,2013,"All students, Undergraduate, Non-degree/certificate-seeking",4,1,3,-2
440396,New Saint Andrews College,2013,"All students, Graduate",24,15,9,-2
440411,Marlboro College-Graduate School,2013,All students total,114,38,76,-2
440411,Marlboro College-Graduate School,2013,"All students, Undergraduate total",14,6,8,-2
440411,Marlboro College-Graduate School,2013,"All students, Undergraduate, Degree/certificate-seeking total",14,6,8,-2
440411,Marlboro College-Graduate School,2013,"All students, Undergraduate, Other degree/certificate-seeking",14,6,8,-2
440411,Marlboro College-Graduate School,2013,"All students, Undergraduate, Other degree/certifcate-seeking, Transfer-ins",1,1,0,-2
440411,Marlboro College-Graduate School,2013,"All students, Undergraduate, Other degree/certifcate-seeking, Continuing",13,5,8,-2
440411,Marlboro College-Graduate School,2013,"All students, Graduate",100,32,68,-2
440420,University of Phoenix-Boston Campus,2013,All students total,210,147,63,-2
440420,University of Phoenix-Boston Campus,2013,"All students, Undergraduate total",181,132,49,-2
440420,University of Phoenix-Boston Campus,2013,"All students, Undergraduate, Degree/certificate-seeking total",181,132,49,-2
440420,University of Phoenix-Boston Campus,2013,"All students, Undergraduate, Degree/certificate-seeking, First-time",3,1,2,-2
440420,University of Phoenix-Boston Campus,2013,"All students, Undergraduate, Other degree/certificate-seeking",178,131,47,-2
440420,University of Phoenix-Boston Campus,2013,"All students, Undergraduate, Other degree/certifcate-seeking, Transfer-ins",16,15,1,-2
440420,University of Phoenix-Boston Campus,2013,"All students, Undergraduate, Other degree/certifcate-seeking, Continuing",162,116,46,-2
440420,University of Phoenix-Boston Campus,2013,"All students, Graduate",29,15,14,-2
440466,University of Phoenix-Idaho Campus,2013,All students total,307,125,182,-2
440466,University of Phoenix-Idaho Campus,2013,"All students, Undergraduate total",283,108,175,-2
440466,University of Phoenix-Idaho Campus,2013,"All students, Undergraduate, Degree/certificate-seeking total",283,108,175,-2
440466,University of Phoenix-Idaho Campus,2013,"All students, Undergraduate, Degree/certificate-seeking, First-time",13,4,9,-2
440466,University of Phoenix-Idaho Campus,2013,"All students, Undergraduate, Other degree/certificate-seeking",270,104,166,-2
440466,University of Phoenix-Idaho Campus,2013,"All students, Undergraduate, Other degree/certifcate-seeking, Transfer-ins",18,11,7,-2
440466,University of Phoenix-Idaho Campus,2013,"All students, Undergraduate, Other degree/certifcate-seeking, Continuing",252,93,159,-2
440466,University of Phoenix-Idaho Campus,2013,"All students, Graduate",24,17,7,-2
440536,DeVry University-Virginia,2013,,,,,-2
440572,DeVry University's Keller Graduate School of Management-Ohio,2013,,,,,-2
440590,DeVry University-Colorado,2013,,,,,-2
440767,National American University-Brooklyn Center,2013,All students total,756,208,548,-2
440767,National American University-Brooklyn Center,2013,"All students, Undergraduate total",756,208,548,-2
440767,National American University-Brooklyn Center,2013,"All students, Undergraduate, Degree/certificate-seeking total",755,207,548,-2
440767,National American University-Brooklyn Center,2013,"All students, Undergraduate, Degree/certificate-seeking, First-time",66,27,39,-2
440767,National American University-Brooklyn Center,2013,"All students, Undergraduate, Other degree/certificate-seeking",689,180,509,-2
440767,National American University-Brooklyn Center,2013,"All students, Undergraduate, Other degree/certifcate-seeking, Transfer-ins",147,43,104,-2
440767,National American University-Brooklyn Center,2013,"All students, Undergraduate, Other degree/certifcate-seeking, Continuing",542,137,405,-2
440767,National American University-Brooklyn Center,2013,"All students, Undergraduate, Non-degree/certificate-seeking",1,1,0,-2
440794,Pillar College,2013,All students total,418,154,264,-2
440794,Pillar College,2013,"All students, Undergraduate total",418,154,264,-2
440794,Pillar College,2013,"All students, Undergraduate, Degree/certificate-seeking total",411,151,260,-2
440794,Pillar College,2013,"All students, Undergraduate, Degree/certificate-seeking, First-time",61,26,35,-2
440794,Pillar College,2013,"All students, Undergraduate, Other degree/certificate-seeking",350,125,225,-2
440794,Pillar College,2013,"All students, Undergraduate, Other degree/certifcate-seeking, Transfer-ins",81,33,48,-2
440794,Pillar College,2013,"All students, Undergraduate, Other degree/certifcate-seeking, Continuing",269,92,177,-2
440794,Pillar College,2013,"All students, Undergraduate, Non-degree/certificate-seeking",7,3,4,-2
441308,University of the Rockies,2013,All students total,1797,472,1325,-2
441308,University of the Rockies,2013,"All students, Graduate",1797,472,1325,-2
441478,National Graduate School of Quality Management,2013,All students total,142,84,58,-2
441478,National Graduate School of Quality Management,2013,"All students, Undergraduate total",33,20,13,-2
441478,National Graduate School of Quality Management,2013,"All students, Undergraduate, Degree/certificate-seeking total",33,20,13,-2
441478,National Graduate School of Quality Management,2013,"All students, Undergraduate, Other degree/certificate-seeking",33,20,13,-2
441478,National Graduate School of Quality Management,2013,"All students, Undergraduate, Other degree/certifcate-seeking, Transfer-ins",33,20,13,-2
441478,National Graduate School of Quality Management,2013,"All students, Graduate",109,64,45,-2
441609,Yeshiva Shaarei Torah of Rockland,2013,All students total,116,116,0,-2
441609,Yeshiva Shaarei Torah of Rockland,2013,"All students, Undergraduate total",116,116,0,-2
441609,Yeshiva Shaarei Torah of Rockland,2013,"All students, Undergraduate, Degree/certificate-seeking total",116,116,0,-2
441609,Yeshiva Shaarei Torah of Rockland,2013,"All students, Undergraduate, Degree/certificate-seeking, First-time",5,5,0,-2
441609,Yeshiva Shaarei Torah of Rockland,2013,"All students, Undergraduate, Other degree/certificate-seeking",111,111,0,-2
441609,Yeshiva Shaarei Torah of Rockland,2013,"All students, Undergraduate, Other degree/certifcate-seeking, Continuing",111,111,0,-2
441955,ITT Technical Institute-Springfield,2013,All students total,678,572,106,-2
441955,ITT Technical Institute-Springfield,2013,"All students, Undergraduate total",678,572,106,-2
441955,ITT Technical Institute-Springfield,2013,"All students, Undergraduate, Degree/certificate-seeking total",678,572,106,-2
441955,ITT Technical Institute-Springfield,2013,"All students, Undergraduate, Degree/certificate-seeking, First-time",103,84,19,-2
441955,ITT Technical Institute-Springfield,2013,"All students, Undergraduate, Other degree/certificate-seeking",575,488,87,-2
441955,ITT Technical Institute-Springfield,2013,"All students, Undergraduate, Other degree/certifcate-seeking, Continuing",575,488,87,-2
441964,ITT Technical Institute-Chantilly,2013,All students total,573,481,92,-2
441964,ITT Technical Institute-Chantilly,2013,"All students, Undergraduate total",573,481,92,-2
441964,ITT Technical Institute-Chantilly,2013,"All students, Undergraduate, Degree/certificate-seeking total",573,481,92,-2
441964,ITT Technical Institute-Chantilly,2013,"All students, Undergraduate, Degree/certificate-seeking, First-time",58,46,12,-2
441964,ITT Technical Institute-Chantilly,2013,"All students, Undergraduate, Other degree/certificate-seeking",515,435,80,-2
441964,ITT Technical Institute-Chantilly,2013,"All students, Undergraduate, Other degree/certifcate-seeking, Transfer-ins",9,9,0,-2
441964,ITT Technical Institute-Chantilly,2013,"All students, Undergraduate, Other degree/certifcate-seeking, Continuing",506,426,80,-2
441982,Franklin W Olin College of Engineering,2013,All students total,355,177,178,-2
441982,Franklin W Olin College of Engineering,2013,"All students, Undergraduate total",355,177,178,-2
441982,Franklin W Olin College of Engineering,2013,"All students, Undergraduate, Degree/certificate-seeking total",343,171,172,-2
441982,Franklin W Olin College of Engineering,2013,"All students, Undergraduate, Degree/certificate-seeking, First-time",82,36,46,-2
441982,Franklin W Olin College of Engineering,2013,"All students, Undergraduate, Other degree/certificate-seeking",261,135,126,-2
441982,Franklin W Olin College of Engineering,2013,"All students, Undergraduate, Other degree/certifcate-seeking, Transfer-ins",4,3,1,-2
441982,Franklin W Olin College of Engineering,2013,"All students, Undergraduate, Other degree/certifcate-seeking, Continuing",257,132,125,-2
441982,Franklin W Olin College of Engineering,2013,"All students, Undergraduate, Non-degree/certificate-seeking",12,6,6,-2
442064,Won Institute of Graduate Studies,2013,All students total,86,27,59,-2
442064,Won Institute of Graduate Studies,2013,"All students, Graduate",86,27,59,-2
442189,University of Phoenix-Northern Virginia Campus,2013,All students total,865,539,326,-2
442189,University of Phoenix-Northern Virginia Campus,2013,"All students, Undergraduate total",650,408,242,-2
442189,University of Phoenix-Northern Virginia Campus,2013,"All students, Undergraduate, Degree/certificate-seeking total",650,408,242,-2
442189,University of Phoenix-Northern Virginia Campus,2013,"All students, Undergraduate, Degree/certificate-seeking, First-time",3,2,1,-2
442189,University of Phoenix-Northern Virginia Campus,2013,"All students, Undergraduate, Other degree/certificate-seeking",647,406,241,-2
442189,University of Phoenix-Northern Virginia Campus,2013,"All students, Undergraduate, Other degree/certifcate-seeking, Transfer-ins",45,29,16,-2
442189,University of Phoenix-Northern Virginia Campus,2013,"All students, Undergraduate, Other degree/certifcate-seeking, Continuing",602,377,225,-2
442189,University of Phoenix-Northern Virginia Campus,2013,"All students, Graduate",215,131,84,-2
442338,ITT Technical Institute-Canton,2013,All students total,442,286,156,-2
442338,ITT Technical Institute-Canton,2013,"All students, Undergraduate total",442,286,156,-2
442338,ITT Technical Institute-Canton,2013,"All students, Undergraduate, Degree/certificate-seeking total",442,286,156,-2
442338,ITT Technical Institute-Canton,2013,"All students, Undergraduate, Degree/certificate-seeking, First-time",52,37,15,-2
442338,ITT Technical Institute-Canton,2013,"All students, Undergraduate, Other degree/certificate-seeking",390,249,141,-2
442338,ITT Technical Institute-Canton,2013,"All students, Undergraduate, Other degree/certifcate-seeking, Transfer-ins",25,6,19,-2
442338,ITT Technical Institute-Canton,2013,"All students, Undergraduate, Other degree/certifcate-seeking, Continuing",365,243,122,-2
442356,Pennsylvania College of Health Sciences,2013,All students total,1429,203,1226,-2
442356,Pennsylvania College of Health Sciences,2013,"All students, Undergraduate total",1429,203,1226,-2
442356,Pennsylvania College of Health Sciences,2013,"All students, Undergraduate, Degree/certificate-seeking total",1394,198,1196,-2
442356,Pennsylvania College of Health Sciences,2013,"All students, Undergraduate, Degree/certificate-seeking, First-time",179,39,140,-2
442356,Pennsylvania College of Health Sciences,2013,"All students, Undergraduate, Other degree/certificate-seeking",1215,159,1056,-2
442356,Pennsylvania College of Health Sciences,2013,"All students, Undergraduate, Other degree/certifcate-seeking, Transfer-ins",278,41,237,-2
442356,Pennsylvania College of Health Sciences,2013,"All students, Undergraduate, Other degree/certifcate-seeking, Continuing",937,118,819,-2
442356,Pennsylvania College of Health Sciences,2013,"All students, Undergraduate, Non-degree/certificate-seeking",35,5,30,-2
442392,Antioch University-PhD Program in Leadership and Change,2013,All students total,152,56,96,-2
442392,Antioch University-PhD Program in Leadership and Change,2013,"All students, Graduate",152,56,96,-2
442578,Minnesota School of Business-Plymouth,2013,All students total,190,48,142,-2
442578,Minnesota School of Business-Plymouth,2013,"All students, Undergraduate total",190,48,142,-2
442578,Minnesota School of Business-Plymouth,2013,"All students, Undergraduate, Degree/certificate-seeking total",184,45,139,-2
442578,Minnesota School of Business-Plymouth,2013,"All students, Undergraduate, Degree/certificate-seeking, First-time",17,1,16,-2
442578,Minnesota School of Business-Plymouth,2013,"All students, Undergraduate, Other degree/certificate-seeking",167,44,123,-2
442578,Minnesota School of Business-Plymouth,2013,"All students, Undergraduate, Other degree/certifcate-seeking, Transfer-ins",30,5,25,-2
442578,Minnesota School of Business-Plymouth,2013,"All students, Undergraduate, Other degree/certifcate-seeking, Continuing",137,39,98,-2
442578,Minnesota School of Business-Plymouth,2013,"All students, Undergraduate, Non-degree/certificate-seeking",6,3,3,-2
442639,University of the Potomac-VA Campus,2013,All students total,35,21,14,-2
442639,University of the Potomac-VA Campus,2013,"All students, Undergraduate total",27,14,13,-2
442639,University of the Potomac-VA Campus,2013,"All students, Undergraduate, Degree/certificate-seeking total",26,13,13,-2
442639,University of the Potomac-VA Campus,2013,"All students, Undergraduate, Degree/certificate-seeking, First-time",3,2,1,-2
442639,University of the Potomac-VA Campus,2013,"All students, Undergraduate, Other degree/certificate-seeking",23,11,12,-2
442639,University of the Potomac-VA Campus,2013,"All students, Undergraduate, Other degree/certifcate-seeking, Transfer-ins",5,2,3,-2
442639,University of the Potomac-VA Campus,2013,"All students, Undergraduate, Other degree/certifcate-seeking, Continuing",18,9,9,-2
442639,University of the Potomac-VA Campus,2013,"All students, Undergraduate, Non-degree/certificate-seeking",1,1,0,-2
442639,University of the Potomac-VA Campus,2013,"All students, Graduate",8,7,1,-2
442806,Edward Via College of Osteopathic Medicine,2013,All students total,1278,610,668,-2
442806,Edward Via College of Osteopathic Medicine,2013,"All students, Graduate",1278,610,668,-2
442824,DeVry University-Pennsylvania,2013,,,,,-2
443456,University of Phoenix-Cincinnati Campus,2013,All students total,119,54,65,-2
443456,University of Phoenix-Cincinnati Campus,2013,"All students, Undergraduate total",108,48,60,-2
443456,University of Phoenix-Cincinnati Campus,2013,"All students, Undergraduate, Degree/certificate-seeking total",108,48,60,-2
443456,University of Phoenix-Cincinnati Campus,2013,"All students, Undergraduate, Other degree/certificate-seeking",108,48,60,-2
443456,University of Phoenix-Cincinnati Campus,2013,"All students, Undergraduate, Other degree/certifcate-seeking, Continuing",108,48,60,-2
443456,University of Phoenix-Cincinnati Campus,2013,"All students, Graduate",11,6,5,-2
443535,ITT Technical Institute-Hilliard,2013,All students total,322,186,136,-2
443535,ITT Technical Institute-Hilliard,2013,"All students, Undergraduate total",322,186,136,-2
443535,ITT Technical Institute-Hilliard,2013,"All students, Undergraduate, Degree/certificate-seeking total",322,186,136,-2
443535,ITT Technical Institute-Hilliard,2013,"All students, Undergraduate, Degree/certificate-seeking, First-time",50,30,20,-2
443535,ITT Technical Institute-Hilliard,2013,"All students, Undergraduate, Other degree/certificate-seeking",272,156,116,-2
443535,ITT Technical Institute-Hilliard,2013,"All students, Undergraduate, Other degree/certifcate-seeking, Transfer-ins",17,7,10,-2
443535,ITT Technical Institute-Hilliard,2013,"All students, Undergraduate, Other degree/certifcate-seeking, Continuing",255,149,106,-2
443702,Bexley Hall Episcopal Seminary,2013,All students total,15,11,4,-2
443702,Bexley Hall Episcopal Seminary,2013,"All students, Graduate",15,11,4,-2
443784,Strayer University-Pennsylvania,2013,All students total,2329,874,1455,-2
443784,Strayer University-Pennsylvania,2013,"All students, Undergraduate total",1650,596,1054,-2
443784,Strayer University-Pennsylvania,2013,"All students, Undergraduate, Degree/certificate-seeking total",1644,596,1048,-2
443784,Strayer University-Pennsylvania,2013,"All students, Undergraduate, Degree/certificate-seeking, First-time",214,80,134,-2
443784,Strayer University-Pennsylvania,2013,"All students, Undergraduate, Other degree/certificate-seeking",1430,516,914,-2
443784,Strayer University-Pennsylvania,2013,"All students, Undergraduate, Other degree/certifcate-seeking, Transfer-ins",179,66,113,-2
443784,Strayer University-Pennsylvania,2013,"All students, Undergraduate, Other degree/certifcate-seeking, Continuing",1251,450,801,-2
443784,Strayer University-Pennsylvania,2013,"All students, Undergraduate, Non-degree/certificate-seeking",6,0,6,-2
443784,Strayer University-Pennsylvania,2013,"All students, Graduate",679,278,401,-2
443906,University of Phoenix-Columbus Ohio Campus,2013,All students total,61,32,29,-2
443906,University of Phoenix-Columbus Ohio Campus,2013,"All students, Undergraduate total",55,28,27,-2
443906,University of Phoenix-Columbus Ohio Campus,2013,"All students, Undergraduate, Degree/certificate-seeking total",55,28,27,-2
443906,University of Phoenix-Columbus Ohio Campus,2013,"All students, Undergraduate, Other degree/certificate-seeking",55,28,27,-2
443906,University of Phoenix-Columbus Ohio Campus,2013,"All students, Undergraduate, Other degree/certifcate-seeking, Continuing",55,28,27,-2
443906,University of Phoenix-Columbus Ohio Campus,2013,"All students, Graduate",6,4,2,-2
443988,DeVry University's Keller Graduate School of Management-Pennsylvania,2013,,,,,-2
444103,Byzantine Catholic Seminary of Saints Cyril and Methodius,2013,All students total,11,10,1,-2
444103,Byzantine Catholic Seminary of Saints Cyril and Methodius,2013,"All students, Graduate",11,10,1,-2
444158,Colorado Technical University-Online,2013,All students total,20826,7588,13238,-2
444158,Colorado Technical University-Online,2013,"All students, Undergraduate total",18061,6501,11560,-2
444158,Colorado Technical University-Online,2013,"All students, Undergraduate, Degree/certificate-seeking total",17902,6470,11432,-2
444158,Colorado Technical University-Online,2013,"All students, Undergraduate, Degree/certificate-seeking, First-time",1559,708,851,-2
444158,Colorado Technical University-Online,2013,"All students, Undergraduate, Other degree/certificate-seeking",16343,5762,10581,-2
444158,Colorado Technical University-Online,2013,"All students, Undergraduate, Other degree/certifcate-seeking, Transfer-ins",2421,757,1664,-2
444158,Colorado Technical University-Online,2013,"All students, Undergraduate, Other degree/certifcate-seeking, Continuing",13922,5005,8917,-2
444158,Colorado Technical University-Online,2013,"All students, Undergraduate, Non-degree/certificate-seeking",159,31,128,-2
444158,Colorado Technical University-Online,2013,"All students, Graduate",2765,1087,1678,-2
444167,Baker College of Allen Park,2013,All students total,3800,943,2857,-2
444167,Baker College of Allen Park,2013,"All students, Undergraduate total",3795,942,2853,-2
444167,Baker College of Allen Park,2013,"All students, Undergraduate, Degree/certificate-seeking total",3761,931,2830,-2
444167,Baker College of Allen Park,2013,"All students, Undergraduate, Degree/certificate-seeking, First-time",581,189,392,-2
444167,Baker College of Allen Park,2013,"All students, Undergraduate, Other degree/certificate-seeking",3180,742,2438,-2
444167,Baker College of Allen Park,2013,"All students, Undergraduate, Other degree/certifcate-seeking, Transfer-ins",544,122,422,-2
444167,Baker College of Allen Park,2013,"All students, Undergraduate, Other degree/certifcate-seeking, Continuing",2636,620,2016,-2
444167,Baker College of Allen Park,2013,"All students, Undergraduate, Non-degree/certificate-seeking",34,11,23,-2
444167,Baker College of Allen Park,2013,"All students, Graduate",5,1,4,-2
444413,Beis Medrash Heichal Dovid,2013,All students total,113,113,0,-2
444413,Beis Medrash Heichal Dovid,2013,"All students, Undergraduate total",96,96,0,-2
444413,Beis Medrash Heichal Dovid,2013,"All students, Undergraduate, Degree/certificate-seeking total",96,96,0,-2
444413,Beis Medrash Heichal Dovid,2013,"All students, Undergraduate, Degree/certificate-seeking, First-time",32,32,0,-2
444413,Beis Medrash Heichal Dovid,2013,"All students, Undergraduate, Other degree/certificate-seeking",64,64,0,-2
444413,Beis Medrash Heichal Dovid,2013,"All students, Undergraduate, Other degree/certifcate-seeking, Transfer-ins",7,7,0,-2
444413,Beis Medrash Heichal Dovid,2013,"All students, Undergraduate, Other degree/certifcate-seeking, Continuing",57,57,0,-2
444413,Beis Medrash Heichal Dovid,2013,"All students, Graduate",17,17,0,-2
444699,Institute of Clinical Acupuncture & Oriental Med,2013,All students total,53,21,32,-2
444699,Institute of Clinical Acupuncture & Oriental Med,2013,"All students, Graduate",53,21,32,-2
444723,Jones International University,2013,All students total,2782,892,1890,-2
444723,Jones International University,2013,"All students, Undergraduate total",1634,517,1117,-2
444723,Jones International University,2013,"All students, Undergraduate, Degree/certificate-seeking total",1586,490,1096,-2
444723,Jones International University,2013,"All students, Undergraduate, Degree/certificate-seeking, First-time",320,100,220,-2
444723,Jones International University,2013,"All students, Undergraduate, Other degree/certificate-seeking",1266,390,876,-2
444723,Jones International University,2013,"All students, Undergraduate, Other degree/certifcate-seeking, Transfer-ins",96,33,63,-2
444723,Jones International University,2013,"All students, Undergraduate, Other degree/certifcate-seeking, Continuing",1170,357,813,-2
444723,Jones International University,2013,"All students, Undergraduate, Non-degree/certificate-seeking",48,27,21,-2
444723,Jones International University,2013,"All students, Graduate",1148,375,773,-2
445081,ITT Technical Institute-Eden Prairie,2013,All students total,208,191,17,-2
445081,ITT Technical Institute-Eden Prairie,2013,"All students, Undergraduate total",208,191,17,-2
445081,ITT Technical Institute-Eden Prairie,2013,"All students, Undergraduate, Degree/certificate-seeking total",208,191,17,-2
445081,ITT Technical Institute-Eden Prairie,2013,"All students, Undergraduate, Degree/certificate-seeking, First-time",23,23,0,-2
445081,ITT Technical Institute-Eden Prairie,2013,"All students, Undergraduate, Other degree/certificate-seeking",185,168,17,-2
445081,ITT Technical Institute-Eden Prairie,2013,"All students, Undergraduate, Other degree/certifcate-seeking, Transfer-ins",2,1,1,-2
445081,ITT Technical Institute-Eden Prairie,2013,"All students, Undergraduate, Other degree/certifcate-seeking, Continuing",183,167,16,-2
445124,International Academy of Design and Technology-Troy,2013,All students total,351,161,190,-2
445124,International Academy of Design and Technology-Troy,2013,"All students, Undergraduate total",351,161,190,-2
445124,International Academy of Design and Technology-Troy,2013,"All students, Undergraduate, Degree/certificate-seeking total",347,159,188,-2
445124,International Academy of Design and Technology-Troy,2013,"All students, Undergraduate, Degree/certificate-seeking, First-time",25,9,16,-2
445124,International Academy of Design and Technology-Troy,2013,"All students, Undergraduate, Other degree/certificate-seeking",322,150,172,-2
445124,International Academy of Design and Technology-Troy,2013,"All students, Undergraduate, Other degree/certifcate-seeking, Transfer-ins",17,6,11,-2
445124,International Academy of Design and Technology-Troy,2013,"All students, Undergraduate, Other degree/certifcate-seeking, Continuing",305,144,161,-2
445124,International Academy of Design and Technology-Troy,2013,"All students, Undergraduate, Non-degree/certificate-seeking",4,2,2,-2
445300,University of Phoenix-Jersey City Campus,2013,All students total,455,211,244,-2
445300,University of Phoenix-Jersey City Campus,2013,"All students, Undergraduate total",455,211,244,-2
445300,University of Phoenix-Jersey City Campus,2013,"All students, Undergraduate, Degree/certificate-seeking total",455,211,244,-2
445300,University of Phoenix-Jersey City Campus,2013,"All students, Undergraduate, Degree/certificate-seeking, First-time",40,15,25,-2
445300,University of Phoenix-Jersey City Campus,2013,"All students, Undergraduate, Other degree/certificate-seeking",415,196,219,-2
445300,University of Phoenix-Jersey City Campus,2013,"All students, Undergraduate, Other degree/certifcate-seeking, Transfer-ins",23,15,8,-2
445300,University of Phoenix-Jersey City Campus,2013,"All students, Undergraduate, Other degree/certifcate-seeking, Continuing",392,181,211,-2
445319,University of Phoenix-Minneapolis St Paul Campus,2013,All students total,180,92,88,-2
445319,University of Phoenix-Minneapolis St Paul Campus,2013,"All students, Undergraduate total",153,77,76,-2
445319,University of Phoenix-Minneapolis St Paul Campus,2013,"All students, Undergraduate, Degree/certificate-seeking total",153,77,76,-2
445319,University of Phoenix-Minneapolis St Paul Campus,2013,"All students, Undergraduate, Degree/certificate-seeking, First-time",5,2,3,-2
445319,University of Phoenix-Minneapolis St Paul Campus,2013,"All students, Undergraduate, Other degree/certificate-seeking",148,75,73,-2
445319,University of Phoenix-Minneapolis St Paul Campus,2013,"All students, Undergraduate, Other degree/certifcate-seeking, Transfer-ins",10,5,5,-2
445319,University of Phoenix-Minneapolis St Paul Campus,2013,"All students, Undergraduate, Other degree/certifcate-seeking, Continuing",138,70,68,-2
445319,University of Phoenix-Minneapolis St Paul Campus,2013,"All students, Graduate",27,15,12,-2
445407,DeVry University-Minnesota,2013,,,,,-2
445416,Kaplan University-Council Bluffs Campus,2013,,,,,-2
445869,Institute for the Psychological Sciences,2013,All students total,80,27,53,-2
445869,Institute for the Psychological Sciences,2013,"All students, Graduate",80,27,53,-2
445920,Minnesota School of Business-Waite Park,2013,All students total,354,104,250,-2
445920,Minnesota School of Business-Waite Park,2013,"All students, Undergraduate total",354,104,250,-2
445920,Minnesota School of Business-Waite Park,2013,"All students, Undergraduate, Degree/certificate-seeking total",339,101,238,-2
445920,Minnesota School of Business-Waite Park,2013,"All students, Undergraduate, Degree/certificate-seeking, First-time",42,12,30,-2
445920,Minnesota School of Business-Waite Park,2013,"All students, Undergraduate, Other degree/certificate-seeking",297,89,208,-2
445920,Minnesota School of Business-Waite Park,2013,"All students, Undergraduate, Other degree/certifcate-seeking, Transfer-ins",51,15,36,-2
445920,Minnesota School of Business-Waite Park,2013,"All students, Undergraduate, Other degree/certifcate-seeking, Continuing",246,74,172,-2
445920,Minnesota School of Business-Waite Park,2013,"All students, Undergraduate, Non-degree/certificate-seeking",15,3,12,-2
445939,Minnesota School of Business-Shakopee,2013,All students total,117,30,87,-2
445939,Minnesota School of Business-Shakopee,2013,"All students, Undergraduate total",117,30,87,-2
445939,Minnesota School of Business-Shakopee,2013,"All students, Undergraduate, Degree/certificate-seeking total",110,28,82,-2
445939,Minnesota School of Business-Shakopee,2013,"All students, Undergraduate, Degree/certificate-seeking, First-time",6,1,5,-2
445939,Minnesota School of Business-Shakopee,2013,"All students, Undergraduate, Other degree/certificate-seeking",104,27,77,-2
445939,Minnesota School of Business-Shakopee,2013,"All students, Undergraduate, Other degree/certifcate-seeking, Transfer-ins",13,2,11,-2
445939,Minnesota School of Business-Shakopee,2013,"All students, Undergraduate, Other degree/certifcate-seeking, Continuing",91,25,66,-2
445939,Minnesota School of Business-Shakopee,2013,"All students, Undergraduate, Non-degree/certificate-seeking",7,2,5,-2
446002,American Academy of Acupuncture and Oriental Medicine,2013,All students total,65,18,47,-2
446002,American Academy of Acupuncture and Oriental Medicine,2013,"All students, Graduate",65,18,47,-2
446394,Maple Springs Baptist Bible College and Seminary,2013,All students total,105,46,59,-2
446394,Maple Springs Baptist Bible College and Seminary,2013,"All students, Undergraduate total",76,34,42,-2
446394,Maple Springs Baptist Bible College and Seminary,2013,"All students, Undergraduate, Degree/certificate-seeking total",76,34,42,-2
446394,Maple Springs Baptist Bible College and Seminary,2013,"All students, Undergraduate, Degree/certificate-seeking, First-time",6,1,5,-2
446394,Maple Springs Baptist Bible College and Seminary,2013,"All students, Undergraduate, Other degree/certificate-seeking",70,33,37,-2
446394,Maple Springs Baptist Bible College and Seminary,2013,"All students, Undergraduate, Other degree/certifcate-seeking, Transfer-ins",6,3,3,-2
446394,Maple Springs Baptist Bible College and Seminary,2013,"All students, Undergraduate, Other degree/certifcate-seeking, Continuing",64,30,34,-2
446394,Maple Springs Baptist Bible College and Seminary,2013,"All students, Graduate",29,12,17,-2
446604,Uta Mesivta of Kiryas Joel,2013,All students total,1561,1561,0,-2
446604,Uta Mesivta of Kiryas Joel,2013,"All students, Undergraduate total",1561,1561,0,-2
446604,Uta Mesivta of Kiryas Joel,2013,"All students, Undergraduate, Degree/certificate-seeking total",1561,1561,0,-2
446604,Uta Mesivta of Kiryas Joel,2013,"All students, Undergraduate, Degree/certificate-seeking, First-time",305,305,0,-2
446604,Uta Mesivta of Kiryas Joel,2013,"All students, Undergraduate, Other degree/certificate-seeking",1256,1256,0,-2
446604,Uta Mesivta of Kiryas Joel,2013,"All students, Undergraduate, Other degree/certifcate-seeking, Transfer-ins",171,171,0,-2
446604,Uta Mesivta of Kiryas Joel,2013,"All students, Undergraduate, Other degree/certifcate-seeking, Continuing",1085,1085,0,-2
446640,Harrisburg University of Science and Technology,2013,All students total,344,176,168,-2
446640,Harrisburg University of Science and Technology,2013,"All students, Undergraduate total",289,148,141,-2
446640,Harrisburg University of Science and Technology,2013,"All students, Undergraduate, Degree/certificate-seeking total",278,141,137,-2
446640,Harrisburg University of Science and Technology,2013,"All students, Undergraduate, Degree/certificate-seeking, First-time",108,49,59,-2
446640,Harrisburg University of Science and Technology,2013,"All students, Undergraduate, Other degree/certificate-seeking",170,92,78,-2
446640,Harrisburg University of Science and Technology,2013,"All students, Undergraduate, Other degree/certifcate-seeking, Transfer-ins",5,0,5,-2
446640,Harrisburg University of Science and Technology,2013,"All students, Undergraduate, Other degree/certifcate-seeking, Continuing",165,92,73,-2
446640,Harrisburg University of Science and Technology,2013,"All students, Undergraduate, Non-degree/certificate-seeking",11,7,4,-2
446640,Harrisburg University of Science and Technology,2013,"All students, Graduate",55,28,27,-2
446668,The Art Institute of Ohio-Cincinnati,2013,All students total,834,405,429,-2
446668,The Art Institute of Ohio-Cincinnati,2013,"All students, Undergraduate total",834,405,429,-2
446668,The Art Institute of Ohio-Cincinnati,2013,"All students, Undergraduate, Degree/certificate-seeking total",834,405,429,-2
446668,The Art Institute of Ohio-Cincinnati,2013,"All students, Undergraduate, Degree/certificate-seeking, First-time",292,136,156,-2
446668,The Art Institute of Ohio-Cincinnati,2013,"All students, Undergraduate, Other degree/certificate-seeking",542,269,273,-2
446668,The Art Institute of Ohio-Cincinnati,2013,"All students, Undergraduate, Other degree/certifcate-seeking, Transfer-ins",71,27,44,-2
446668,The Art Institute of Ohio-Cincinnati,2013,"All students, Undergraduate, Other degree/certifcate-seeking, Continuing",471,242,229,-2
446729,University of Phoenix-Des Moines Campus,2013,All students total,61,24,37,-2
446729,University of Phoenix-Des Moines Campus,2013,"All students, Undergraduate total",46,18,28,-2
446729,University of Phoenix-Des Moines Campus,2013,"All students, Undergraduate, Degree/certificate-seeking total",46,18,28,-2
446729,University of Phoenix-Des Moines Campus,2013,"All students, Undergraduate, Other degree/certificate-seeking",46,18,28,-2
446729,University of Phoenix-Des Moines Campus,2013,"All students, Undergraduate, Other degree/certifcate-seeking, Transfer-ins",4,2,2,-2
446729,University of Phoenix-Des Moines Campus,2013,"All students, Undergraduate, Other degree/certifcate-seeking, Continuing",42,16,26,-2
446729,University of Phoenix-Des Moines Campus,2013,"All students, Graduate",15,6,9,-2
446756,University of Phoenix-Richmond-Virginia Beach Campus,2013,All students total,706,311,395,-2
446756,University of Phoenix-Richmond-Virginia Beach Campus,2013,"All students, Undergraduate total",640,277,363,-2
446756,University of Phoenix-Richmond-Virginia Beach Campus,2013,"All students, Undergraduate, Degree/certificate-seeking total",640,277,363,-2
446756,University of Phoenix-Richmond-Virginia Beach Campus,2013,"All students, Undergraduate, Degree/certificate-seeking, First-time",11,0,11,-2
446756,University of Phoenix-Richmond-Virginia Beach Campus,2013,"All students, Undergraduate, Other degree/certificate-seeking",629,277,352,-2
446756,University of Phoenix-Richmond-Virginia Beach Campus,2013,"All students, Undergraduate, Other degree/certifcate-seeking, Transfer-ins",48,23,25,-2
446756,University of Phoenix-Richmond-Virginia Beach Campus,2013,"All students, Undergraduate, Other degree/certifcate-seeking, Continuing",581,254,327,-2
446756,University of Phoenix-Richmond-Virginia Beach Campus,2013,"All students, Graduate",66,34,32,-2
446914,ITT Technical Institute-Owings Mills,2013,All students total,616,518,98,-2
446914,ITT Technical Institute-Owings Mills,2013,"All students, Undergraduate total",616,518,98,-2
446914,ITT Technical Institute-Owings Mills,2013,"All students, Undergraduate, Degree/certificate-seeking total",616,518,98,-2
446914,ITT Technical Institute-Owings Mills,2013,"All students, Undergraduate, Degree/certificate-seeking, First-time",86,71,15,-2
446914,ITT Technical Institute-Owings Mills,2013,"All students, Undergraduate, Other degree/certificate-seeking",530,447,83,-2
446914,ITT Technical Institute-Owings Mills,2013,"All students, Undergraduate, Other degree/certifcate-seeking, Transfer-ins",2,2,0,-2
446914,ITT Technical Institute-Owings Mills,2013,"All students, Undergraduate, Other degree/certifcate-seeking, Continuing",528,445,83,-2
446923,ITT Technical Institute-Warrensville Heights,2013,All students total,458,260,198,-2
446923,ITT Technical Institute-Warrensville Heights,2013,"All students, Undergraduate total",458,260,198,-2
446923,ITT Technical Institute-Warrensville Heights,2013,"All students, Undergraduate, Degree/certificate-seeking total",458,260,198,-2
446923,ITT Technical Institute-Warrensville Heights,2013,"All students, Undergraduate, Degree/certificate-seeking, First-time",74,51,23,-2
446923,ITT Technical Institute-Warrensville Heights,2013,"All students, Undergraduate, Other degree/certificate-seeking",384,209,175,-2
446923,ITT Technical Institute-Warrensville Heights,2013,"All students, Undergraduate, Other degree/certifcate-seeking, Transfer-ins",16,8,8,-2
446923,ITT Technical Institute-Warrensville Heights,2013,"All students, Undergraduate, Other degree/certifcate-seeking, Continuing",368,201,167,-2
446932,Union Graduate College,2013,All students total,410,234,176,-2
446932,Union Graduate College,2013,"All students, Graduate",410,234,176,-2
446978,Colorado State University-System Office,2013,,,,,-2
447069,Westwood College-Arlington Ballston,2013,All students total,371,200,171,-2
447069,Westwood College-Arlington Ballston,2013,"All students, Undergraduate total",371,200,171,-2
447069,Westwood College-Arlington Ballston,2013,"All students, Undergraduate, Degree/certificate-seeking total",371,200,171,-2
447069,Westwood College-Arlington Ballston,2013,"All students, Undergraduate, Degree/certificate-seeking, First-time",50,24,26,-2
447069,Westwood College-Arlington Ballston,2013,"All students, Undergraduate, Other degree/certificate-seeking",321,176,145,-2
447069,Westwood College-Arlington Ballston,2013,"All students, Undergraduate, Other degree/certifcate-seeking, Transfer-ins",4,2,2,-2
447069,Westwood College-Arlington Ballston,2013,"All students, Undergraduate, Other degree/certifcate-seeking, Continuing",317,174,143,-2
447670,Minnesota School of Business-Rochester,2013,All students total,264,89,175,-2
447670,Minnesota School of Business-Rochester,2013,"All students, Undergraduate total",264,89,175,-2
447670,Minnesota School of Business-Rochester,2013,"All students, Undergraduate, Degree/certificate-seeking total",256,85,171,-2
447670,Minnesota School of Business-Rochester,2013,"All students, Undergraduate, Degree/certificate-seeking, First-time",21,9,12,-2
447670,Minnesota School of Business-Rochester,2013,"All students, Undergraduate, Other degree/certificate-seeking",235,76,159,-2
447670,Minnesota School of Business-Rochester,2013,"All students, Undergraduate, Other degree/certifcate-seeking, Transfer-ins",48,10,38,-2
447670,Minnesota School of Business-Rochester,2013,"All students, Undergraduate, Other degree/certifcate-seeking, Continuing",187,66,121,-2
447670,Minnesota School of Business-Rochester,2013,"All students, Undergraduate, Non-degree/certificate-seeking",8,4,4,-2
448284,Doane College-Lincoln Grand Island and Master,2013,All students total,1653,520,1133,-2
448284,Doane College-Lincoln Grand Island and Master,2013,"All students, Undergraduate total",726,288,438,-2
448284,Doane College-Lincoln Grand Island and Master,2013,"All students, Undergraduate, Degree/certificate-seeking total",721,286,435,-2
448284,Doane College-Lincoln Grand Island and Master,2013,"All students, Undergraduate, Degree/certificate-seeking, First-time",1,1,0,-2
448284,Doane College-Lincoln Grand Island and Master,2013,"All students, Undergraduate, Other degree/certificate-seeking",720,285,435,-2
448284,Doane College-Lincoln Grand Island and Master,2013,"All students, Undergraduate, Other degree/certifcate-seeking, Transfer-ins",71,27,44,-2
448284,Doane College-Lincoln Grand Island and Master,2013,"All students, Undergraduate, Other degree/certifcate-seeking, Continuing",649,258,391,-2
448284,Doane College-Lincoln Grand Island and Master,2013,"All students, Undergraduate, Non-degree/certificate-seeking",5,2,3,-2
448284,Doane College-Lincoln Grand Island and Master,2013,"All students, Graduate",927,232,695,-2
448479,ITT Technical Institute-Swartz Creek,2013,All students total,402,316,86,-2
448479,ITT Technical Institute-Swartz Creek,2013,"All students, Undergraduate total",402,316,86,-2
448479,ITT Technical Institute-Swartz Creek,2013,"All students, Undergraduate, Degree/certificate-seeking total",402,316,86,-2
448479,ITT Technical Institute-Swartz Creek,2013,"All students, Undergraduate, Degree/certificate-seeking, First-time",81,63,18,-2
448479,ITT Technical Institute-Swartz Creek,2013,"All students, Undergraduate, Other degree/certificate-seeking",321,253,68,-2
448479,ITT Technical Institute-Swartz Creek,2013,"All students, Undergraduate, Other degree/certifcate-seeking, Transfer-ins",14,12,2,-2
448479,ITT Technical Institute-Swartz Creek,2013,"All students, Undergraduate, Other degree/certifcate-seeking, Continuing",307,241,66,-2
448497,ITT Technical Institute-Maumee,2013,All students total,219,185,34,-2
448497,ITT Technical Institute-Maumee,2013,"All students, Undergraduate total",219,185,34,-2
448497,ITT Technical Institute-Maumee,2013,"All students, Undergraduate, Degree/certificate-seeking total",219,185,34,-2
448497,ITT Technical Institute-Maumee,2013,"All students, Undergraduate, Degree/certificate-seeking, First-time",39,32,7,-2
448497,ITT Technical Institute-Maumee,2013,"All students, Undergraduate, Other degree/certificate-seeking",180,153,27,-2
448497,ITT Technical Institute-Maumee,2013,"All students, Undergraduate, Other degree/certifcate-seeking, Transfer-ins",5,4,1,-2
448497,ITT Technical Institute-Maumee,2013,"All students, Undergraduate, Other degree/certifcate-seeking, Continuing",175,149,26,-2
448521,University of Phoenix-Omaha Campus,2013,All students total,34,16,18,-2
448521,University of Phoenix-Omaha Campus,2013,"All students, Undergraduate total",27,10,17,-2
448521,University of Phoenix-Omaha Campus,2013,"All students, Undergraduate, Degree/certificate-seeking total",27,10,17,-2
448521,University of Phoenix-Omaha Campus,2013,"All students, Undergraduate, Other degree/certificate-seeking",27,10,17,-2
448521,University of Phoenix-Omaha Campus,2013,"All students, Undergraduate, Other degree/certifcate-seeking, Continuing",27,10,17,-2
448521,University of Phoenix-Omaha Campus,2013,"All students, Graduate",7,6,1,-2
448628,Westwood College-Annandale,2013,All students total,348,199,149,-2
448628,Westwood College-Annandale,2013,"All students, Undergraduate total",348,199,149,-2
448628,Westwood College-Annandale,2013,"All students, Undergraduate, Degree/certificate-seeking total",348,199,149,-2
448628,Westwood College-Annandale,2013,"All students, Undergraduate, Degree/certificate-seeking, First-time",22,13,9,-2
448628,Westwood College-Annandale,2013,"All students, Undergraduate, Other degree/certificate-seeking",326,186,140,-2
448628,Westwood College-Annandale,2013,"All students, Undergraduate, Other degree/certifcate-seeking, Transfer-ins",1,0,1,-2
448628,Westwood College-Annandale,2013,"All students, Undergraduate, Other degree/certifcate-seeking, Continuing",325,186,139,-2
448691,International Institute for Restorative Practices,2013,All students total,30,9,21,-2
448691,International Institute for Restorative Practices,2013,"All students, Graduate",30,9,21,-2
448734,Argosy University-Denver,2013,All students total,398,119,279,-2
448734,Argosy University-Denver,2013,"All students, Undergraduate total",154,57,97,-2
448734,Argosy University-Denver,2013,"All students, Undergraduate, Degree/certificate-seeking total",151,57,94,-2
448734,Argosy University-Denver,2013,"All students, Undergraduate, Degree/certificate-seeking, First-time",19,9,10,-2
448734,Argosy University-Denver,2013,"All students, Undergraduate, Other degree/certificate-seeking",132,48,84,-2
448734,Argosy University-Denver,2013,"All students, Undergraduate, Other degree/certifcate-seeking, Transfer-ins",28,10,18,-2
448734,Argosy University-Denver,2013,"All students, Undergraduate, Other degree/certifcate-seeking, Continuing",104,38,66,-2
448734,Argosy University-Denver,2013,"All students, Undergraduate, Non-degree/certificate-seeking",3,0,3,-2
448734,Argosy University-Denver,2013,"All students, Graduate",244,62,182,-2
448752,College America-Colorado Springs,2013,All students total,322,114,208,-2
448752,College America-Colorado Springs,2013,"All students, Undergraduate total",322,114,208,-2
448752,College America-Colorado Springs,2013,"All students, Undergraduate, Degree/certificate-seeking total",322,114,208,-2
448752,College America-Colorado Springs,2013,"All students, Undergraduate, Degree/certificate-seeking, First-time",32,11,21,-2
448752,College America-Colorado Springs,2013,"All students, Undergraduate, Other degree/certificate-seeking",290,103,187,-2
448752,College America-Colorado Springs,2013,"All students, Undergraduate, Other degree/certifcate-seeking, Transfer-ins",27,9,18,-2
448752,College America-Colorado Springs,2013,"All students, Undergraduate, Other degree/certifcate-seeking, Continuing",263,94,169,-2
448761,College America-Fort Collins,2013,All students total,159,42,117,-2
448761,College America-Fort Collins,2013,"All students, Undergraduate total",159,42,117,-2
448761,College America-Fort Collins,2013,"All students, Undergraduate, Degree/certificate-seeking total",159,42,117,-2
448761,College America-Fort Collins,2013,"All students, Undergraduate, Degree/certificate-seeking, First-time",26,5,21,-2
448761,College America-Fort Collins,2013,"All students, Undergraduate, Other degree/certificate-seeking",133,37,96,-2
448761,College America-Fort Collins,2013,"All students, Undergraduate, Other degree/certifcate-seeking, Continuing",133,37,96,-2
448804,The Robert B Miller College,2013,All students total,328,80,248,-2
448804,The Robert B Miller College,2013,"All students, Undergraduate total",328,80,248,-2
448804,The Robert B Miller College,2013,"All students, Undergraduate, Degree/certificate-seeking total",275,75,200,-2
448804,The Robert B Miller College,2013,"All students, Undergraduate, Other degree/certificate-seeking",275,75,200,-2
448804,The Robert B Miller College,2013,"All students, Undergraduate, Other degree/certifcate-seeking, Transfer-ins",75,18,57,-2
448804,The Robert B Miller College,2013,"All students, Undergraduate, Other degree/certifcate-seeking, Continuing",200,57,143,-2
448804,The Robert B Miller College,2013,"All students, Undergraduate, Non-degree/certificate-seeking",53,5,48,-2
448822,University of Phoenix-Fairfield County Campus,2013,All students total,20,8,12,-2
448822,University of Phoenix-Fairfield County Campus,2013,"All students, Undergraduate total",20,8,12,-2
448822,University of Phoenix-Fairfield County Campus,2013,"All students, Undergraduate, Degree/certificate-seeking total",20,8,12,-2
448822,University of Phoenix-Fairfield County Campus,2013,"All students, Undergraduate, Other degree/certificate-seeking",20,8,12,-2
448822,University of Phoenix-Fairfield County Campus,2013,"All students, Undergraduate, Other degree/certifcate-seeking, Continuing",20,8,12,-2
448831,University of Phoenix-Harrisburg Campus,2013,All students total,60,21,39,-2
448831,University of Phoenix-Harrisburg Campus,2013,"All students, Undergraduate total",58,20,38,-2
448831,University of Phoenix-Harrisburg Campus,2013,"All students, Undergraduate, Degree/certificate-seeking total",58,20,38,-2
448831,University of Phoenix-Harrisburg Campus,2013,"All students, Undergraduate, Other degree/certificate-seeking",58,20,38,-2
448831,University of Phoenix-Harrisburg Campus,2013,"All students, Undergraduate, Other degree/certifcate-seeking, Continuing",58,20,38,-2
448831,University of Phoenix-Harrisburg Campus,2013,"All students, Graduate",2,1,1,-2
449579,Hawaii College of Oriental Medicine,2013,All students total,11,3,8,-2
449579,Hawaii College of Oriental Medicine,2013,"All students, Graduate",11,3,8,-2
449658,Bais Medrash Toras Chesed,2013,All students total,114,114,0,-2
449658,Bais Medrash Toras Chesed,2013,"All students, Undergraduate total",114,114,0,-2
449658,Bais Medrash Toras Chesed,2013,"All students, Undergraduate, Degree/certificate-seeking total",114,114,0,-2
449658,Bais Medrash Toras Chesed,2013,"All students, Undergraduate, Degree/certificate-seeking, First-time",29,29,0,-2
449658,Bais Medrash Toras Chesed,2013,"All students, Undergraduate, Other degree/certificate-seeking",85,85,0,-2
449658,Bais Medrash Toras Chesed,2013,"All students, Undergraduate, Other degree/certifcate-seeking, Transfer-ins",3,3,0,-2
449658,Bais Medrash Toras Chesed,2013,"All students, Undergraduate, Other degree/certifcate-seeking, Continuing",82,82,0,-2
449922,Appalachian College of Pharmacy,2013,All students total,220,105,115,-2
449922,Appalachian College of Pharmacy,2013,"All students, Graduate",220,105,115,-2
449931,Averett University-Non-Traditional Programs,2013,All students total,1221,495,726,-2
449931,Averett University-Non-Traditional Programs,2013,"All students, Undergraduate total",790,315,475,-2
449931,Averett University-Non-Traditional Programs,2013,"All students, Undergraduate, Degree/certificate-seeking total",790,315,475,-2
449931,Averett University-Non-Traditional Programs,2013,"All students, Undergraduate, Degree/certificate-seeking, First-time",32,12,20,-2
449931,Averett University-Non-Traditional Programs,2013,"All students, Undergraduate, Other degree/certificate-seeking",758,303,455,-2
449931,Averett University-Non-Traditional Programs,2013,"All students, Undergraduate, Other degree/certifcate-seeking, Transfer-ins",84,31,53,-2
449931,Averett University-Non-Traditional Programs,2013,"All students, Undergraduate, Other degree/certifcate-seeking, Continuing",674,272,402,-2
449931,Averett University-Non-Traditional Programs,2013,"All students, Graduate",431,180,251,-2
450508,DeVry University-Michigan,2013,,,,,-2
450766,LIU Riverhead,2013,All students total,215,84,131,-2
450766,LIU Riverhead,2013,"All students, Undergraduate total",56,11,45,-2
450766,LIU Riverhead,2013,"All students, Undergraduate, Degree/certificate-seeking total",56,11,45,-2
450766,LIU Riverhead,2013,"All students, Undergraduate, Other degree/certificate-seeking",56,11,45,-2
450766,LIU Riverhead,2013,"All students, Undergraduate, Other degree/certifcate-seeking, Transfer-ins",15,2,13,-2
450766,LIU Riverhead,2013,"All students, Undergraduate, Other degree/certifcate-seeking, Continuing",41,9,32,-2
450766,LIU Riverhead,2013,"All students, Graduate",159,73,86,-2
451370,Yeshivas Be'er Yitzchok,2013,All students total,61,61,0,-2
451370,Yeshivas Be'er Yitzchok,2013,"All students, Undergraduate total",61,61,0,-2
451370,Yeshivas Be'er Yitzchok,2013,"All students, Undergraduate, Degree/certificate-seeking total",61,61,0,-2
451370,Yeshivas Be'er Yitzchok,2013,"All students, Undergraduate, Degree/certificate-seeking, First-time",8,8,0,-2
451370,Yeshivas Be'er Yitzchok,2013,"All students, Undergraduate, Other degree/certificate-seeking",53,53,0,-2
451370,Yeshivas Be'er Yitzchok,2013,"All students, Undergraduate, Other degree/certifcate-seeking, Transfer-ins",11,11,0,-2
451370,Yeshivas Be'er Yitzchok,2013,"All students, Undergraduate, Other degree/certifcate-seeking, Continuing",42,42,0,-2
451398,Yeshiva Toras Chaim,2013,All students total,182,182,0,-2
451398,Yeshiva Toras Chaim,2013,"All students, Undergraduate total",182,182,0,-2
451398,Yeshiva Toras Chaim,2013,"All students, Undergraduate, Degree/certificate-seeking total",182,182,0,-2
451398,Yeshiva Toras Chaim,2013,"All students, Undergraduate, Degree/certificate-seeking, First-time",54,54,0,-2
451398,Yeshiva Toras Chaim,2013,"All students, Undergraduate, Other degree/certificate-seeking",128,128,0,-2
451398,Yeshiva Toras Chaim,2013,"All students, Undergraduate, Other degree/certifcate-seeking, Transfer-ins",18,18,0,-2
451398,Yeshiva Toras Chaim,2013,"All students, Undergraduate, Other degree/certifcate-seeking, Continuing",110,110,0,-2
451404,Talmudical Seminary of Bobov,2013,All students total,307,307,0,-2
451404,Talmudical Seminary of Bobov,2013,"All students, Undergraduate total",307,307,0,-2
451404,Talmudical Seminary of Bobov,2013,"All students, Undergraduate, Degree/certificate-seeking total",307,307,0,-2
451404,Talmudical Seminary of Bobov,2013,"All students, Undergraduate, Degree/certificate-seeking, First-time",68,68,0,-2
451404,Talmudical Seminary of Bobov,2013,"All students, Undergraduate, Other degree/certificate-seeking",239,239,0,-2
451404,Talmudical Seminary of Bobov,2013,"All students, Undergraduate, Other degree/certifcate-seeking, Transfer-ins",78,78,0,-2
451404,Talmudical Seminary of Bobov,2013,"All students, Undergraduate, Other degree/certifcate-seeking, Continuing",161,161,0,-2
451662,The Art Institute of Pittsburgh-Online Division,2013,All students total,10906,4232,6674,-2
451662,The Art Institute of Pittsburgh-Online Division,2013,"All students, Undergraduate total",10906,4232,6674,-2
451662,The Art Institute of Pittsburgh-Online Division,2013,"All students, Undergraduate, Degree/certificate-seeking total",10896,4228,6668,-2
451662,The Art Institute of Pittsburgh-Online Division,2013,"All students, Undergraduate, Degree/certificate-seeking, First-time",1339,626,713,-2
451662,The Art Institute of Pittsburgh-Online Division,2013,"All students, Undergraduate, Other degree/certificate-seeking",9557,3602,5955,-2
451662,The Art Institute of Pittsburgh-Online Division,2013,"All students, Undergraduate, Other degree/certifcate-seeking, Transfer-ins",1161,428,733,-2
451662,The Art Institute of Pittsburgh-Online Division,2013,"All students, Undergraduate, Other degree/certifcate-seeking, Continuing",8396,3174,5222,-2
451662,The Art Institute of Pittsburgh-Online Division,2013,"All students, Undergraduate, Non-degree/certificate-seeking",10,4,6,-2
451769,Minnesota School of Business-Blaine,2013,All students total,395,104,291,-2
451769,Minnesota School of Business-Blaine,2013,"All students, Undergraduate total",395,104,291,-2
451769,Minnesota School of Business-Blaine,2013,"All students, Undergraduate, Degree/certificate-seeking total",384,103,281,-2
451769,Minnesota School of Business-Blaine,2013,"All students, Undergraduate, Degree/certificate-seeking, First-time",21,4,17,-2
451769,Minnesota School of Business-Blaine,2013,"All students, Undergraduate, Other degree/certificate-seeking",363,99,264,-2
451769,Minnesota School of Business-Blaine,2013,"All students, Undergraduate, Other degree/certifcate-seeking, Transfer-ins",56,14,42,-2
451769,Minnesota School of Business-Blaine,2013,"All students, Undergraduate, Other degree/certifcate-seeking, Continuing",307,85,222,-2
451769,Minnesota School of Business-Blaine,2013,"All students, Undergraduate, Non-degree/certificate-seeking",11,1,10,-2
451796,The Art Institute of Michigan,2013,All students total,1003,486,517,-2
451796,The Art Institute of Michigan,2013,"All students, Undergraduate total",1003,486,517,-2
451796,The Art Institute of Michigan,2013,"All students, Undergraduate, Degree/certificate-seeking total",995,481,514,-2
451796,The Art Institute of Michigan,2013,"All students, Undergraduate, Degree/certificate-seeking, First-time",294,157,137,-2
451796,The Art Institute of Michigan,2013,"All students, Undergraduate, Other degree/certificate-seeking",701,324,377,-2
451796,The Art Institute of Michigan,2013,"All students, Undergraduate, Other degree/certifcate-seeking, Transfer-ins",128,53,75,-2
451796,The Art Institute of Michigan,2013,"All students, Undergraduate, Other degree/certifcate-seeking, Continuing",573,271,302,-2
451796,The Art Institute of Michigan,2013,"All students, Undergraduate, Non-degree/certificate-seeking",8,5,3,-2
451954,ITT Technical Institute-Clive,2013,All students total,208,172,36,-2
451954,ITT Technical Institute-Clive,2013,"All students, Undergraduate total",208,172,36,-2
451954,ITT Technical Institute-Clive,2013,"All students, Undergraduate, Degree/certificate-seeking total",208,172,36,-2
451954,ITT Technical Institute-Clive,2013,"All students, Undergraduate, Degree/certificate-seeking, First-time",46,35,11,-2
451954,ITT Technical Institute-Clive,2013,"All students, Undergraduate, Other degree/certificate-seeking",162,137,25,-2
451954,ITT Technical Institute-Clive,2013,"All students, Undergraduate, Other degree/certifcate-seeking, Transfer-ins",7,6,1,-2
451954,ITT Technical Institute-Clive,2013,"All students, Undergraduate, Other degree/certifcate-seeking, Continuing",155,131,24,-2
451963,ITT Technical Institute-Columbus,2013,All students total,345,262,83,-2
451963,ITT Technical Institute-Columbus,2013,"All students, Undergraduate total",345,262,83,-2
451963,ITT Technical Institute-Columbus,2013,"All students, Undergraduate, Degree/certificate-seeking total",345,262,83,-2
451963,ITT Technical Institute-Columbus,2013,"All students, Undergraduate, Degree/certificate-seeking, First-time",66,50,16,-2
451963,ITT Technical Institute-Columbus,2013,"All students, Undergraduate, Other degree/certificate-seeking",279,212,67,-2
451963,ITT Technical Institute-Columbus,2013,"All students, Undergraduate, Other degree/certifcate-seeking, Transfer-ins",9,6,3,-2
451963,ITT Technical Institute-Columbus,2013,"All students, Undergraduate, Other degree/certifcate-seeking, Continuing",270,206,64,-2
453215,Strayer University-New Jersey,2013,All students total,788,290,498,-2
453215,Strayer University-New Jersey,2013,"All students, Undergraduate total",580,206,374,-2
453215,Strayer University-New Jersey,2013,"All students, Undergraduate, Degree/certificate-seeking total",578,206,372,-2
453215,Strayer University-New Jersey,2013,"All students, Undergraduate, Degree/certificate-seeking, First-time",62,21,41,-2
453215,Strayer University-New Jersey,2013,"All students, Undergraduate, Other degree/certificate-seeking",516,185,331,-2
453215,Strayer University-New Jersey,2013,"All students, Undergraduate, Other degree/certifcate-seeking, Transfer-ins",65,28,37,-2
453215,Strayer University-New Jersey,2013,"All students, Undergraduate, Other degree/certifcate-seeking, Continuing",451,157,294,-2
453215,Strayer University-New Jersey,2013,"All students, Undergraduate, Non-degree/certificate-seeking",2,0,2,-2
453215,Strayer University-New Jersey,2013,"All students, Graduate",208,84,124,-2
454184,The King’s College,2013,All students total,516,206,310,-2
454184,The King’s College,2013,"All students, Undergraduate total",516,206,310,-2
454184,The King’s College,2013,"All students, Undergraduate, Degree/certificate-seeking total",504,203,301,-2
454184,The King’s College,2013,"All students, Undergraduate, Degree/certificate-seeking, First-time",127,42,85,-2
454184,The King’s College,2013,"All students, Undergraduate, Other degree/certificate-seeking",377,161,216,-2
454184,The King’s College,2013,"All students, Undergraduate, Other degree/certifcate-seeking, Transfer-ins",12,9,3,-2
454184,The King’s College,2013,"All students, Undergraduate, Other degree/certifcate-seeking, Continuing",365,152,213,-2
454184,The King’s College,2013,"All students, Undergraduate, Non-degree/certificate-seeking",12,3,9,-2
454236,Chamberlain College of Nursing-Ohio,2013,All students total,667,105,562,-2
454236,Chamberlain College of Nursing-Ohio,2013,"All students, Undergraduate total",667,105,562,-2
454236,Chamberlain College of Nursing-Ohio,2013,"All students, Undergraduate, Degree/certificate-seeking total",666,105,561,-2
454236,Chamberlain College of Nursing-Ohio,2013,"All students, Undergraduate, Degree/certificate-seeking, First-time",13,3,10,-2
454236,Chamberlain College of Nursing-Ohio,2013,"All students, Undergraduate, Other degree/certificate-seeking",653,102,551,-2
454236,Chamberlain College of Nursing-Ohio,2013,"All students, Undergraduate, Other degree/certifcate-seeking, Transfer-ins",267,37,230,-2
454236,Chamberlain College of Nursing-Ohio,2013,"All students, Undergraduate, Other degree/certifcate-seeking, Continuing",386,65,321,-2
454236,Chamberlain College of Nursing-Ohio,2013,"All students, Undergraduate, Non-degree/certificate-seeking",1,0,1,-2
454829,Aspen University,2013,All students total,633,195,438,-2
454829,Aspen University,2013,"All students, Undergraduate total",162,75,87,-2
454829,Aspen University,2013,"All students, Undergraduate, Degree/certificate-seeking total",162,75,87,-2
454829,Aspen University,2013,"All students, Undergraduate, Degree/certificate-seeking, First-time",34,14,20,-2
454829,Aspen University,2013,"All students, Undergraduate, Other degree/certificate-seeking",128,61,67,-2
454829,Aspen University,2013,"All students, Undergraduate, Other degree/certifcate-seeking, Continuing",128,61,67,-2
454829,Aspen University,2013,"All students, Graduate",471,120,351,-2
454838,Institute of Taoist Education and Acupuncture,2013,All students total,43,11,32,-2
454838,Institute of Taoist Education and Acupuncture,2013,"All students, Graduate",43,11,32,-2
454856,Denver School of Nursing,2013,All students total,696,90,606,-2
454856,Denver School of Nursing,2013,"All students, Undergraduate total",696,90,606,-2
454856,Denver School of Nursing,2013,"All students, Undergraduate, Degree/certificate-seeking total",696,90,606,-2
454856,Denver School of Nursing,2013,"All students, Undergraduate, Other degree/certificate-seeking",696,90,606,-2
454856,Denver School of Nursing,2013,"All students, Undergraduate, Other degree/certifcate-seeking, Transfer-ins",115,16,99,-2
454856,Denver School of Nursing,2013,"All students, Undergraduate, Other degree/certifcate-seeking, Continuing",581,74,507,-2
455257,Yeshiva of Machzikai Hadas,2013,All students total,347,347,0,-2
455257,Yeshiva of Machzikai Hadas,2013,"All students, Undergraduate total",347,347,0,-2
455257,Yeshiva of Machzikai Hadas,2013,"All students, Undergraduate, Degree/certificate-seeking total",347,347,0,-2
455257,Yeshiva of Machzikai Hadas,2013,"All students, Undergraduate, Degree/certificate-seeking, First-time",69,69,0,-2
455257,Yeshiva of Machzikai Hadas,2013,"All students, Undergraduate, Other degree/certificate-seeking",278,278,0,-2
455257,Yeshiva of Machzikai Hadas,2013,"All students, Undergraduate, Other degree/certifcate-seeking, Transfer-ins",25,25,0,-2
455257,Yeshiva of Machzikai Hadas,2013,"All students, Undergraduate, Other degree/certifcate-seeking, Continuing",253,253,0,-2
455585,Minnesota School of Business-Moorhead,2013,All students total,182,45,137,-2
455585,Minnesota School of Business-Moorhead,2013,"All students, Undergraduate total",182,45,137,-2
455585,Minnesota School of Business-Moorhead,2013,"All students, Undergraduate, Degree/certificate-seeking total",171,41,130,-2
455585,Minnesota School of Business-Moorhead,2013,"All students, Undergraduate, Degree/certificate-seeking, First-time",32,2,30,-2
455585,Minnesota School of Business-Moorhead,2013,"All students, Undergraduate, Other degree/certificate-seeking",139,39,100,-2
455585,Minnesota School of Business-Moorhead,2013,"All students, Undergraduate, Other degree/certifcate-seeking, Transfer-ins",29,9,20,-2
455585,Minnesota School of Business-Moorhead,2013,"All students, Undergraduate, Other degree/certifcate-seeking, Continuing",110,30,80,-2
455585,Minnesota School of Business-Moorhead,2013,"All students, Undergraduate, Non-degree/certificate-seeking",11,4,7,-2
455600,Brown Mackie College-Boise,2013,All students total,393,106,287,-2
455600,Brown Mackie College-Boise,2013,"All students, Undergraduate total",393,106,287,-2
455600,Brown Mackie College-Boise,2013,"All students, Undergraduate, Degree/certificate-seeking total",393,106,287,-2
455600,Brown Mackie College-Boise,2013,"All students, Undergraduate, Degree/certificate-seeking, First-time",63,16,47,-2
455600,Brown Mackie College-Boise,2013,"All students, Undergraduate, Other degree/certificate-seeking",330,90,240,-2
455600,Brown Mackie College-Boise,2013,"All students, Undergraduate, Other degree/certifcate-seeking, Transfer-ins",59,11,48,-2
455600,Brown Mackie College-Boise,2013,"All students, Undergraduate, Other degree/certifcate-seeking, Continuing",271,79,192,-2
455992,Vermont College of Fine Arts,2013,All students total,359,110,249,-2
455992,Vermont College of Fine Arts,2013,"All students, Graduate",359,110,249,-2
456010,The Art Institute of Washington-Dulles,2013,All students total,244,110,134,-2
456010,The Art Institute of Washington-Dulles,2013,"All students, Undergraduate total",244,110,134,-2
456010,The Art Institute of Washington-Dulles,2013,"All students, Undergraduate, Degree/certificate-seeking total",243,110,133,-2
456010,The Art Institute of Washington-Dulles,2013,"All students, Undergraduate, Degree/certificate-seeking, First-time",24,14,10,-2
456010,The Art Institute of Washington-Dulles,2013,"All students, Undergraduate, Other degree/certificate-seeking",219,96,123,-2
456010,The Art Institute of Washington-Dulles,2013,"All students, Undergraduate, Other degree/certifcate-seeking, Transfer-ins",42,17,25,-2
456010,The Art Institute of Washington-Dulles,2013,"All students, Undergraduate, Other degree/certifcate-seeking, Continuing",177,79,98,-2
456010,The Art Institute of Washington-Dulles,2013,"All students, Undergraduate, Non-degree/certificate-seeking",1,0,1,-2
456542,The Commonwealth Medical College,2013,All students total,364,195,169,-2
456542,The Commonwealth Medical College,2013,"All students, Graduate",364,195,169,-2
456667,Strayer University-Ohio,2013,All students total,950,309,641,-2
456667,Strayer University-Ohio,2013,"All students, Undergraduate total",727,246,481,-2
456667,Strayer University-Ohio,2013,"All students, Undergraduate, Degree/certificate-seeking total",724,244,480,-2
456667,Strayer University-Ohio,2013,"All students, Undergraduate, Degree/certificate-seeking, First-time",123,41,82,-2
456667,Strayer University-Ohio,2013,"All students, Undergraduate, Other degree/certificate-seeking",601,203,398,-2
456667,Strayer University-Ohio,2013,"All students, Undergraduate, Other degree/certifcate-seeking, Transfer-ins",104,24,80,-2
456667,Strayer University-Ohio,2013,"All students, Undergraduate, Other degree/certifcate-seeking, Continuing",497,179,318,-2
456667,Strayer University-Ohio,2013,"All students, Undergraduate, Non-degree/certificate-seeking",3,2,1,-2
456667,Strayer University-Ohio,2013,"All students, Graduate",223,63,160,-2
456782,Minnesota School of Business-Elk River,2013,All students total,291,77,214,-2
456782,Minnesota School of Business-Elk River,2013,"All students, Undergraduate total",291,77,214,-2
456782,Minnesota School of Business-Elk River,2013,"All students, Undergraduate, Degree/certificate-seeking total",285,76,209,-2
456782,Minnesota School of Business-Elk River,2013,"All students, Undergraduate, Degree/certificate-seeking, First-time",21,4,17,-2
456782,Minnesota School of Business-Elk River,2013,"All students, Undergraduate, Other degree/certificate-seeking",264,72,192,-2
456782,Minnesota School of Business-Elk River,2013,"All students, Undergraduate, Other degree/certifcate-seeking, Transfer-ins",49,12,37,-2
456782,Minnesota School of Business-Elk River,2013,"All students, Undergraduate, Other degree/certifcate-seeking, Continuing",215,60,155,-2
456782,Minnesota School of Business-Elk River,2013,"All students, Undergraduate, Non-degree/certificate-seeking",6,1,5,-2
456834,Globe University-Minneapolis,2013,All students total,237,127,110,-2
456834,Globe University-Minneapolis,2013,"All students, Undergraduate total",126,64,62,-2
456834,Globe University-Minneapolis,2013,"All students, Undergraduate, Degree/certificate-seeking total",126,64,62,-2
456834,Globe University-Minneapolis,2013,"All students, Undergraduate, Degree/certificate-seeking, First-time",8,6,2,-2
456834,Globe University-Minneapolis,2013,"All students, Undergraduate, Other degree/certificate-seeking",118,58,60,-2
456834,Globe University-Minneapolis,2013,"All students, Undergraduate, Other degree/certifcate-seeking, Transfer-ins",35,17,18,-2
456834,Globe University-Minneapolis,2013,"All students, Undergraduate, Other degree/certifcate-seeking, Continuing",83,41,42,-2
456834,Globe University-Minneapolis,2013,"All students, Graduate",111,63,48,-2
456959,University of Minnesota-Rochester,2013,All students total,495,143,352,-2
456959,University of Minnesota-Rochester,2013,"All students, Undergraduate total",495,143,352,-2
456959,University of Minnesota-Rochester,2013,"All students, Undergraduate, Degree/certificate-seeking total",477,132,345,-2
456959,University of Minnesota-Rochester,2013,"All students, Undergraduate, Degree/certificate-seeking, First-time",155,42,113,-2
456959,University of Minnesota-Rochester,2013,"All students, Undergraduate, Other degree/certificate-seeking",322,90,232,-2
456959,University of Minnesota-Rochester,2013,"All students, Undergraduate, Other degree/certifcate-seeking, Transfer-ins",39,5,34,-2
456959,University of Minnesota-Rochester,2013,"All students, Undergraduate, Other degree/certifcate-seeking, Continuing",283,85,198,-2
456959,University of Minnesota-Rochester,2013,"All students, Undergraduate, Non-degree/certificate-seeking",18,11,7,-2
457022,Herzing University-Toledo,2013,All students total,205,44,161,-2
457022,Herzing University-Toledo,2013,"All students, Undergraduate total",205,44,161,-2
457022,Herzing University-Toledo,2013,"All students, Undergraduate, Degree/certificate-seeking total",205,44,161,-2
457022,Herzing University-Toledo,2013,"All students, Undergraduate, Degree/certificate-seeking, First-time",40,10,30,-2
457022,Herzing University-Toledo,2013,"All students, Undergraduate, Other degree/certificate-seeking",165,34,131,-2
457022,Herzing University-Toledo,2013,"All students, Undergraduate, Other degree/certifcate-seeking, Continuing",165,34,131,-2
457484,New Hope Christian College-Honolulu,2013,All students total,147,79,68,-2
457484,New Hope Christian College-Honolulu,2013,"All students, Undergraduate total",129,66,63,-2
457484,New Hope Christian College-Honolulu,2013,"All students, Undergraduate, Degree/certificate-seeking total",126,64,62,-2
457484,New Hope Christian College-Honolulu,2013,"All students, Undergraduate, Degree/certificate-seeking, First-time",13,5,8,-2
457484,New Hope Christian College-Honolulu,2013,"All students, Undergraduate, Other degree/certificate-seeking",113,59,54,-2
457484,New Hope Christian College-Honolulu,2013,"All students, Undergraduate, Other degree/certifcate-seeking, Transfer-ins",4,0,4,-2
457484,New Hope Christian College-Honolulu,2013,"All students, Undergraduate, Other degree/certifcate-seeking, Continuing",109,59,50,-2
457484,New Hope Christian College-Honolulu,2013,"All students, Undergraduate, Non-degree/certificate-seeking",3,2,1,-2
457484,New Hope Christian College-Honolulu,2013,"All students, Graduate",18,13,5,-2
458113,Bethel College,2013,All students total,54,27,27,-2
458113,Bethel College,2013,"All students, Undergraduate total",54,27,27,-2
458113,Bethel College,2013,"All students, Undergraduate, Degree/certificate-seeking total",54,27,27,-2
458113,Bethel College,2013,"All students, Undergraduate, Degree/certificate-seeking, First-time",5,3,2,-2
458113,Bethel College,2013,"All students, Undergraduate, Other degree/certificate-seeking",49,24,25,-2
458113,Bethel College,2013,"All students, Undergraduate, Other degree/certifcate-seeking, Transfer-ins",8,5,3,-2
458113,Bethel College,2013,"All students, Undergraduate, Other degree/certifcate-seeking, Continuing",41,19,22,-2
458432,Harrison College-Grove City,2013,All students total,244,43,201,-2
458432,Harrison College-Grove City,2013,"All students, Undergraduate total",244,43,201,-2
458432,Harrison College-Grove City,2013,"All students, Undergraduate, Degree/certificate-seeking total",244,43,201,-2
458432,Harrison College-Grove City,2013,"All students, Undergraduate, Degree/certificate-seeking, First-time",36,10,26,-2
458432,Harrison College-Grove City,2013,"All students, Undergraduate, Other degree/certificate-seeking",208,33,175,-2
458432,Harrison College-Grove City,2013,"All students, Undergraduate, Other degree/certifcate-seeking, Transfer-ins",30,8,22,-2
458432,Harrison College-Grove City,2013,"All students, Undergraduate, Other degree/certifcate-seeking, Continuing",178,25,153,-2
458496,The Art Institute of Virginia Beach,2013,All students total,663,279,384,-2
458496,The Art Institute of Virginia Beach,2013,"All students, Undergraduate total",663,279,384,-2
458496,The Art Institute of Virginia Beach,2013,"All students, Undergraduate, Degree/certificate-seeking total",663,279,384,-2
458496,The Art Institute of Virginia Beach,2013,"All students, Undergraduate, Degree/certificate-seeking, First-time",135,55,80,-2
458496,The Art Institute of Virginia Beach,2013,"All students, Undergraduate, Other degree/certificate-seeking",528,224,304,-2
458496,The Art Institute of Virginia Beach,2013,"All students, Undergraduate, Other degree/certifcate-seeking, Transfer-ins",119,36,83,-2
458496,The Art Institute of Virginia Beach,2013,"All students, Undergraduate, Other degree/certifcate-seeking, Continuing",409,188,221,-2
458511,Gerstner Sloan-Kettering Graduate School of Biomedical Sciences,2013,,,,,-2
458742,Minnesota School of Business-Lakeville,2013,All students total,203,61,142,-2
458742,Minnesota School of Business-Lakeville,2013,"All students, Undergraduate total",203,61,142,-2
458742,Minnesota School of Business-Lakeville,2013,"All students, Undergraduate, Degree/certificate-seeking total",197,60,137,-2
458742,Minnesota School of Business-Lakeville,2013,"All students, Undergraduate, Degree/certificate-seeking, First-time",17,8,9,-2
458742,Minnesota School of Business-Lakeville,2013,"All students, Undergraduate, Other degree/certificate-seeking",180,52,128,-2
458742,Minnesota School of Business-Lakeville,2013,"All students, Undergraduate, Other degree/certifcate-seeking, Transfer-ins",37,7,30,-2
458742,Minnesota School of Business-Lakeville,2013,"All students, Undergraduate, Other degree/certifcate-seeking, Continuing",143,45,98,-2
458742,Minnesota School of Business-Lakeville,2013,"All students, Undergraduate, Non-degree/certificate-seeking",6,1,5,-2
459107,Bryant & Stratton College-Hampton,2013,All students total,641,140,501,-2
459107,Bryant & Stratton College-Hampton,2013,"All students, Undergraduate total",641,140,501,-2
459107,Bryant & Stratton College-Hampton,2013,"All students, Undergraduate, Degree/certificate-seeking total",641,140,501,-2
459107,Bryant & Stratton College-Hampton,2013,"All students, Undergraduate, Degree/certificate-seeking, First-time",94,34,60,-2
459107,Bryant & Stratton College-Hampton,2013,"All students, Undergraduate, Other degree/certificate-seeking",547,106,441,-2
459107,Bryant & Stratton College-Hampton,2013,"All students, Undergraduate, Other degree/certifcate-seeking, Transfer-ins",157,35,122,-2
459107,Bryant & Stratton College-Hampton,2013,"All students, Undergraduate, Other degree/certifcate-seeking, Continuing",390,71,319,-2
459259,South University–Richmond,2013,All students total,699,94,605,-2
459259,South University–Richmond,2013,"All students, Undergraduate total",637,85,552,-2
459259,South University–Richmond,2013,"All students, Undergraduate, Degree/certificate-seeking total",634,84,550,-2
459259,South University–Richmond,2013,"All students, Undergraduate, Degree/certificate-seeking, First-time",35,7,28,-2
459259,South University–Richmond,2013,"All students, Undergraduate, Other degree/certificate-seeking",599,77,522,-2
459259,South University–Richmond,2013,"All students, Undergraduate, Other degree/certifcate-seeking, Transfer-ins",154,18,136,-2
459259,South University–Richmond,2013,"All students, Undergraduate, Other degree/certifcate-seeking, Continuing",445,59,386,-2
459259,South University–Richmond,2013,"All students, Undergraduate, Non-degree/certificate-seeking",3,1,2,-2
459259,South University–Richmond,2013,"All students, Graduate",62,9,53,-2
459268,South University–Virginia Beach,2013,All students total,790,172,618,-2
459268,South University–Virginia Beach,2013,"All students, Undergraduate total",685,157,528,-2
459268,South University–Virginia Beach,2013,"All students, Undergraduate, Degree/certificate-seeking total",685,157,528,-2
459268,South University–Virginia Beach,2013,"All students, Undergraduate, Degree/certificate-seeking, First-time",31,13,18,-2
459268,South University–Virginia Beach,2013,"All students, Undergraduate, Other degree/certificate-seeking",654,144,510,-2
459268,South University–Virginia Beach,2013,"All students, Undergraduate, Other degree/certifcate-seeking, Transfer-ins",211,40,171,-2
459268,South University–Virginia Beach,2013,"All students, Undergraduate, Other degree/certifcate-seeking, Continuing",443,104,339,-2
459268,South University–Virginia Beach,2013,"All students, Graduate",105,15,90,-2
459417,Compass College of Cinematic Arts,2013,All students total,81,63,18,-2
459417,Compass College of Cinematic Arts,2013,"All students, Undergraduate total",81,63,18,-2
459417,Compass College of Cinematic Arts,2013,"All students, Undergraduate, Degree/certificate-seeking total",80,62,18,-2
459417,Compass College of Cinematic Arts,2013,"All students, Undergraduate, Degree/certificate-seeking, First-time",40,33,7,-2
459417,Compass College of Cinematic Arts,2013,"All students, Undergraduate, Other degree/certificate-seeking",40,29,11,-2
459417,Compass College of Cinematic Arts,2013,"All students, Undergraduate, Other degree/certifcate-seeking, Transfer-ins",29,21,8,-2
459417,Compass College of Cinematic Arts,2013,"All students, Undergraduate, Other degree/certifcate-seeking, Continuing",11,8,3,-2
459417,Compass College of Cinematic Arts,2013,"All students, Undergraduate, Non-degree/certificate-seeking",1,1,0,-2
459602,ITT Technical Institute-Salem,2013,All students total,250,135,115,-2
459602,ITT Technical Institute-Salem,2013,"All students, Undergraduate total",250,135,115,-2
459602,ITT Technical Institute-Salem,2013,"All students, Undergraduate, Degree/certificate-seeking total",250,135,115,-2
459602,ITT Technical Institute-Salem,2013,"All students, Undergraduate, Degree/certificate-seeking, First-time",53,32,21,-2
459602,ITT Technical Institute-Salem,2013,"All students, Undergraduate, Other degree/certificate-seeking",197,103,94,-2
459602,ITT Technical Institute-Salem,2013,"All students, Undergraduate, Other degree/certifcate-seeking, Transfer-ins",3,3,0,-2
459602,ITT Technical Institute-Salem,2013,"All students, Undergraduate, Other degree/certifcate-seeking, Continuing",194,100,94,-2
459611,ITT Technical Institute-Akron,2013,All students total,249,174,75,-2
459611,ITT Technical Institute-Akron,2013,"All students, Undergraduate total",249,174,75,-2
459611,ITT Technical Institute-Akron,2013,"All students, Undergraduate, Degree/certificate-seeking total",249,174,75,-2
459611,ITT Technical Institute-Akron,2013,"All students, Undergraduate, Degree/certificate-seeking, First-time",51,38,13,-2
459611,ITT Technical Institute-Akron,2013,"All students, Undergraduate, Other degree/certificate-seeking",198,136,62,-2
459611,ITT Technical Institute-Akron,2013,"All students, Undergraduate, Other degree/certifcate-seeking, Transfer-ins",3,0,3,-2
459611,ITT Technical Institute-Akron,2013,"All students, Undergraduate, Other degree/certifcate-seeking, Continuing",195,136,59,-2
459620,ITT Technical Institute-Cedar Rapids,2013,All students total,37,34,3,-2
459620,ITT Technical Institute-Cedar Rapids,2013,"All students, Undergraduate total",37,34,3,-2
459620,ITT Technical Institute-Cedar Rapids,2013,"All students, Undergraduate, Degree/certificate-seeking total",37,34,3,-2
459620,ITT Technical Institute-Cedar Rapids,2013,"All students, Undergraduate, Other degree/certificate-seeking",37,34,3,-2
459620,ITT Technical Institute-Cedar Rapids,2013,"All students, Undergraduate, Other degree/certifcate-seeking, Continuing",37,34,3,-2
459675,ITT Technical Institute-Aurora,2013,All students total,247,201,46,-2
459675,ITT Technical Institute-Aurora,2013,"All students, Undergraduate total",247,201,46,-2
459675,ITT Technical Institute-Aurora,2013,"All students, Undergraduate, Degree/certificate-seeking total",247,201,46,-2
459675,ITT Technical Institute-Aurora,2013,"All students, Undergraduate, Degree/certificate-seeking, First-time",24,18,6,-2
459675,ITT Technical Institute-Aurora,2013,"All students, Undergraduate, Other degree/certificate-seeking",223,183,40,-2
459675,ITT Technical Institute-Aurora,2013,"All students, Undergraduate, Other degree/certifcate-seeking, Transfer-ins",6,5,1,-2
459675,ITT Technical Institute-Aurora,2013,"All students, Undergraduate, Other degree/certifcate-seeking, Continuing",217,178,39,-2
459709,ITT Technical Institute-Dearborn,2013,All students total,438,329,109,-2
459709,ITT Technical Institute-Dearborn,2013,"All students, Undergraduate total",438,329,109,-2
459709,ITT Technical Institute-Dearborn,2013,"All students, Undergraduate, Degree/certificate-seeking total",438,329,109,-2
459709,ITT Technical Institute-Dearborn,2013,"All students, Undergraduate, Degree/certificate-seeking, First-time",77,57,20,-2
459709,ITT Technical Institute-Dearborn,2013,"All students, Undergraduate, Other degree/certificate-seeking",361,272,89,-2
459709,ITT Technical Institute-Dearborn,2013,"All students, Undergraduate, Other degree/certifcate-seeking, Transfer-ins",6,5,1,-2
459709,ITT Technical Institute-Dearborn,2013,"All students, Undergraduate, Other degree/certifcate-seeking, Continuing",355,267,88,-2
460349,Johnson & Wales University-Online,2013,All students total,135,48,87,-2
460349,Johnson & Wales University-Online,2013,"All students, Undergraduate total",118,45,73,-2
460349,Johnson & Wales University-Online,2013,"All students, Undergraduate, Degree/certificate-seeking total",118,45,73,-2
460349,Johnson & Wales University-Online,2013,"All students, Undergraduate, Other degree/certificate-seeking",118,45,73,-2
460349,Johnson & Wales University-Online,2013,"All students, Undergraduate, Other degree/certifcate-seeking, Transfer-ins",24,13,11,-2
460349,Johnson & Wales University-Online,2013,"All students, Undergraduate, Other degree/certifcate-seeking, Continuing",94,32,62,-2
460349,Johnson & Wales University-Online,2013,"All students, Graduate",17,3,14,-2
460738,American Sentinel University,2013,All students total,3676,555,3121,-2
460738,American Sentinel University,2013,"All students, Undergraduate total",2346,366,1980,-2
460738,American Sentinel University,2013,"All students, Undergraduate, Degree/certificate-seeking total",2328,360,1968,-2
460738,American Sentinel University,2013,"All students, Undergraduate, Other degree/certificate-seeking",2328,360,1968,-2
460738,American Sentinel University,2013,"All students, Undergraduate, Other degree/certifcate-seeking, Transfer-ins",1206,144,1062,-2
460738,American Sentinel University,2013,"All students, Undergraduate, Other degree/certifcate-seeking, Continuing",1122,216,906,-2
460738,American Sentinel University,2013,"All students, Undergraduate, Non-degree/certificate-seeking",18,6,12,-2
460738,American Sentinel University,2013,"All students, Graduate",1330,189,1141,-2
460871,Chamberlain College of Nursing-Virginia,2013,All students total,364,44,320,-2
460871,Chamberlain College of Nursing-Virginia,2013,"All students, Undergraduate total",364,44,320,-2
460871,Chamberlain College of Nursing-Virginia,2013,"All students, Undergraduate, Degree/certificate-seeking total",363,44,319,-2
460871,Chamberlain College of Nursing-Virginia,2013,"All students, Undergraduate, Degree/certificate-seeking, First-time",2,0,2,-2
460871,Chamberlain College of Nursing-Virginia,2013,"All students, Undergraduate, Other degree/certificate-seeking",361,44,317,-2
460871,Chamberlain College of Nursing-Virginia,2013,"All students, Undergraduate, Other degree/certifcate-seeking, Transfer-ins",119,15,104,-2
460871,Chamberlain College of Nursing-Virginia,2013,"All students, Undergraduate, Other degree/certifcate-seeking, Continuing",242,29,213,-2
460871,Chamberlain College of Nursing-Virginia,2013,"All students, Undergraduate, Non-degree/certificate-seeking",1,0,1,-2
460899,Stevens-Henager College-Boise,2013,All students total,422,163,259,-2
460899,Stevens-Henager College-Boise,2013,"All students, Undergraduate total",422,163,259,-2
460899,Stevens-Henager College-Boise,2013,"All students, Undergraduate, Degree/certificate-seeking total",422,163,259,-2
460899,Stevens-Henager College-Boise,2013,"All students, Undergraduate, Degree/certificate-seeking, First-time",269,100,169,-2
460899,Stevens-Henager College-Boise,2013,"All students, Undergraduate, Other degree/certificate-seeking",153,63,90,-2
460899,Stevens-Henager College-Boise,2013,"All students, Undergraduate, Other degree/certifcate-seeking, Continuing",153,63,90,-2
461847,Mesivta Keser Torah,2013,All students total,33,33,0,-2
461847,Mesivta Keser Torah,2013,"All students, Undergraduate total",33,33,0,-2
461847,Mesivta Keser Torah,2013,"All students, Undergraduate, Degree/certificate-seeking total",33,33,0,-2
461847,Mesivta Keser Torah,2013,"All students, Undergraduate, Degree/certificate-seeking, First-time",7,7,0,-2
461847,Mesivta Keser Torah,2013,"All students, Undergraduate, Other degree/certificate-seeking",26,26,0,-2
461847,Mesivta Keser Torah,2013,"All students, Undergraduate, Other degree/certifcate-seeking, Transfer-ins",1,1,0,-2
461847,Mesivta Keser Torah,2013,"All students, Undergraduate, Other degree/certifcate-seeking, Continuing",25,25,0,-2
462044,Institute for Doctoral Studies in the Visual Arts,2013,All students total,46,9,37,-2
462044,Institute for Doctoral Studies in the Visual Arts,2013,"All students, Graduate",46,9,37,-2
462080,DeVry University's Keller Graduate School of Management-Maryland,2013,,,,,-2
462114,DeVry College of New York's Keller Graduate School of Management,2013,,,,,-2
462141,DeVry University's Keller Graduate School of Management-Colorado,2013,,,,,-2
462150,DeVry University's Keller Graduate School of Management-Minnesota,2013,,,,,-2
462196,DeVry University's Keller Graduate School of Management-Michigan,2013,,,,,-2
462211,DeVry University's Keller Graduate School of Management-New Jersey,2013,,,,,-2
462239,Lincoln College of New England-Hartford,2013,,,,,-2
462372,ITT Technical Institute-Hanover,2013,All students total,313,257,56,-2
462372,ITT Technical Institute-Hanover,2013,"All students, Undergraduate total",313,257,56,-2
462372,ITT Technical Institute-Hanover,2013,"All students, Undergraduate, Degree/certificate-seeking total",313,257,56,-2
462372,ITT Technical Institute-Hanover,2013,"All students, Undergraduate, Degree/certificate-seeking, First-time",67,48,19,-2
462372,ITT Technical Institute-Hanover,2013,"All students, Undergraduate, Other degree/certificate-seeking",246,209,37,-2
462372,ITT Technical Institute-Hanover,2013,"All students, Undergraduate, Other degree/certifcate-seeking, Continuing",246,209,37,-2
466161,National American University-Centennial,2013,All students total,139,37,102,-2
466161,National American University-Centennial,2013,"All students, Undergraduate total",139,37,102,-2
466161,National American University-Centennial,2013,"All students, Undergraduate, Degree/certificate-seeking total",139,37,102,-2
466161,National American University-Centennial,2013,"All students, Undergraduate, Degree/certificate-seeking, First-time",12,6,6,-2
466161,National American University-Centennial,2013,"All students, Undergraduate, Other degree/certificate-seeking",127,31,96,-2
466161,National American University-Centennial,2013,"All students, Undergraduate, Other degree/certifcate-seeking, Transfer-ins",31,7,24,-2
466161,National American University-Centennial,2013,"All students, Undergraduate, Other degree/certifcate-seeking, Continuing",96,24,72,-2
466189,National American University-Colorado Springs South,2013,All students total,262,97,165,-2
466189,National American University-Colorado Springs South,2013,"All students, Undergraduate total",262,97,165,-2
466189,National American University-Colorado Springs South,2013,"All students, Undergraduate, Degree/certificate-seeking total",262,97,165,-2
466189,National American University-Colorado Springs South,2013,"All students, Undergraduate, Degree/certificate-seeking, First-time",17,8,9,-2
466189,National American University-Colorado Springs South,2013,"All students, Undergraduate, Other degree/certificate-seeking",245,89,156,-2
466189,National American University-Colorado Springs South,2013,"All students, Undergraduate, Other degree/certifcate-seeking, Transfer-ins",91,37,54,-2
466189,National American University-Colorado Springs South,2013,"All students, Undergraduate, Other degree/certifcate-seeking, Continuing",154,52,102,-2
467793,Broadview University-Boise,2013,All students total,142,37,105,-2
467793,Broadview University-Boise,2013,"All students, Undergraduate total",142,37,105,-2
467793,Broadview University-Boise,2013,"All students, Undergraduate, Degree/certificate-seeking total",136,36,100,-2
467793,Broadview University-Boise,2013,"All students, Undergraduate, Degree/certificate-seeking, First-time",20,4,16,-2
467793,Broadview University-Boise,2013,"All students, Undergraduate, Other degree/certificate-seeking",116,32,84,-2
467793,Broadview University-Boise,2013,"All students, Undergraduate, Other degree/certifcate-seeking, Transfer-ins",24,6,18,-2
467793,Broadview University-Boise,2013,"All students, Undergraduate, Other degree/certifcate-seeking, Continuing",92,26,66,-2
467793,Broadview University-Boise,2013,"All students, Undergraduate, Non-degree/certificate-seeking",6,1,5,-2
468024,South University-Novi,2013,All students total,503,99,404,-2
468024,South University-Novi,2013,"All students, Undergraduate total",354,74,280,-2
468024,South University-Novi,2013,"All students, Undergraduate, Degree/certificate-seeking total",354,74,280,-2
468024,South University-Novi,2013,"All students, Undergraduate, Degree/certificate-seeking, First-time",12,4,8,-2
468024,South University-Novi,2013,"All students, Undergraduate, Other degree/certificate-seeking",342,70,272,-2
468024,South University-Novi,2013,"All students, Undergraduate, Other degree/certifcate-seeking, Transfer-ins",134,18,116,-2
468024,South University-Novi,2013,"All students, Undergraduate, Other degree/certifcate-seeking, Continuing",208,52,156,-2
468024,South University-Novi,2013,"All students, Graduate",149,25,124,-2
470870,ITT Technical Institute-Brooklyn Center,2013,All students total,159,141,18,-2
470870,ITT Technical Institute-Brooklyn Center,2013,"All students, Undergraduate total",159,141,18,-2
470870,ITT Technical Institute-Brooklyn Center,2013,"All students, Undergraduate, Degree/certificate-seeking total",159,141,18,-2
470870,ITT Technical Institute-Brooklyn Center,2013,"All students, Undergraduate, Degree/certificate-seeking, First-time",51,48,3,-2
470870,ITT Technical Institute-Brooklyn Center,2013,"All students, Undergraduate, Other degree/certificate-seeking",108,93,15,-2
470870,ITT Technical Institute-Brooklyn Center,2013,"All students, Undergraduate, Other degree/certifcate-seeking, Transfer-ins",6,4,2,-2
470870,ITT Technical Institute-Brooklyn Center,2013,"All students, Undergraduate, Other degree/certifcate-seeking, Continuing",102,89,13,-2
474906,CollegeAmerica-Stevens Henager College,2013,All students total,95,27,68,-2
474906,CollegeAmerica-Stevens Henager College,2013,"All students, Undergraduate total",95,27,68,-2
474906,CollegeAmerica-Stevens Henager College,2013,"All students, Undergraduate, Degree/certificate-seeking total",95,27,68,-2
474906,CollegeAmerica-Stevens Henager College,2013,"All students, Undergraduate, Degree/certificate-seeking, First-time",46,14,32,-2
474906,CollegeAmerica-Stevens Henager College,2013,"All students, Undergraduate, Other degree/certificate-seeking",49,13,36,-2
474906,CollegeAmerica-Stevens Henager College,2013,"All students, Undergraduate, Other degree/certifcate-seeking, Transfer-ins",14,3,11,-2
474906,CollegeAmerica-Stevens Henager College,2013,"All students, Undergraduate, Other degree/certifcate-seeking, Continuing",35,10,25,-2
475033,Relay Graduate School of Education,2013,All students total,721,219,502,-2
475033,Relay Graduate School of Education,2013,"All students, Graduate",721,219,502,-2
475273,Springfield College-School of Human Services,2013,All students total,1763,404,1359,-2
475273,Springfield College-School of Human Services,2013,"All students, Undergraduate total",1319,284,1035,-2
475273,Springfield College-School of Human Services,2013,"All students, Undergraduate, Degree/certificate-seeking total",1319,284,1035,-2
475273,Springfield College-School of Human Services,2013,"All students, Undergraduate, Other degree/certificate-seeking",1319,284,1035,-2
475273,Springfield College-School of Human Services,2013,"All students, Undergraduate, Other degree/certifcate-seeking, Continuing",1319,284,1035,-2
475273,Springfield College-School of Human Services,2013,"All students, Graduate",444,120,324,-2
475291,Brown College-Brooklyn Center,2013,All students total,144,38,106,-2
475291,Brown College-Brooklyn Center,2013,"All students, Undergraduate total",144,38,106,-2
475291,Brown College-Brooklyn Center,2013,"All students, Undergraduate, Degree/certificate-seeking total",144,38,106,-2
475291,Brown College-Brooklyn Center,2013,"All students, Undergraduate, Degree/certificate-seeking, First-time",13,5,8,-2
475291,Brown College-Brooklyn Center,2013,"All students, Undergraduate, Other degree/certificate-seeking",131,33,98,-2
475291,Brown College-Brooklyn Center,2013,"All students, Undergraduate, Other degree/certifcate-seeking, Transfer-ins",15,2,13,-2
475291,Brown College-Brooklyn Center,2013,"All students, Undergraduate, Other degree/certifcate-seeking, Continuing",116,31,85,-2
475510,Christie's Education,2013,All students total,73,5,68,-2
475510,Christie's Education,2013,"All students, Graduate",73,5,68,-2
475699,Bryant & Stratton College-Akron,2013,All students total,313,32,281,-2
475699,Bryant & Stratton College-Akron,2013,"All students, Undergraduate total",313,32,281,-2
475699,Bryant & Stratton College-Akron,2013,"All students, Undergraduate, Degree/certificate-seeking total",313,32,281,-2
475699,Bryant & Stratton College-Akron,2013,"All students, Undergraduate, Degree/certificate-seeking, First-time",17,2,15,-2
475699,Bryant & Stratton College-Akron,2013,"All students, Undergraduate, Other degree/certificate-seeking",296,30,266,-2
475699,Bryant & Stratton College-Akron,2013,"All students, Undergraduate, Other degree/certifcate-seeking, Transfer-ins",109,6,103,-2
475699,Bryant & Stratton College-Akron,2013,"All students, Undergraduate, Other degree/certifcate-seeking, Continuing",187,24,163,-2
476319,CollegeAmerica-Colorado Springs South,2013,All students total,31,6,25,-2
476319,CollegeAmerica-Colorado Springs South,2013,"All students, Undergraduate total",31,6,25,-2
476319,CollegeAmerica-Colorado Springs South,2013,"All students, Undergraduate, Degree/certificate-seeking total",31,6,25,-2
476319,CollegeAmerica-Colorado Springs South,2013,"All students, Undergraduate, Degree/certificate-seeking, First-time",3,0,3,-2
476319,CollegeAmerica-Colorado Springs South,2013,"All students, Undergraduate, Other degree/certificate-seeking",28,6,22,-2
476319,CollegeAmerica-Colorado Springs South,2013,"All students, Undergraduate, Other degree/certifcate-seeking, Transfer-ins",5,1,4,-2
476319,CollegeAmerica-Colorado Springs South,2013,"All students, Undergraduate, Other degree/certifcate-seeking, Continuing",23,5,18,-2
476601,Bais HaMedrash and Mesivta of Baltimore,2013,All students total,49,49,0,-2
476601,Bais HaMedrash and Mesivta of Baltimore,2013,"All students, Undergraduate total",49,49,0,-2
476601,Bais HaMedrash and Mesivta of Baltimore,2013,"All students, Undergraduate, Degree/certificate-seeking total",49,49,0,-2
476601,Bais HaMedrash and Mesivta of Baltimore,2013,"All students, Undergraduate, Degree/certificate-seeking, First-time",24,24,0,-2
476601,Bais HaMedrash and Mesivta of Baltimore,2013,"All students, Undergraduate, Other degree/certificate-seeking",25,25,0,-2
476601,Bais HaMedrash and Mesivta of Baltimore,2013,"All students, Undergraduate, Other degree/certifcate-seeking, Transfer-ins",1,1,0,-2
476601,Bais HaMedrash and Mesivta of Baltimore,2013,"All students, Undergraduate, Other degree/certifcate-seeking, Continuing",24,24,0,-2
476692,Yeshiva Gedolah Zichron Leyma,2013,All students total,23,23,0,-2
476692,Yeshiva Gedolah Zichron Leyma,2013,"All students, Undergraduate total",23,23,0,-2
476692,Yeshiva Gedolah Zichron Leyma,2013,"All students, Undergraduate, Degree/certificate-seeking total",23,23,0,-2
476692,Yeshiva Gedolah Zichron Leyma,2013,"All students, Undergraduate, Degree/certificate-seeking, First-time",3,3,0,-2
476692,Yeshiva Gedolah Zichron Leyma,2013,"All students, Undergraduate, Other degree/certificate-seeking",20,20,0,-2
476692,Yeshiva Gedolah Zichron Leyma,2013,"All students, Undergraduate, Other degree/certifcate-seeking, Transfer-ins",3,3,0,-2
476692,Yeshiva Gedolah Zichron Leyma,2013,"All students, Undergraduate, Other degree/certifcate-seeking, Continuing",17,17,0,-2
476717,Be'er Yaakov Talmudic Seminary,2013,All students total,298,298,0,-2
476717,Be'er Yaakov Talmudic Seminary,2013,"All students, Undergraduate total",298,298,0,-2
476717,Be'er Yaakov Talmudic Seminary,2013,"All students, Undergraduate, Degree/certificate-seeking total",298,298,0,-2
476717,Be'er Yaakov Talmudic Seminary,2013,"All students, Undergraduate, Degree/certificate-seeking, First-time",101,101,0,-2
476717,Be'er Yaakov Talmudic Seminary,2013,"All students, Undergraduate, Other degree/certificate-seeking",197,197,0,-2
476717,Be'er Yaakov Talmudic Seminary,2013,"All students, Undergraduate, Other degree/certifcate-seeking, Continuing",197,197,0,-2
476975,Colorado State University-Global Campus,2013,All students total,7402,3552,3850,-2
476975,Colorado State University-Global Campus,2013,"All students, Undergraduate total",5578,2798,2780,-2
476975,Colorado State University-Global Campus,2013,"All students, Undergraduate, Degree/certificate-seeking total",5282,2638,2644,-2
476975,Colorado State University-Global Campus,2013,"All students, Undergraduate, Other degree/certificate-seeking",5282,2638,2644,-2
476975,Colorado State University-Global Campus,2013,"All students, Undergraduate, Other degree/certifcate-seeking, Transfer-ins",1930,942,988,-2
476975,Colorado State University-Global Campus,2013,"All students, Undergraduate, Other degree/certifcate-seeking, Continuing",3352,1696,1656,-2
476975,Colorado State University-Global Campus,2013,"All students, Undergraduate, Non-degree/certificate-seeking",296,160,136,-2
476975,Colorado State University-Global Campus,2013,"All students, Graduate",1824,754,1070,-2
477011,Strayer University-Minnesota,2013,All students total,135,61,74,-2
477011,Strayer University-Minnesota,2013,"All students, Undergraduate total",110,51,59,-2
477011,Strayer University-Minnesota,2013,"All students, Undergraduate, Degree/certificate-seeking total",110,51,59,-2
477011,Strayer University-Minnesota,2013,"All students, Undergraduate, Degree/certificate-seeking, First-time",21,7,14,-2
477011,Strayer University-Minnesota,2013,"All students, Undergraduate, Other degree/certificate-seeking",89,44,45,-2
477011,Strayer University-Minnesota,2013,"All students, Undergraduate, Other degree/certifcate-seeking, Transfer-ins",12,7,5,-2
477011,Strayer University-Minnesota,2013,"All students, Undergraduate, Other degree/certifcate-seeking, Continuing",77,37,40,-2
477011,Strayer University-Minnesota,2013,"All students, Graduate",25,10,15,-2
477996,National American University-Bellevue,2013,All students total,227,75,152,-2
477996,National American University-Bellevue,2013,"All students, Undergraduate total",227,75,152,-2
477996,National American University-Bellevue,2013,"All students, Undergraduate, Degree/certificate-seeking total",217,67,150,-2
477996,National American University-Bellevue,2013,"All students, Undergraduate, Degree/certificate-seeking, First-time",30,12,18,-2
477996,National American University-Bellevue,2013,"All students, Undergraduate, Other degree/certificate-seeking",187,55,132,-2
477996,National American University-Bellevue,2013,"All students, Undergraduate, Other degree/certifcate-seeking, Transfer-ins",55,14,41,-2
477996,National American University-Bellevue,2013,"All students, Undergraduate, Other degree/certifcate-seeking, Continuing",132,41,91,-2
477996,National American University-Bellevue,2013,"All students, Undergraduate, Non-degree/certificate-seeking",10,8,2,-2
478005,National American University-Burnsville,2013,All students total,161,49,112,-2
478005,National American University-Burnsville,2013,"All students, Undergraduate total",161,49,112,-2
478005,National American University-Burnsville,2013,"All students, Undergraduate, Degree/certificate-seeking total",161,49,112,-2
478005,National American University-Burnsville,2013,"All students, Undergraduate, Degree/certificate-seeking, First-time",17,4,13,-2
478005,National American University-Burnsville,2013,"All students, Undergraduate, Other degree/certificate-seeking",144,45,99,-2
478005,National American University-Burnsville,2013,"All students, Undergraduate, Other degree/certifcate-seeking, Transfer-ins",36,10,26,-2
478005,National American University-Burnsville,2013,"All students, Undergraduate, Other degree/certifcate-seeking, Continuing",108,35,73,-2
479576,ITT Technical Institute-Grand Rapids,2013,All students total,51,48,3,-2
479576,ITT Technical Institute-Grand Rapids,2013,"All students, Undergraduate total",51,48,3,-2
479576,ITT Technical Institute-Grand Rapids,2013,"All students, Undergraduate, Degree/certificate-seeking total",51,48,3,-2
479576,ITT Technical Institute-Grand Rapids,2013,"All students, Undergraduate, Other degree/certificate-seeking",51,48,3,-2
479576,ITT Technical Institute-Grand Rapids,2013,"All students, Undergraduate, Other degree/certifcate-seeking, Continuing",51,48,3,-2
479585,ITT Technical Institute-Southfield,2013,All students total,143,116,27,-2
479585,ITT Technical Institute-Southfield,2013,"All students, Undergraduate total",143,116,27,-2
479585,ITT Technical Institute-Southfield,2013,"All students, Undergraduate, Degree/certificate-seeking total",143,116,27,-2
479585,ITT Technical Institute-Southfield,2013,"All students, Undergraduate, Degree/certificate-seeking, First-time",49,40,9,-2
479585,ITT Technical Institute-Southfield,2013,"All students, Undergraduate, Other degree/certificate-seeking",94,76,18,-2
479585,ITT Technical Institute-Southfield,2013,"All students, Undergraduate, Other degree/certifcate-seeking, Transfer-ins",2,2,0,-2
479585,ITT Technical Institute-Southfield,2013,"All students, Undergraduate, Other degree/certifcate-seeking, Continuing",92,74,18,-2
479956,Pennsylvania State University-World Campus,2013,All students total,9631,4937,4694,-2
479956,Pennsylvania State University-World Campus,2013,"All students, Undergraduate total",5389,2555,2834,-2
479956,Pennsylvania State University-World Campus,2013,"All students, Undergraduate, Degree/certificate-seeking total",4881,2223,2658,-2
479956,Pennsylvania State University-World Campus,2013,"All students, Undergraduate, Degree/certificate-seeking, First-time",251,128,123,-2
479956,Pennsylvania State University-World Campus,2013,"All students, Undergraduate, Other degree/certificate-seeking",4630,2095,2535,-2
479956,Pennsylvania State University-World Campus,2013,"All students, Undergraduate, Other degree/certifcate-seeking, Transfer-ins",908,433,475,-2
479956,Pennsylvania State University-World Campus,2013,"All students, Undergraduate, Other degree/certifcate-seeking, Continuing",3722,1662,2060,-2
479956,Pennsylvania State University-World Campus,2013,"All students, Undergraduate, Non-degree/certificate-seeking",508,332,176,-2
479956,Pennsylvania State University-World Campus,2013,"All students, Graduate",4242,2382,1860,-2
480064,Kaplan University-Augusta Campus,2013,All students total,396,72,324,-2
480064,Kaplan University-Augusta Campus,2013,"All students, Undergraduate total",384,69,315,-2
480064,Kaplan University-Augusta Campus,2013,"All students, Undergraduate, Degree/certificate-seeking total",379,66,313,-2
480064,Kaplan University-Augusta Campus,2013,"All students, Undergraduate, Degree/certificate-seeking, First-time",72,14,58,-2
480064,Kaplan University-Augusta Campus,2013,"All students, Undergraduate, Other degree/certificate-seeking",307,52,255,-2
480064,Kaplan University-Augusta Campus,2013,"All students, Undergraduate, Other degree/certifcate-seeking, Transfer-ins",132,25,107,-2
480064,Kaplan University-Augusta Campus,2013,"All students, Undergraduate, Other degree/certifcate-seeking, Continuing",175,27,148,-2
480064,Kaplan University-Augusta Campus,2013,"All students, Undergraduate, Non-degree/certificate-seeking",5,3,2,-2
480064,Kaplan University-Augusta Campus,2013,"All students, Graduate",12,3,9,-2
480082,South University-Cleveland,2013,All students total,254,48,206,-2
480082,South University-Cleveland,2013,"All students, Undergraduate total",238,48,190,-2
480082,South University-Cleveland,2013,"All students, Undergraduate, Degree/certificate-seeking total",238,48,190,-2
480082,South University-Cleveland,2013,"All students, Undergraduate, Degree/certificate-seeking, First-time",21,8,13,-2
480082,South University-Cleveland,2013,"All students, Undergraduate, Other degree/certificate-seeking",217,40,177,-2
480082,South University-Cleveland,2013,"All students, Undergraduate, Other degree/certifcate-seeking, Transfer-ins",117,16,101,-2
480082,South University-Cleveland,2013,"All students, Undergraduate, Other degree/certifcate-seeking, Continuing",100,24,76,-2
480082,South University-Cleveland,2013,"All students, Graduate",16,0,16,-2
480091,Bryant & Stratton College-Online,2013,All students total,2140,281,1859,-2
480091,Bryant & Stratton College-Online,2013,"All students, Undergraduate total",2140,281,1859,-2
480091,Bryant & Stratton College-Online,2013,"All students, Undergraduate, Degree/certificate-seeking total",2132,279,1853,-2
480091,Bryant & Stratton College-Online,2013,"All students, Undergraduate, Degree/certificate-seeking, First-time",180,36,144,-2
480091,Bryant & Stratton College-Online,2013,"All students, Undergraduate, Other degree/certificate-seeking",1952,243,1709,-2
480091,Bryant & Stratton College-Online,2013,"All students, Undergraduate, Other degree/certifcate-seeking, Transfer-ins",591,81,510,-2
480091,Bryant & Stratton College-Online,2013,"All students, Undergraduate, Other degree/certifcate-seeking, Continuing",1361,162,1199,-2
480091,Bryant & Stratton College-Online,2013,"All students, Undergraduate, Non-degree/certificate-seeking",8,2,6,-2
480134,Elizabethtown College School of Continuing and Professional Studies,2013,All students total,440,149,291,-2
480134,Elizabethtown College School of Continuing and Professional Studies,2013,"All students, Undergraduate total",372,119,253,-2
480134,Elizabethtown College School of Continuing and Professional Studies,2013,"All students, Undergraduate, Degree/certificate-seeking total",365,116,249,-2
480134,Elizabethtown College School of Continuing and Professional Studies,2013,"All students, Undergraduate, Other degree/certificate-seeking",365,116,249,-2
480134,Elizabethtown College School of Continuing and Professional Studies,2013,"All students, Undergraduate, Other degree/certifcate-seeking, Transfer-ins",51,11,40,-2
480134,Elizabethtown College School of Continuing and Professional Studies,2013,"All students, Undergraduate, Other degree/certifcate-seeking, Continuing",314,105,209,-2
480134,Elizabethtown College School of Continuing and Professional Studies,2013,"All students, Undergraduate, Non-degree/certificate-seeking",7,3,4,-2
480134,Elizabethtown College School of Continuing and Professional Studies,2013,"All students, Graduate",68,30,38,-2
480499,Shiloh University,2013,,,,,-2
480709,Wadsworth Center-NY State Dept of Health,2013,,,,,-2
480754,Manthano Christian College,2013,All students total,28,26,2,-2
480754,Manthano Christian College,2013,"All students, Undergraduate total",28,26,2,-2
480754,Manthano Christian College,2013,"All students, Undergraduate, Degree/certificate-seeking total",28,26,2,-2
480754,Manthano Christian College,2013,"All students, Undergraduate, Degree/certificate-seeking, First-time",12,11,1,-2
480754,Manthano Christian College,2013,"All students, Undergraduate, Other degree/certificate-seeking",16,15,1,-2
480754,Manthano Christian College,2013,"All students, Undergraduate, Other degree/certifcate-seeking, Transfer-ins",4,4,0,-2
480754,Manthano Christian College,2013,"All students, Undergraduate, Other degree/certifcate-seeking, Continuing",12,11,1,-2
480790,Rocky Vista University,2013,All students total,624,349,275,-2
480790,Rocky Vista University,2013,"All students, Graduate",624,349,275,-2
481094,Sotheby's Institute of Art-NY,2013,All students total,136,16,120,-2
481094,Sotheby's Institute of Art-NY,2013,"All students, Graduate",136,16,120,-2
481410,Yeshiva Gedolah Kesser Torah,2013,All students total,70,70,0,-2
481410,Yeshiva Gedolah Kesser Torah,2013,"All students, Undergraduate total",70,70,0,-2
481410,Yeshiva Gedolah Kesser Torah,2013,"All students, Undergraduate, Degree/certificate-seeking total",70,70,0,-2
481410,Yeshiva Gedolah Kesser Torah,2013,"All students, Undergraduate, Degree/certificate-seeking, First-time",12,12,0,-2
481410,Yeshiva Gedolah Kesser Torah,2013,"All students, Undergraduate, Other degree/certificate-seeking",58,58,0,-2
481410,Yeshiva Gedolah Kesser Torah,2013,"All students, Undergraduate, Other degree/certifcate-seeking, Transfer-ins",9,9,0,-2
481410,Yeshiva Gedolah Kesser Torah,2013,"All students, Undergraduate, Other degree/certifcate-seeking, Continuing",49,49,0,-2
481438,Yeshiva Yesodei Hatorah,2013,All students total,64,64,0,-2
481438,Yeshiva Yesodei Hatorah,2013,"All students, Undergraduate total",64,64,0,-2
481438,Yeshiva Yesodei Hatorah,2013,"All students, Undergraduate, Degree/certificate-seeking total",64,64,0,-2
481438,Yeshiva Yesodei Hatorah,2013,"All students, Undergraduate, Degree/certificate-seeking, First-time",23,23,0,-2
481438,Yeshiva Yesodei Hatorah,2013,"All students, Undergraduate, Other degree/certificate-seeking",41,41,0,-2
481438,Yeshiva Yesodei Hatorah,2013,"All students, Undergraduate, Other degree/certifcate-seeking, Continuing",41,41,0,-2
482228,Virginia Baptist College,2013,All students total,108,68,40,-2
482228,Virginia Baptist College,2013,"All students, Undergraduate total",91,56,35,-2
482228,Virginia Baptist College,2013,"All students, Undergraduate, Degree/certificate-seeking total",66,38,28,-2
482228,Virginia Baptist College,2013,"All students, Undergraduate, Degree/certificate-seeking, First-time",18,9,9,-2
482228,Virginia Baptist College,2013,"All students, Undergraduate, Other degree/certificate-seeking",48,29,19,-2
482228,Virginia Baptist College,2013,"All students, Undergraduate, Other degree/certifcate-seeking, Continuing",48,29,19,-2
482228,Virginia Baptist College,2013,"All students, Undergraduate, Non-degree/certificate-seeking",25,18,7,-2
482228,Virginia Baptist College,2013,"All students, Graduate",17,12,5,-2
482343,National American University-Rochester,2013,All students total,149,44,105,-2
482343,National American University-Rochester,2013,"All students, Undergraduate total",149,44,105,-2
482343,National American University-Rochester,2013,"All students, Undergraduate, Degree/certificate-seeking total",149,44,105,-2
482343,National American University-Rochester,2013,"All students, Undergraduate, Degree/certificate-seeking, First-time",22,9,13,-2
482343,National American University-Rochester,2013,"All students, Undergraduate, Other degree/certificate-seeking",127,35,92,-2
482343,National American University-Rochester,2013,"All students, Undergraduate, Other degree/certifcate-seeking, Transfer-ins",33,8,25,-2
482343,National American University-Rochester,2013,"All students, Undergraduate, Other degree/certifcate-seeking, Continuing",94,27,67,-2
482413,DeVry College of New York,2013,All students total,2127,1336,791,-2
482413,DeVry College of New York,2013,"All students, Undergraduate total",1402,962,440,-2
482413,DeVry College of New York,2013,"All students, Undergraduate, Degree/certificate-seeking total",1398,959,439,-2
482413,DeVry College of New York,2013,"All students, Undergraduate, Degree/certificate-seeking, First-time",114,72,42,-2
482413,DeVry College of New York,2013,"All students, Undergraduate, Other degree/certificate-seeking",1284,887,397,-2
482413,DeVry College of New York,2013,"All students, Undergraduate, Other degree/certifcate-seeking, Transfer-ins",362,232,130,-2
482413,DeVry College of New York,2013,"All students, Undergraduate, Other degree/certifcate-seeking, Continuing",922,655,267,-2
482413,DeVry College of New York,2013,"All students, Undergraduate, Non-degree/certificate-seeking",4,3,1,-2
482413,DeVry College of New York,2013,"All students, Graduate",725,374,351,-2
482440,DeVry University-Colorado,2013,All students total,1116,679,437,-2
482440,DeVry University-Colorado,2013,"All students, Undergraduate total",869,552,317,-2
482440,DeVry University-Colorado,2013,"All students, Undergraduate, Degree/certificate-seeking total",865,551,314,-2
482440,DeVry University-Colorado,2013,"All students, Undergraduate, Degree/certificate-seeking, First-time",25,18,7,-2
482440,DeVry University-Colorado,2013,"All students, Undergraduate, Other degree/certificate-seeking",840,533,307,-2
482440,DeVry University-Colorado,2013,"All students, Undergraduate, Other degree/certifcate-seeking, Transfer-ins",262,160,102,-2
482440,DeVry University-Colorado,2013,"All students, Undergraduate, Other degree/certifcate-seeking, Continuing",578,373,205,-2
482440,DeVry University-Colorado,2013,"All students, Undergraduate, Non-degree/certificate-seeking",4,1,3,-2
482440,DeVry University-Colorado,2013,"All students, Graduate",247,127,120,-2
482501,DeVry University-Maryland,2013,All students total,137,62,75,-2
482501,DeVry University-Maryland,2013,"All students, Undergraduate total",63,32,31,-2
482501,DeVry University-Maryland,2013,"All students, Undergraduate, Degree/certificate-seeking total",63,32,31,-2
482501,DeVry University-Maryland,2013,"All students, Undergraduate, Degree/certificate-seeking, First-time",1,0,1,-2
482501,DeVry University-Maryland,2013,"All students, Undergraduate, Other degree/certificate-seeking",62,32,30,-2
482501,DeVry University-Maryland,2013,"All students, Undergraduate, Other degree/certifcate-seeking, Transfer-ins",11,8,3,-2
482501,DeVry University-Maryland,2013,"All students, Undergraduate, Other degree/certifcate-seeking, Continuing",51,24,27,-2
482501,DeVry University-Maryland,2013,"All students, Graduate",74,30,44,-2
482510,DeVry University-Michigan,2013,All students total,304,136,168,-2
482510,DeVry University-Michigan,2013,"All students, Undergraduate total",185,97,88,-2
482510,DeVry University-Michigan,2013,"All students, Undergraduate, Degree/certificate-seeking total",184,97,87,-2
482510,DeVry University-Michigan,2013,"All students, Undergraduate, Degree/certificate-seeking, First-time",13,8,5,-2
482510,DeVry University-Michigan,2013,"All students, Undergraduate, Other degree/certificate-seeking",171,89,82,-2
482510,DeVry University-Michigan,2013,"All students, Undergraduate, Other degree/certifcate-seeking, Transfer-ins",50,21,29,-2
482510,DeVry University-Michigan,2013,"All students, Undergraduate, Other degree/certifcate-seeking, Continuing",121,68,53,-2
482510,DeVry University-Michigan,2013,"All students, Undergraduate, Non-degree/certificate-seeking",1,0,1,-2
482510,DeVry University-Michigan,2013,"All students, Graduate",119,39,80,-2
482529,DeVry University-Minnesota,2013,All students total,466,250,216,-2
482529,DeVry University-Minnesota,2013,"All students, Undergraduate total",290,168,122,-2
482529,DeVry University-Minnesota,2013,"All students, Undergraduate, Degree/certificate-seeking total",284,163,121,-2
482529,DeVry University-Minnesota,2013,"All students, Undergraduate, Degree/certificate-seeking, First-time",12,6,6,-2
482529,DeVry University-Minnesota,2013,"All students, Undergraduate, Other degree/certificate-seeking",272,157,115,-2
482529,DeVry University-Minnesota,2013,"All students, Undergraduate, Other degree/certifcate-seeking, Transfer-ins",76,44,32,-2
482529,DeVry University-Minnesota,2013,"All students, Undergraduate, Other degree/certifcate-seeking, Continuing",196,113,83,-2
482529,DeVry University-Minnesota,2013,"All students, Undergraduate, Non-degree/certificate-seeking",6,5,1,-2
482529,DeVry University-Minnesota,2013,"All students, Graduate",176,82,94,-2
482556,DeVry University-New Jersey,2013,All students total,1725,1178,547,-2
482556,DeVry University-New Jersey,2013,"All students, Undergraduate total",1458,1038,420,-2
482556,DeVry University-New Jersey,2013,"All students, Undergraduate, Degree/certificate-seeking total",1452,1035,417,-2
482556,DeVry University-New Jersey,2013,"All students, Undergraduate, Degree/certificate-seeking, First-time",170,130,40,-2
482556,DeVry University-New Jersey,2013,"All students, Undergraduate, Other degree/certificate-seeking",1282,905,377,-2
482556,DeVry University-New Jersey,2013,"All students, Undergraduate, Other degree/certifcate-seeking, Transfer-ins",265,177,88,-2
482556,DeVry University-New Jersey,2013,"All students, Undergraduate, Other degree/certifcate-seeking, Continuing",1017,728,289,-2
482556,DeVry University-New Jersey,2013,"All students, Undergraduate, Non-degree/certificate-seeking",6,3,3,-2
482556,DeVry University-New Jersey,2013,"All students, Graduate",267,140,127,-2
482574,DeVry University-Ohio,2013,All students total,3578,1870,1708,-2
482574,DeVry University-Ohio,2013,"All students, Undergraduate total",2822,1542,1280,-2
482574,DeVry University-Ohio,2013,"All students, Undergraduate, Degree/certificate-seeking total",2762,1511,1251,-2
482574,DeVry University-Ohio,2013,"All students, Undergraduate, Degree/certificate-seeking, First-time",213,146,67,-2
482574,DeVry University-Ohio,2013,"All students, Undergraduate, Other degree/certificate-seeking",2549,1365,1184,-2
482574,DeVry University-Ohio,2013,"All students, Undergraduate, Other degree/certifcate-seeking, Transfer-ins",737,351,386,-2
482574,DeVry University-Ohio,2013,"All students, Undergraduate, Other degree/certifcate-seeking, Continuing",1812,1014,798,-2
482574,DeVry University-Ohio,2013,"All students, Undergraduate, Non-degree/certificate-seeking",60,31,29,-2
482574,DeVry University-Ohio,2013,"All students, Graduate",756,328,428,-2
482608,DeVry University-Pennsylvania,2013,All students total,1481,830,651,-2
482608,DeVry University-Pennsylvania,2013,"All students, Undergraduate total",1114,658,456,-2
482608,DeVry University-Pennsylvania,2013,"All students, Undergraduate, Degree/certificate-seeking total",1110,657,453,-2
482608,DeVry University-Pennsylvania,2013,"All students, Undergraduate, Degree/certificate-seeking, First-time",112,65,47,-2
482608,DeVry University-Pennsylvania,2013,"All students, Undergraduate, Other degree/certificate-seeking",998,592,406,-2
482608,DeVry University-Pennsylvania,2013,"All students, Undergraduate, Other degree/certifcate-seeking, Transfer-ins",255,139,116,-2
482608,DeVry University-Pennsylvania,2013,"All students, Undergraduate, Other degree/certifcate-seeking, Continuing",743,453,290,-2
482608,DeVry University-Pennsylvania,2013,"All students, Undergraduate, Non-degree/certificate-seeking",4,1,3,-2
482608,DeVry University-Pennsylvania,2013,"All students, Graduate",367,172,195,-2
482653,DeVry University-Virginia,2013,All students total,1328,824,504,-2
482653,DeVry University-Virginia,2013,"All students, Undergraduate total",783,501,282,-2
482653,DeVry University-Virginia,2013,"All students, Undergraduate, Degree/certificate-seeking total",783,501,282,-2
482653,DeVry University-Virginia,2013,"All students, Undergraduate, Degree/certificate-seeking, First-time",28,17,11,-2
482653,DeVry University-Virginia,2013,"All students, Undergraduate, Other degree/certificate-seeking",755,484,271,-2
482653,DeVry University-Virginia,2013,"All students, Undergraduate, Other degree/certifcate-seeking, Transfer-ins",197,115,82,-2
482653,DeVry University-Virginia,2013,"All students, Undergraduate, Other degree/certifcate-seeking, Continuing",558,369,189,-2
482653,DeVry University-Virginia,2013,"All students, Graduate",545,323,222,-2
482705,Northeastern University Global Network,2013,All students total,8479,3604,4875,-2
482705,Northeastern University Global Network,2013,"All students, Undergraduate total",3519,1685,1834,-2
482705,Northeastern University Global Network,2013,"All students, Undergraduate, Degree/certificate-seeking total",2124,981,1143,-2
482705,Northeastern University Global Network,2013,"All students, Undergraduate, Other degree/certificate-seeking",2124,981,1143,-2
482705,Northeastern University Global Network,2013,"All students, Undergraduate, Other degree/certifcate-seeking, Continuing",2124,981,1143,-2
482705,Northeastern University Global Network,2013,"All students, Undergraduate, Non-degree/certificate-seeking",1395,704,691,-2
482705,Northeastern University Global Network,2013,"All students, Graduate",4960,1919,3041,-2
483018,Antioch College,2013,All students total,186,68,118,-2
483018,Antioch College,2013,"All students, Undergraduate total",186,68,118,-2
483018,Antioch College,2013,"All students, Undergraduate, Degree/certificate-seeking total",185,68,117,-2
483018,Antioch College,2013,"All students, Undergraduate, Degree/certificate-seeking, First-time",91,35,56,-2
483018,Antioch College,2013,"All students, Undergraduate, Other degree/certificate-seeking",94,33,61,-2
483018,Antioch College,2013,"All students, Undergraduate, Other degree/certifcate-seeking, Transfer-ins",7,3,4,-2
483018,Antioch College,2013,"All students, Undergraduate, Other degree/certifcate-seeking, Continuing",87,30,57,-2
483018,Antioch College,2013,"All students, Undergraduate, Non-degree/certificate-seeking",1,0,1,-2
483090,EDMC Central Administrative Office,2013,,,,,-2
